,empty_slots,free_bikes,latitude,longitude,name,timestamp,extra.last_updated,extra.slots
0,3,0,35.708596,139.758269,E5-26.本郷4丁目,2024-02-09T01:17:47.634000Z,1707441424,3
1,20,15,35.692599,139.770109,A3-42.内神田3丁目,2024-02-09T01:17:47.636000Z,1707441424,35
2,3,2,35.748736,139.574839,T2-76.東中前の森緑地,2024-02-09T01:17:47.637000Z,1707441424,5
3,2,16,35.693408,139.762809,A2-20.神田スクエア,2024-02-09T01:17:47.638000Z,1707441424,18
4,7,0,35.586993,139.736491,K1-79.Tマークシティホテル東京大森,2024-02-09T01:17:47.639000Z,1707441424,7
5,3,1,35.579849,139.731241,K1-80.大森北6丁目,2024-02-09T01:17:47.639000Z,1707441424,4
6,8,2,35.676643,139.816054,H1-130.トヨタモビリティ東京 深川店,2024-02-09T01:17:47.640000Z,1707441424,10
7,3,2,35.679029,139.793535,H1-131.セブン-イレブン 江東佐賀2丁目店,2024-02-09T01:17:47.641000Z,1707441424,5
8,0,6,35.681418,139.809287,H1-132.セブン-イレブン 江東三好4丁目店,2024-02-09T01:17:47.642000Z,1707441424,6
9,12,2,35.683433,139.740756,A6-22.半蔵門PREX South,2024-02-09T01:17:47.643000Z,1707441424,14
10,2,3,35.622403,139.71771,I1-74.セブン-イレブン西五反田6丁目店,2024-02-09T01:17:47.645000Z,1707441424,5
11,5,2,35.709777,139.810189,G2-01.東京ソラマチ,2024-02-09T01:17:47.646000Z,1707441424,7
12,2,1,35.722917,139.587864,T2-59.平成公園,2024-02-09T01:17:47.647000Z,1707441424,3
13,4,2,35.52928,139.722762,Z15.ファミリーマート藤崎一丁目店,2024-02-09T01:17:47.648000Z,1707441424,6
14,0,24,35.617475,139.729221,I1-26.大崎西口公園,2024-02-09T01:17:47.649000Z,1707441424,24
15,6,4,35.627599,139.720463,I1-96.西五反田２丁目,2024-02-09T01:17:47.650000Z,1707441424,10
16,0,4,35.668856,139.794069,H1-172.サンヨーパシフィックマンション,2024-02-09T01:17:47.651000Z,1707441424,4
17,2,2,35.654009,139.692727,J1-56.青葉台四丁目街かど公園,2024-02-09T01:17:47.653000Z,1707441424,4
18,39,0,35.687837,139.79654,H1-173.森下駅前,2024-02-09T01:17:47.654000Z,1707441424,39
19,6,4,35.718656,139.734556,E3-01.大塚地域活動センター跡地,2024-02-09T01:17:47.661000Z,1707441424,10
20,39,0,35.715556,139.721988,E2-03.目白台運動公園,2024-02-09T01:17:47.662000Z,1707441424,39
21,4,0,35.759861,139.581682,T2-77.大泉なかよし緑地,2024-02-09T01:17:47.663000Z,1707441424,4
22,52,29,35.710381,139.732137,E2-01.江戸川橋Ｂ自転車駐車場,2024-02-09T01:17:47.664000Z,1707441424,81
23,16,4,35.710958,139.731165,E2-02.江戸川公園,2024-02-09T01:17:48.151000Z,1707441424,20
24,6,0,35.720028,139.678936,D7-14.大栄パーク西落合１丁目,2024-02-09T01:17:47.666000Z,1707441424,6
25,9,1,35.712015,139.750284,E1-07.礫川地域活動センター,2024-02-09T01:17:47.667000Z,1707441424,10
26,4,2,35.67917,139.67493,M6-05.七号通り公園,2024-02-09T01:17:47.670000Z,1707441424,6
27,11,0,35.687416,139.795588,H1-138.HW.HILLS新大橋,2024-02-09T01:17:47.671000Z,1707441424,11
28,12,16,35.663681,139.785651,B4-21.月島駅前第一駐輪場,2024-02-09T01:17:47.672000Z,1707441424,28
29,6,1,35.712179,139.65603,N2-03.野方1丁目,2024-02-09T01:17:47.673000Z,1707441424,7
30,11,0,35.630109,139.747094,C5-52.港南四丁目第3アパート駐車場,2024-02-09T01:17:47.674000Z,1707441424,11
31,1,2,35.714875,139.76394,E5-27.真正館駐車場,2024-02-09T01:17:47.675000Z,1707441424,3
32,5,1,35.62822,139.741135,C5-35.品川駅港南口,2024-02-09T01:17:47.676000Z,1707441424,6
33,3,2,35.710285,139.66173,N2-01.NTT野方ビル,2024-02-09T01:17:47.676000Z,1707441424,5
34,1,8,35.686334,139.692881,D6-27.新宿三井ビルディング二号館,2024-02-09T01:17:47.677000Z,1707441424,9
35,14,2,35.691888,139.724365,D1-10.曙橋駐輪場,2024-02-09T01:17:47.678000Z,1707441424,16
36,2,2,35.628116,139.713149,I1-39.MID POINT 目黒不動前,2024-02-09T01:17:47.679000Z,1707441424,4
37,6,0,35.713388,139.737009,E3-07.小日向1丁目,2024-02-09T01:17:47.680000Z,1707441424,6
38,9,0,35.641791,139.740734,C1-47.パークプレイス三田,2024-02-09T01:17:47.682000Z,1707441424,9
39,6,39,35.594544,139.760423,I1-38.ローソン 八潮三丁目店,2024-02-09T01:17:47.683000Z,1707441424,45
40,6,0,35.655135,139.744449,C2-24.Dash Living HigashiAzabu,2024-02-09T01:17:47.683000Z,1707441424,6
41,4,4,35.650351,139.692853,J1-04.菅刈公園,2024-02-09T01:17:47.684000Z,1707441424,8
42,1,2,35.712496,139.632778,O4-09.ローソン杉並本天沼一丁目店,2024-02-09T01:17:47.685000Z,1707441424,3
43,1,2,35.755773,139.661913,T3-29.平和台もものき緑地,2024-02-09T01:17:47.686000Z,1707441424,3
44,12,0,35.696242,139.735776,D2-10.市谷砂土原町3丁目,2024-02-09T01:17:47.687000Z,1707441424,12
45,0,18,35.655139,139.762812,C1-48.竹芝客船ターミナル,2024-02-09T01:17:47.688000Z,1707441424,18
46,3,2,35.687624,139.777125,B1-06.伊場仙ビル,2024-02-09T01:17:47.690000Z,1707441424,5
47,4,2,35.67224,139.779348,B2-01.鉄砲洲児童公園（西側）,2024-02-09T01:17:47.692000Z,1707441424,6
48,3,0,35.694164,139.787057,B1-04.産業会館,2024-02-09T01:17:47.693000Z,1707441424,3
49,0,12,35.687419,139.779053,B1-05.日本橋保健センター,2024-02-09T01:17:47.694000Z,1707441424,12
50,0,4,35.670674,139.775993,B2-05.ＮＴＴ東日本築地ビル,2024-02-09T01:17:47.695000Z,1707441424,4
51,0,18,35.676393,139.768319,B2-02.柳通り（東京スクエアガーデン前）,2024-02-09T01:17:47.696000Z,1707441424,18
52,8,3,35.673923,139.778671,B2-03.男女平等センター（ブーケ21）,2024-02-09T01:17:47.698000Z,1707441424,11
53,6,1,35.651718,139.728165,C2-13.麻布運動場,2024-02-09T01:17:47.699000Z,1707441424,7
54,2,4,35.70074,139.731363,D2-08.旧市ヶ谷商業高校,2024-02-09T01:17:47.700000Z,1707441424,6
55,3,2,35.649032,139.750147,C1-35.セブン-イレブン 三田駅北店,2024-02-09T01:17:48.744000Z,1707441424,5
56,3,1,35.655497,139.774556,B4-12.THE TOKYO TOWERS,2024-02-09T01:17:47.702000Z,1707441424,4
57,5,1,35.642399,139.746992,C5-21.セブン-イレブン 芝浦3丁目店,2024-02-09T01:17:47.703000Z,1707441424,6
58,6,7,35.69766,139.843408,H1-67.セブン-イレブン 江東亀戸9丁目店,2024-02-09T01:17:47.704000Z,1707441424,13
59,0,47,35.664367,139.737185,C2-15.住友不動産六本木グランドタワー,2024-02-09T01:17:47.704000Z,1707441424,47
60,7,3,35.653608,139.73138,C2-14.元麻布ヒルズ,2024-02-09T01:17:47.706000Z,1707441424,10
61,4,0,35.67323,139.66393,M6-14.ドコモショップ笹塚店,2024-02-09T01:17:47.708000Z,1707441424,4
62,11,0,35.68509,139.671102,N4-07.南台2丁目,2024-02-09T01:17:47.710000Z,1707441424,11
63,0,13,35.580511,139.775957,K1-68.ART FACTORY 城南島,2024-02-09T01:17:50.210000Z,1707441424,13
64,2,2,35.678031,139.837193,H1-178.北砂7丁目団地(第二),2024-02-09T01:17:47.712000Z,1707441424,4
65,6,5,35.678246,139.8366,H1-179.北砂7丁目団地(第三),2024-02-09T01:17:47.713000Z,1707441424,11
66,6,0,35.692605,139.755761,A1-17.雉子橋集積所,2024-02-09T01:17:47.714000Z,1707441424,6
67,1,4,35.678537,139.837391,H1-177.北砂7丁目団地(第一),2024-02-09T01:17:47.681000Z,1707441424,5
68,10,6,35.578259,139.783505,K1-95.城南島海浜公園,2024-02-09T01:17:47.717000Z,1707441424,16
69,0,28,35.66711,139.76643,B3-17.銀座6丁目-SQUARE,2024-02-09T01:17:47.718000Z,1707441424,28
70,13,1,35.629861,139.666293,J1-33.芳窪街かど公園,2024-02-09T01:17:47.718000Z,1707441424,14
71,4,1,35.70442,139.67141,N3-07.なかのZERO,2024-02-09T01:17:47.719000Z,1707441424,5
72,8,4,35.690897,139.668345,N4-04.弥生町5丁目,2024-02-09T01:17:47.720000Z,1707441424,12
73,3,1,35.694679,139.779504,A3-44.THE WAVES AKIHABARA,2024-02-09T01:17:47.721000Z,1707441424,4
74,0,11,35.544534,139.763244,K1-138.羽田エアポートガーデン,2024-02-09T01:17:47.722000Z,1707441424,11
75,0,5,35.67011,139.733375,C3-26.ホテルリブマックス赤坂,2024-02-09T01:17:47.724000Z,1707441424,5
76,5,1,35.652549,139.747789,C1-52.NTT三田ビル,2024-02-09T01:17:47.725000Z,1707441424,6
77,2,1,35.689757,139.710091,D1-07.Dash Living Shinjuku,2024-02-09T01:17:47.726000Z,1707441424,3
78,1,4,35.690311,139.62178,O4-07.ローソン成田西三丁目店,2024-02-09T01:17:47.726000Z,1707441424,5
79,0,6,35.699187,139.82429,H1-152.コンポジット亀戸ウエスト,2024-02-09T01:17:47.727000Z,1707441424,6
80,6,1,35.71399,139.75137,E1-13.エルアージュ小石川,2024-02-09T01:17:47.728000Z,1707441424,7
81,7,1,35.65554,139.77102,B4-22.リビオレゾン勝どきNEX,2024-02-09T01:17:47.730000Z,1707441424,8
82,0,9,35.667677,139.823552,H1-176.JMFビル東陽町02,2024-02-09T01:17:47.731000Z,1707441424,9
83,6,1,35.672714,139.837914,H1-102.ファミリーマート東砂七丁目店,2024-02-09T01:17:47.732000Z,1707441424,7
84,0,13,35.642571,139.836766,H1-101.ファミリーマート新木場一丁目店,2024-02-09T01:17:47.733000Z,1707441424,13
85,0,36,35.570508,139.764013,K1-67.京浜島防災広場,2024-02-09T01:17:47.734000Z,1707441424,36
86,0,17,35.575097,139.751446,K1-66.昭和島二丁目公園,2024-02-09T01:17:47.735000Z,1707441424,17
87,1,3,35.528868,139.737762,Z11.ファミリーマートＭＧ川崎昭和店,2024-02-09T01:17:47.736000Z,1707441424,4
88,8,2,35.622714,139.74471,I1-80.リバーサイド品川港南ビル,2024-02-09T01:17:47.737000Z,1707441424,10
89,10,0,35.655779,139.680948,J1-10.NTTデータ駒場研修センター,2024-02-09T01:17:47.738000Z,1707441424,10
90,0,10,35.692396,139.75639,A2-17.竹橋ビル,2024-02-09T01:17:47.739000Z,1707441424,10
91,16,2,35.696913,139.823911,H1-91.亀戸駅北口第三自転車駐車場,2024-02-09T01:17:47.740000Z,1707441424,18
92,5,9,35.69788,139.830559,H1-92.亀戸駅東口第二自転車駐車場,2024-02-09T01:17:47.741000Z,1707441424,14
93,7,0,35.565768,139.727396,K1-59.京急梅屋敷第1駐車場,2024-02-09T01:17:47.742000Z,1707441424,7
94,9,0,35.576336,139.733691,K1-60.京急平和島第1駐車場,2024-02-09T01:17:47.743000Z,1707441424,9
95,3,0,35.611582,139.742528,I1-42.京急青横駐車場,2024-02-09T01:17:47.744000Z,1707441424,3
96,9,0,35.594722,139.737101,I1-43.京急南大井駐車場,2024-02-09T01:17:47.745000Z,1707441424,9
97,0,9,35.528801,139.694661,Z01.NTTドコモ川崎ビル,2024-02-09T01:17:47.746000Z,1707441424,9
98,1,1,35.680849,139.65626,O7-05.ジーベック方南町,2024-02-09T01:17:47.747000Z,1707441424,2
99,26,3,35.697935,139.821855,H1-100.URアーバンライフ亀戸,2024-02-09T01:17:47.747000Z,1707441424,29
100,5,6,35.682516,139.736494,A6-10.紀尾井町ビル（西側）,2024-02-09T01:17:47.748000Z,1707441424,11
101,0,7,35.674788,139.731423,C3-02.赤坂地区総合支所,2024-02-09T01:17:47.749000Z,1707441424,7
102,0,5,35.661673,139.721118,C2-08.ファミリーマート西麻布霞町店,2024-02-09T01:17:47.750000Z,1707441424,5
103,1,5,35.682902,139.736494,A6-09.紀尾井町ビル（北側）,2024-02-09T01:17:47.751000Z,1707441424,6
104,5,6,35.630063,139.792209,H1-28.有明客船ターミナル,2024-02-09T01:17:47.752000Z,1707441424,11
105,0,15,35.687786,139.78205,B1-12.ファミリーマート堀留町二丁目店,2024-02-09T01:17:47.753000Z,1707441424,15
106,0,27,35.619234,139.774485,H1-26.青海客船ターミナル,2024-02-09T01:17:47.754000Z,1707441424,27
107,10,0,35.624467,139.781305,H1-27.パレットタウン乗船場,2024-02-09T01:17:47.756000Z,1707441424,10
108,3,7,35.540579,139.754506,K1-121.東京広域ポート（川崎LiSE）,2024-02-09T01:17:47.757000Z,1707441424,10
109,8,5,35.581347,139.662265,K1-122.東急新丸子駅駐輪場,2024-02-09T01:17:47.761000Z,1707441424,13
110,9,3,35.577794,139.660751,K1-123.東急新丸子駅（東）駐輪場,2024-02-09T01:17:47.762000Z,1707441424,12
111,9,6,35.72758,139.62432,O1-04.井草1-34,2024-02-09T01:17:47.763000Z,1707441424,15
112,8,6,35.656647,139.758301,C1-76.浜松町駅北口交通広場(ハマサイト前),2024-02-09T01:17:47.764000Z,1707441424,14
113,9,0,35.629807,139.662398,J1-52.駒沢一丁目公園前,2024-02-09T01:17:47.765000Z,1707441424,9
114,0,17,35.665466,139.748014,C1-75.虎ノ門PFビル,2024-02-09T01:17:47.766000Z,1707441424,17
115,7,4,35.678291,139.78157,B2-18.旭ビルディング,2024-02-09T01:17:47.767000Z,1707441424,11
116,2,4,35.722991,139.673048,N2-09.松山駐車場No.1,2024-02-09T01:17:47.768000Z,1707441424,6
117,4,2,35.627386,139.711182,I1-82.トミンハイム西五反田四丁目,2024-02-09T01:17:47.768000Z,1707441424,6
118,0,12,35.707035,139.633066,O4-03.ザ・ハウス,2024-02-09T01:17:47.771000Z,1707441424,12
119,13,3,35.704147,139.631955,O4-04.阿佐谷南3-43,2024-02-09T01:17:47.772000Z,1707441424,16
120,5,1,35.611085,139.68599,K1-83.北千束北児童公園,2024-02-09T01:17:47.773000Z,1707441424,6
121,0,17,35.584998,139.761055,I1-95.東京レールゲート EAST,2024-02-09T01:17:47.774000Z,1707441424,17
122,0,6,35.68285,139.698528,M5-19.グランリヴィエール代々木,2024-02-09T01:17:47.774000Z,1707441424,6
123,7,2,35.537163,139.729625,Z14.ファミリーマート川崎中瀬店,2024-02-09T01:17:47.775000Z,1707441424,9
124,4,0,35.678296,139.791949,H1-192.ウエリスアーバン水天宮前,2024-02-09T01:17:47.777000Z,1707441424,4
125,3,1,35.728893,139.670119,N2-08.江古田区民活動センター,2024-02-09T01:17:47.779000Z,1707441424,4
126,3,0,35.722645,139.701982,D7-04.セブン-イレブン 新宿下落合3丁目店,2024-02-09T01:17:47.780000Z,1707441424,3
127,4,2,35.515344,139.722229,Z16.ファミリーマート川崎浜町四丁目店,2024-02-09T01:17:47.781000Z,1707441424,6
128,4,3,35.561499,139.71123,K1-82.西蒲田公園,2024-02-09T01:17:47.782000Z,1707441424,7
129,8,1,35.649274,139.792213,H1-68.芝浦工業大学附属中学高等学校,2024-02-09T01:17:47.784000Z,1707441424,9
130,0,30,35.557074,139.74575,K1-24.東糀谷防災公園,2024-02-09T01:17:47.784000Z,1707441424,30
131,0,29,35.640736,139.804331,H1-03.東雲駅,2024-02-09T01:17:47.785000Z,1707441424,29
132,0,2,35.574785,139.730762,K1-26.大森諏訪公園,2024-02-09T01:17:47.786000Z,1707441424,2
133,2,2,35.56892,139.725082,K1-25.鶴渡公園,2024-02-09T01:17:47.787000Z,1707441424,4
134,2,4,35.702659,139.662563,N3-10.エーエスホームズⅡ駐車場,2024-02-09T01:17:47.960000Z,1707441424,6
135,14,4,35.640398,139.704069,J1-37.中目黒公園,2024-02-09T01:17:49.222000Z,1707441424,18
136,0,9,35.696449,139.750784,A1-10.ヒューリック九段ビル,2024-02-09T01:17:47.792000Z,1707441424,9
137,0,4,35.548864,139.74484,K1-93.六間堀仲羽公園,2024-02-09T01:17:47.795000Z,1707441424,4
138,2,2,35.772863,139.626969,T2-53.上練馬公園,2024-02-09T01:17:47.796000Z,1707441424,4
139,7,5,35.680154,139.685937,M5-01.初台駅南口,2024-02-09T01:17:47.797000Z,1707441424,12
140,8,5,35.647659,139.745055,C1-60.専売ビル,2024-02-09T01:17:47.808000Z,1707441424,13
141,0,11,35.583555,139.743381,K1-85.大田区青少年交流センター ゆいっつ,2024-02-09T01:17:47.809000Z,1707441424,11
142,2,6,35.622965,139.731014,I1-64.株式会社ユアス ゆうパック取扱所：ポストのうしろ,2024-02-09T01:17:47.811000Z,1707441424,8
143,5,0,35.646375,139.740061,C4-09.ケーヨーデイツー三田店,2024-02-09T01:17:47.812000Z,1707441424,5
144,16,21,35.653096,139.75739,C1-61.環三浜松町駅南,2024-02-09T01:17:47.813000Z,1707441424,37
145,7,3,35.581698,139.71491,K1-84.佐伯山緑地,2024-02-09T01:17:47.814000Z,1707441424,10
146,8,5,35.650845,139.748346,C1-59.セレスティン芝三井ビルディング,2024-02-09T01:17:47.814000Z,1707441424,13
147,4,0,35.706167,139.815955,G2-07.レオーネ押上cube,2024-02-09T01:17:47.815000Z,1707441424,4
148,10,9,35.708265,139.751983,E1-06.文京シビックセンター,2024-02-09T01:17:47.818000Z,1707441424,19
149,7,0,35.695646,139.725722,D2-13.THE CENTER TOKYO,2024-02-09T01:17:47.819000Z,1707441424,7
150,2,3,35.724828,139.762583,E5-22.千駄木2丁目,2024-02-09T01:17:47.821000Z,1707441424,5
151,9,1,35.628266,139.734171,C4-07.品川プリンスホテル,2024-02-09T01:17:47.824000Z,1707441424,10
152,1,2,35.69474,139.77929,A3-43.unito CHIYODA,2024-02-09T01:17:47.826000Z,1707441424,3
153,0,7,35.644134,139.723432,C4-06.白金プラチナレジデンス,2024-02-09T01:17:47.827000Z,1707441424,7
154,0,2,35.62765,139.719212,I1-63.セブン-イレブン西五反田店,2024-02-09T01:17:47.832000Z,1707441424,2
155,9,8,35.653991,139.795513,H1-53.豊洲シビックセンター,2024-02-09T01:17:47.833000Z,1707441424,17
156,8,2,35.735428,139.652379,T3-16.練馬区役所東庁舎(第一),2024-02-09T01:17:47.835000Z,1707441424,10
157,3,2,35.731372,139.619164,T2-68.さくら原っぱ緑地,2024-02-09T01:17:47.836000Z,1707441424,5
158,1,3,35.76525,139.575978,T2-69.久保新田さくら公園,2024-02-09T01:17:47.837000Z,1707441424,4
159,5,0,35.685344,139.80234,H1-187.森下文化センター,2024-02-09T01:17:47.838000Z,1707441424,5
160,5,0,35.724707,139.750469,E4-04.セブン-イレブン 文京本駒込１丁目店,2024-02-09T01:17:47.841000Z,1707441424,5
161,7,1,35.649257,139.713272,M2-13.恵比寿プライムスクエアタワー南,2024-02-09T01:17:47.842000Z,1707441424,8
162,0,13,35.658249,139.815775,H1-48.セブン-イレブン 江東潮見２丁目店,2024-02-09T01:17:47.844000Z,1707441424,13
163,0,36,35.654958,139.795718,H1-51.豊洲交通広場　東,2024-02-09T01:17:47.848000Z,1707441424,36
164,0,71,35.646756,139.809295,H1-52.辰巳駅,2024-02-09T01:17:47.849000Z,1707441424,71
165,10,5,35.715894,139.698578,D7-01.下落合図書館,2024-02-09T01:17:47.850000Z,1707441424,15
166,0,59,35.655457,139.795161,H1-50.豊洲交通広場　北,2024-02-09T01:17:47.851000Z,1707441424,59
167,0,5,35.690861,139.736393,A6-14.MG市ヶ谷ビルディング,2024-02-09T01:17:47.853000Z,1707441424,5
168,2,2,35.768448,139.601679,T2-21.ファミリーマート 練馬大泉町一丁目店,2024-02-09T01:17:47.855000Z,1707441424,4
169,3,1,35.688929,139.7358,A6-15.東急番町ビル,2024-02-09T01:17:47.856000Z,1707441424,4
170,4,1,35.696202,139.752351,A1-18.東京区政会館別館(特別区研修所),2024-02-09T01:17:47.859000Z,1707441424,5
171,7,12,35.738585,139.653396,T3-18.練馬駅北,2024-02-09T01:17:47.861000Z,1707441424,19
172,0,8,35.658169,139.752509,C1-43.KDX浜松町プレイス,2024-02-09T01:17:47.862000Z,1707441424,8
173,15,6,35.648948,139.757895,C5-27.プレミア海岸ビル,2024-02-09T01:17:47.863000Z,1707441424,21
174,0,10,35.599987,139.745195,I1-29.ローソン 勝島一丁目店,2024-02-09T01:17:47.865000Z,1707441424,10
175,19,0,35.674578,139.797396,H1-72.ネクストサイト深川ビル,2024-02-09T01:17:47.871000Z,1707441424,19
176,0,6,35.768528,139.639807,T1-11.むつみ台,2024-02-09T01:17:47.872000Z,1707441424,6
177,3,2,35.758366,139.628982,T1-10.月見大橋下,2024-02-09T01:17:47.873000Z,1707441424,5
178,10,0,35.688074,139.838932,H1-167.大島八丁目公園,2024-02-09T01:17:47.874000Z,1707441424,10
179,4,0,35.587815,139.691748,K1-36.セブン-イレブン 大田区南雪谷5丁目店,2024-02-09T01:17:47.876000Z,1707441424,4
180,6,6,35.66088,139.654546,L1-01.羽根木公園,2024-02-09T01:17:47.878000Z,1707441424,12
181,8,0,35.721738,139.723103,P1-02.雑司ヶ谷一丁目,2024-02-09T01:17:47.881000Z,1707441424,8
182,6,0,35.596733,139.73804,I1-66.南大井文化センター駐車場,2024-02-09T01:17:47.882000Z,1707441424,6
183,0,4,35.669285,139.597931,L1-05.NTT烏山ビル,2024-02-09T01:17:47.888000Z,1707441424,4
184,4,1,35.63367,139.678139,L1-04.下馬中央公園,2024-02-09T01:17:47.889000Z,1707441424,5
185,2,4,35.645838,139.647799,L1-03.世田谷城阯公園,2024-02-09T01:17:47.890000Z,1707441424,6
186,5,2,35.647075,139.654472,L1-02.若林公園,2024-02-09T01:17:47.891000Z,1707441424,7
187,2,1,35.750804,139.58243,T2-30.ファミリーマート 練馬東大泉四丁目店,2024-02-09T01:17:47.893000Z,1707441424,3
188,2,1,35.648021,139.606529,L1-07.NTT成城ビル,2024-02-09T01:17:47.895000Z,1707441424,3
189,0,11,35.618357,139.626191,L1-06.NTT瀬田ビル,2024-02-09T01:17:47.900000Z,1707441424,11
190,4,0,35.748092,139.636587,T3-12.春日町西公園,2024-02-09T01:17:47.901000Z,1707441424,4
191,2,2,35.757298,139.664139,T3-13.平和台児童公園,2024-02-09T01:17:47.902000Z,1707441424,4
192,5,4,35.727195,139.590179,T2-38.ファミリーマート 練馬上石神井四丁目店,2024-02-09T01:17:47.903000Z,1707441424,9
193,7,1,35.684502,139.77906,B1-28.アイルイムーブル日本橋,2024-02-09T01:17:47.905000Z,1707441424,8
194,3,5,35.6915,139.75685,A2-28.NTTコミュニケーションズ一ツ橋ビル駐車場,2024-02-09T01:17:47.906000Z,1707441424,8
195,2,3,35.667936,139.72745,C3-32.乃木公園,2024-02-09T01:17:47.910000Z,1707441424,5
196,2,2,35.759774,139.654529,T3-14.わらべ児童遊園,2024-02-09T01:17:47.912000Z,1707441424,4
197,4,1,35.762395,139.641522,T2-52.田柄中央児童公園,2024-02-09T01:17:50.226000Z,1707441424,5
198,3,7,35.671823,139.708158,M4-06.THE SHARE 原宿,2024-02-09T01:17:47.917000Z,1707441424,10
199,3,1,35.559647,139.730098,K1-10.セブン‐イレブン 大田区西糀谷１丁目店,2024-02-09T01:17:47.918000Z,1707441424,4
200,0,16,35.570763,139.705895,K1-09.セブン‐イレブン 大田区西蒲田２丁目店,2024-02-09T01:17:47.919000Z,1707441424,16
201,9,0,35.65637,139.811765,H1-63.東京スイソミル,2024-02-09T01:17:47.921000Z,1707441424,9
202,2,4,35.683695,139.780043,B1-16.小網町児童遊園,2024-02-09T01:17:50.282000Z,1707441424,6
203,0,11,35.648281,139.786112,H1-61.Brilliaランニングスタジアムマギーズ東京前,2024-02-09T01:17:47.929000Z,1707441424,11
204,5,0,35.562368,139.730143,K1-08.セブン‐イレブン 大田区東蒲田キネマ通り店,2024-02-09T01:17:47.930000Z,1707441424,5
205,0,10,35.664479,139.743731,C1-34.城山ガーデン,2024-02-09T01:17:47.931000Z,1707441424,10
206,17,2,35.683343,139.812161,H1-62.扇橋一丁目公園南,2024-02-09T01:17:47.932000Z,1707441424,19
207,23,0,35.623756,139.692517,J1-23.清水池公園,2024-02-09T01:17:47.934000Z,1707441424,23
208,19,0,35.634529,139.748378,C5-18.パークタワー品川ベイワード,2024-02-09T01:17:47.935000Z,1707441424,19
209,2,2,35.727279,139.74627,E4-07.ファミリーマート 本駒込二丁目店,2024-02-09T01:17:47.936000Z,1707441424,4
210,9,0,35.644794,139.755688,C5-45.パークアクシス芝浦キャナル,2024-02-09T01:17:47.943000Z,1707441424,9
211,5,3,35.698591,139.755113,A2-02.西神田公園（北側）,2024-02-09T01:17:47.944000Z,1707441424,8
212,5,4,35.719674,139.593696,T2-49.善福寺公園テニスクラブ,2024-02-09T01:17:47.945000Z,1707441424,9
213,27,0,35.651833,139.79962,H1-193.ライフ豊洲店,2024-02-09T01:17:48.689000Z,1707441424,27
214,20,32,35.695762,139.761585,A2-01.神田駿河台下,2024-02-09T01:17:47.947000Z,1707441424,52
215,9,0,35.589573,139.735585,I1-51.京急鈴ヶ森駐車場,2024-02-09T01:17:47.949000Z,1707441424,9
216,7,3,35.75195,139.616028,T2-36.サントピア テニスパーク,2024-02-09T01:17:47.952000Z,1707441424,10
217,0,3,35.696492,139.791591,G4-13. Parking in 両国駅前第2,2024-02-09T01:17:48.705000Z,1707441424,3
218,6,0,35.560125,139.71569,K1-120.蒲田駅消費者生活センター横自転車駐車場 屋上部,2024-02-09T01:17:47.954000Z,1707441424,6
219,6,0,35.69942,139.673964,N3-18.藤和シティコープ新中野3,2024-02-09T01:17:47.956000Z,1707441424,6
220,11,2,35.58209,139.701362,K1-145.トヨタモビリティ東京馬込テクニカル研修センター,2024-02-09T01:17:47.962000Z,1707441424,13
221,5,0,35.589794,139.666955,K1-100.多摩川台公園,2024-02-09T01:17:47.963000Z,1707441424,5
222,0,12,35.664344,139.746662,C1-54.ニッセイ虎ノ門ビル,2024-02-09T01:17:47.964000Z,1707441424,12
223,2,8,35.607557,139.746866,I1-52.カスタリアタワー品川シーサイド,2024-02-09T01:17:47.965000Z,1707441424,10
224,0,8,35.620355,139.749339,I1-53.天王洲公園,2024-02-09T01:17:47.967000Z,1707441424,8
225,3,0,35.656769,139.743224,C2-18.ブランシェ東麻布,2024-02-09T01:17:47.971000Z,1707441424,3
226,4,14,35.691578,139.77138,A3-45.鍛冶町2丁目,2024-02-09T01:17:47.972000Z,1707441424,18
227,7,0,35.662514,139.803694,H1-87.パークアクシス木場キャナルウエスト,2024-02-09T01:17:47.973000Z,1707441424,7
228,1,14,35.693544,139.685806,D6-20.淀橋けやき橋公園,2024-02-09T01:17:47.974000Z,1707441424,15
229,0,0,35.695457,139.772972,A3-46.神田須田町2丁目,2024-02-09T01:17:47.976000Z,1707441424,0
230,7,3,35.664871,139.767188,B3-13.国立がん研究センター,2024-02-09T01:17:47.978000Z,1707441424,10
231,0,16,35.622954,139.750593,I1-35.シーフォートスクエア,2024-02-09T01:17:47.980000Z,1707441424,16
232,17,1,35.576275,139.713704,K1-55.カバヤビル,2024-02-09T01:17:47.981000Z,1707441424,18
233,0,8,35.668419,139.724676,C3-24.SHARE GREEN 南青山 西エントランス,2024-02-09T01:17:47.982000Z,1707441424,8
234,9,1,35.674468,139.741328,A5-06.APA HOTEL PRIDE〈国会議事堂前〉,2024-02-09T01:17:48.004000Z,1707441424,10
235,6,5,35.680431,139.738203,A6-17.東京ガーデンテラス紀尾井町（プリンス通り側）,2024-02-09T01:17:48.028000Z,1707441424,11
236,50,10,35.658135,139.776131,B4-07.勝どき駅地下駐輪場,2024-02-09T01:17:48.064000Z,1707441424,60
237,17,0,35.656449,139.771302,B4-08.東京ミッドベイ勝どき（西仲通り）,2024-02-09T01:17:48.068000Z,1707441424,17
238,17,0,35.664265,139.767426,B3-04.築地市場駅地下駐輪場,2024-02-09T01:17:48.069000Z,1707441424,17
239,3,11,35.649959,139.756068,C5-10.シーバンス,2024-02-09T01:17:48.070000Z,1707441424,14
240,47,3,35.67391,139.796165,H1-34.門前仲町駅,2024-02-09T01:17:48.071000Z,1707441424,50
241,0,19,35.670364,139.744684,C3-10.ファミリーマート特許庁前店,2024-02-09T01:17:48.072000Z,1707441424,19
242,6,2,35.693799,139.753281,A1-01.千代田区役所,2024-02-09T01:17:48.073000Z,1707441424,8
243,4,3,35.701073,139.747525,A1-03.東京区政会館（メトロA5出口）,2024-02-09T01:17:48.080000Z,1707441424,7
244,0,21,35.664457,139.767214,B3-06.朝日新聞東京本社,2024-02-09T01:17:48.081000Z,1707441424,21
245,3,4,35.701347,139.746951,A1-04.東京区政会館（西側駐輪場）,2024-02-09T01:17:48.100000Z,1707441424,7
246,5,0,35.760585,139.626284,T1-03.四季の香公園,2024-02-09T01:17:48.101000Z,1707441424,5
247,3,0,35.75731,139.624922,T1-04.春の風公園,2024-02-09T01:17:48.102000Z,1707441424,3
248,4,1,35.753964,139.629116,T1-05.夏の雲公園,2024-02-09T01:17:48.103000Z,1707441424,5
249,4,0,35.68268,139.8353,H1-194.セブン-イレブン江東北砂5丁目店,2024-02-09T01:17:48.104000Z,1707441424,4
250,5,8,35.697265,139.649397,O5-03.新高円寺地下自転車駐輪場,2024-02-09T01:17:48.105000Z,1707441424,13
251,3,1,35.714616,139.625116,O3-06.アミーズ荻窪,2024-02-09T01:17:48.105000Z,1707441424,4
252,7,1,35.752383,139.594855,T2-03.リヴィンオズ大泉店,2024-02-09T01:17:48.108000Z,1707441424,8
253,1,6,35.673055,139.611293,O6-06.上高井戸1丁目,2024-02-09T01:17:48.109000Z,1707441424,7
254,4,0,35.736076,139.599676,T2-05.石神井図書館,2024-02-09T01:17:48.110000Z,1707441424,4
255,3,0,35.748957,139.621385,T2-06.総合体育館,2024-02-09T01:17:48.111000Z,1707441424,3
256,5,1,35.705686,139.642587,O5-02.馬橋ハイツ,2024-02-09T01:17:48.112000Z,1707441424,6
257,2,5,35.733292,139.630369,N1-07.プランドール上鷺宮,2024-02-09T01:17:48.124000Z,1707441424,7
258,8,0,35.709261,139.746374,E1-18.アーバネックス小石川春日,2024-02-09T01:17:48.125000Z,1707441424,8
259,5,2,35.740378,139.667502,T3-03.新桜台駅自転車駐車場,2024-02-09T01:17:48.126000Z,1707441424,7
260,7,16,35.70389,139.6185,O3-05.Nちゃりパーク,2024-02-09T01:17:48.127000Z,1707441424,23
261,10,1,35.71038,139.64519,O5-01.朝霞ハイツ,2024-02-09T01:17:48.128000Z,1707441424,11
262,2,1,35.656849,139.594422,L1-11.アイムタウン上祖師谷,2024-02-09T01:17:48.129000Z,1707441424,3
263,13,1,35.646648,139.633038,L1-12.鈴木リースホーム駐車場,2024-02-09T01:17:48.131000Z,1707441424,14
264,4,0,35.647393,139.667085,L1-13.わびさびホステル,2024-02-09T01:17:48.133000Z,1707441424,4
265,6,0,35.715733,139.815451,G2-05.リアナスカイパーク押上,2024-02-09T01:17:48.134000Z,1707441424,6
266,7,4,35.756846,139.652154,T3-02.早宮第二自転車駐車場,2024-02-09T01:17:48.144000Z,1707441424,11
267,3,5,35.623466,139.734359,I1-37.ガーデンシティ品川御殿山,2024-02-09T01:17:48.148000Z,1707441424,8
268,5,5,35.726523,139.5905,T2-47.上石神井駅北第二自転車駐車場,2024-02-09T01:17:48.150000Z,1707441424,10
269,12,0,35.663843,139.757697,C1-51.環二新橋四丁目,2024-02-09T01:17:48.150000Z,1707441424,12
270,20,0,35.675436,139.670594,M6-07.笹塚東,2024-02-09T01:17:48.846000Z,1707441424,20
271,5,3,35.647757,139.712981,M3-10.ウノサワ東急ビル,2024-02-09T01:17:48.157000Z,1707441424,8
272,5,1,35.655367,139.738075,C2-26.一の橋公園,2024-02-09T01:17:49.458000Z,1707441424,6
273,3,2,35.658351,139.818229,H1-14.ホテルリブマックス東京潮見駅前,2024-02-09T01:17:48.159000Z,1707441424,5
274,5,0,35.705774,139.743366,D2-12.ヴィアイン飯田橋後楽園,2024-02-09T01:17:48.160000Z,1707441424,5
275,5,2,35.712952,139.701356,D3-08.ホテルリブマックス高田馬場駅前,2024-02-09T01:17:48.161000Z,1707441424,7
276,10,0,35.680948,139.796917,H1-103.清澄庭園,2024-02-09T01:17:48.163000Z,1707441424,10
277,15,0,35.676488,139.809616,H1-104.木場公園,2024-02-09T01:17:48.166000Z,1707441424,15
278,6,2,35.692277,139.817491,H1-105.猿江恩賜公園,2024-02-09T01:17:48.168000Z,1707441424,8
279,2,1,35.69955,139.803204,G4-07.ディアレイシャス両国,2024-02-09T01:17:48.176000Z,1707441424,3
280,1,8,35.766491,139.587232,T2-46.大泉郵便局バス停自転車駐車場,2024-02-09T01:17:48.180000Z,1707441424,9
281,3,1,35.61379,139.746617,I1-18.東品川公園,2024-02-09T01:17:48.181000Z,1707441424,4
282,5,1,35.650688,139.696696,J1-03.西郷山公園,2024-02-09T01:17:48.182000Z,1707441424,6
283,12,2,35.657718,139.681043,J1-02.駒場野公園,2024-02-09T01:17:48.183000Z,1707441424,14
284,0,5,35.704201,139.735815,D2-14.ローソン 神楽坂駅北店,2024-02-09T01:17:48.183000Z,1707441424,5
285,5,7,35.571711,139.685337,K1-65.下丸子3丁目,2024-02-09T01:17:48.184000Z,1707441424,12
286,8,0,35.7547,139.5871,T2-43.学園通り自転車駐車場,2024-02-09T01:17:48.185000Z,1707441424,8
287,2,0,35.608721,139.714158,I1-46.セブン-イレブン 品川東中延2丁目店,2024-02-09T01:17:48.186000Z,1707441424,2
288,0,11,35.743354,139.606592,T2-04.石神井公園駅南口,2024-02-09T01:17:49.112000Z,1707441424,11
289,11,35,35.642251,139.69692,J1-06.観音橋自転車置場,2024-02-09T01:17:48.193000Z,1707441424,46
290,0,9,35.64853,139.686309,J1-05.東山公園　北,2024-02-09T01:17:48.194000Z,1707441424,9
291,2,0,35.63767,139.7045,J1-45.プラウド中目黒,2024-02-09T01:17:48.195000Z,1707441424,2
292,13,0,35.68642,139.836151,H1-168.大島五丁目公園,2024-02-09T01:17:48.195000Z,1707441424,13
293,12,4,35.61847,139.70019,J1-47.本町みなみ街かど公園,2024-02-09T01:17:48.196000Z,1707441424,16
294,0,8,35.64372,139.68777,J1-48.グランドエクセル祐天寺,2024-02-09T01:17:48.200000Z,1707441424,8
295,1,4,35.599541,139.697962,K1-101.小池公園,2024-02-09T01:17:48.201000Z,1707441424,5
296,8,1,35.672877,139.842339,H1-171.LOGI’Q南砂町,2024-02-09T01:17:48.202000Z,1707441424,9
297,3,6,35.63851,139.823534,H1-153.三井リンクラボ新木場1,2024-02-09T01:17:48.203000Z,1707441424,9
298,0,20,35.631132,139.792726,H1-154.やぐら橋下,2024-02-09T01:17:48.215000Z,1707441424,20
299,3,2,35.514643,139.706285,Z21.コーナン川崎小田栄店,2024-02-09T01:17:48.216000Z,1707441424,5
300,0,11,35.699312,139.696468,D5-11.NTTコミュニケーションズ新宿ビル,2024-02-09T01:17:48.218000Z,1707441424,11
301,0,10,35.626267,139.771438,C5-31.ヒルトン東京お台場,2024-02-09T01:17:48.220000Z,1707441424,10
302,0,16,35.567562,139.766854,K1-78.城南鋳物団地協同組合,2024-02-09T01:17:48.221000Z,1707441424,16
303,6,0,35.513548,139.697176,Z05.ローソン川崎小田二丁目店,2024-02-09T01:17:48.222000Z,1707441424,6
304,4,0,35.600003,139.754288,I1-68.八潮公園第二,2024-02-09T01:17:48.229000Z,1707441424,4
305,4,0,35.601149,139.754284,I1-67.八潮公園第一,2024-02-09T01:17:48.229000Z,1707441424,4
306,0,21,35.634316,139.793199,H1-123.ダイワロイネットホテル東京有明,2024-02-09T01:17:48.230000Z,1707441424,21
307,4,1,35.612389,139.676238,J1-24.ボヌールREIWA,2024-02-09T01:17:48.232000Z,1707441424,5
308,0,26,35.674835,139.785656,B2-12.東京ダイヤビルディング（東側）,2024-02-09T01:17:48.236000Z,1707441424,26
309,15,1,35.614391,139.678396,J1-15.二の橋自転車置場2,2024-02-09T01:17:48.237000Z,1707441424,16
310,4,5,35.684641,139.844243,H1-77.ライフ東砂店,2024-02-09T01:17:48.243000Z,1707441424,9
311,2,1,35.691188,139.712079,D1-09.NTT四谷ビル,2024-02-09T01:17:48.244000Z,1707441424,3
312,0,3,35.727519,139.742815,E4-11.プライマル千石,2024-02-09T01:17:48.245000Z,1707441424,3
313,11,1,35.616114,139.74033,I1-23.東海橋防災船着場,2024-02-09T01:17:48.246000Z,1707441424,12
314,0,35,35.674274,139.759111,A4-12.東京ミッドタウン日比谷,2024-02-09T01:17:48.247000Z,1707441424,35
315,7,5,35.571478,139.702779,K1-46.池上駅前自転車駐車場,2024-02-09T01:17:48.248000Z,1707441424,12
316,11,1,35.593611,139.738056,I1-24.しながわ区民公園(中央口),2024-02-09T01:17:48.257000Z,1707441424,12
317,3,1,35.750414,139.600011,T2-13.セブン-イレブン 練馬石神井町8丁目店,2024-02-09T01:17:48.258000Z,1707441424,4
318,1,1,35.712,139.62816,O3-04.アヴァンセ阿佐ヶ谷,2024-02-09T01:17:48.259000Z,1707441424,2
319,5,6,35.656071,139.780068,B4-01.黎明橋公園（駐輪場）,2024-02-09T01:17:48.260000Z,1707441424,11
320,8,0,35.750761,139.594457,T2-32.セブン-イレブン 練馬東大泉NTTビル店,2024-02-09T01:17:49.863000Z,1707441424,8
321,10,0,35.604567,139.689096,K1-142.コーラル洗足池,2024-02-09T01:17:48.262000Z,1707441424,10
322,3,1,35.574886,139.685122,K1-28.鵜の木特別出張所,2024-02-09T01:17:48.263000Z,1707441424,4
323,5,7,35.755106,139.621675,T1-02.ホテルカデンツァ東京,2024-02-09T01:17:49.485000Z,1707441424,12
324,4,0,35.657264,139.743821,C2-16.ザ・ベルグレイヴィア麻布,2024-02-09T01:17:48.276000Z,1707441424,4
325,4,1,35.711501,139.672761,N3-11.上高田区民活動センター,2024-02-09T01:17:48.277000Z,1707441424,5
326,2,2,35.765979,139.64931,T3-30.北西大松公園,2024-02-09T01:17:49.498000Z,1707441424,4
327,4,2,35.690474,139.690219,D6-05.新宿中央公園（水の広場）,2024-02-09T01:17:48.281000Z,1707441424,6
328,0,13,35.696387,139.689924,D6-07.新宿フロントタワー,2024-02-09T01:17:48.281000Z,1707441424,13
329,2,2,35.734615,139.576214,T2-73.早実グラウンド記念公園,2024-02-09T01:17:48.286000Z,1707441424,4
330,3,8,35.67156,139.64609,O7-03.永福町西幸モータープール東,2024-02-09T01:17:48.286000Z,1707441424,11
331,4,0,35.684523,139.720519,D1-03.新左門児童遊園,2024-02-09T01:17:48.287000Z,1707441424,4
332,9,4,35.683448,139.728425,D1-04.四谷見附公園,2024-02-09T01:17:48.289000Z,1707441424,13
333,0,52,35.622356,139.749468,I1-54.天王洲オーシャンスクエア,2024-02-09T01:17:48.290000Z,1707441424,52
334,27,22,35.693602,139.703229,D6-01.新宿区役所本庁舎,2024-02-09T01:17:48.292000Z,1707441424,49
335,31,4,35.693976,139.706134,D6-02.新宿区役所第二分庁舎,2024-02-09T01:17:48.296000Z,1707441424,35
336,0,17,35.691559,139.690029,D6-03.新宿中央公園（ポケットパーク）,2024-02-09T01:17:48.297000Z,1707441424,17
337,7,3,35.686649,139.689821,D6-04.新宿中央公園（ちびっこ広場）,2024-02-09T01:17:48.298000Z,1707441424,10
338,2,3,35.684584,139.734442,A6-21.日本工営ビル,2024-02-09T01:17:48.299000Z,1707441424,5
339,3,0,35.612217,139.708164,I1-77.セブン-イレブン品川西中延1丁目店,2024-02-09T01:17:48.300000Z,1707441424,3
340,1,12,35.759164,139.629466,T1-01.光が丘駅前広場,2024-02-09T01:17:49.700000Z,1707441424,13
341,5,2,35.729615,139.59532,T2-37.上石神井2丁目,2024-02-09T01:17:48.305000Z,1707441424,7
342,3,1,35.603275,139.713428,I1-75.セブン-イレブン品川二葉4丁目店,2024-02-09T01:17:48.308000Z,1707441424,4
343,3,0,35.675049,139.68444,M5-13.セブン-イレブン初台店,2024-02-09T01:17:48.309000Z,1707441424,3
344,7,3,35.683102,139.688852,D6-24.ＮＴＴ東日本 本社ビル,2024-02-09T01:17:48.310000Z,1707441424,10
345,4,18,35.643141,139.777821,H1-134.豊洲ぐるり公園,2024-02-09T01:17:48.312000Z,1707441424,22
346,14,4,35.679001,139.825809,H1-133.北砂2丁目公園,2024-02-09T01:17:48.313000Z,1707441424,18
347,2,3,35.722833,139.734662,E3-08.サガラマンション,2024-02-09T01:17:48.316000Z,1707441424,5
348,1,1,35.700703,139.639985,O4-05.阿佐ヶ谷南1-30,2024-02-09T01:17:48.317000Z,1707441424,2
349,5,0,35.70273,139.65864,O5-06.EXAM高円寺南,2024-02-09T01:17:48.320000Z,1707441424,5
350,3,2,35.710323,139.815215,G2-03.押上１丁目２６-４,2024-02-09T01:17:48.321000Z,1707441424,5
351,9,6,35.587232,139.669519,K1-132.多摩川駅前自転車等駐車場,2024-02-09T01:17:48.322000Z,1707441424,15
352,19,6,35.62413,139.744831,C5-47.oak港南品川,2024-02-09T01:17:48.323000Z,1707441424,25
353,8,6,35.711324,139.711976,D3-15.カースルいずみ,2024-02-09T01:17:48.324000Z,1707441424,14
354,1,1,35.640215,139.755971,C5-15.セブン-イレブン 港区芝浦ふ頭店,2024-02-09T01:17:48.328000Z,1707441424,2
355,4,0,35.640481,139.753659,C5-14.セブン-イレブン 港区汐彩橋店,2024-02-09T01:17:48.329000Z,1707441424,4
356,0,7,35.705244,139.70841,D5-01.新宿コズミックセンター,2024-02-09T01:17:48.338000Z,1707441424,7
357,19,1,35.648596,139.824936,H1-45.夢の島競技場,2024-02-09T01:17:48.340000Z,1707441424,20
358,21,4,35.702746,139.752009,E1-01.後楽橋横,2024-02-09T01:17:48.348000Z,1707441424,25
359,4,1,35.682332,139.78722,B1-15.ロイヤルパークホテル,2024-02-09T01:17:48.349000Z,1707441424,5
360,13,2,35.638927,139.727083,C4-05.白金台駅自転車駐車場,2024-02-09T01:17:48.349000Z,1707441424,15
361,0,13,35.70311,139.754951,E1-02.東京ドーム（ミーツポート）,2024-02-09T01:17:48.350000Z,1707441424,13
362,3,3,35.647237,139.71512,M2-06.あいおいニッセイ同和損保恵比寿ビル,2024-02-09T01:17:48.351000Z,1707441424,6
363,4,0,35.605828,139.680265,J1-12.工大橋下流自転車置場,2024-02-09T01:17:48.352000Z,1707441424,4
364,36,2,35.639571,139.755551,C5-25.NEX-TEC芝浦,2024-02-09T01:17:48.356000Z,1707441424,38
365,0,2,35.689543,139.836394,H1-175.ダイアパレス大島駅前,2024-02-09T01:17:48.357000Z,1707441424,2
366,0,19,35.654757,139.761516,C1-65.東京ポートシティ竹芝,2024-02-09T01:17:48.359000Z,1707441424,19
367,3,2,35.709712,139.601846,O2-03.西荻北5-8-17,2024-02-09T01:17:48.359000Z,1707441424,5
368,0,34,35.67942,139.77004,B2-21.八重洲二丁目北地区広場,2024-02-09T01:17:48.360000Z,1707441424,34
369,25,0,35.60838,139.726587,I1-101.下神明駅前,2024-02-09T01:17:48.366000Z,1707441424,25
370,6,0,35.713018,139.656768,N2-04.野方2丁目,2024-02-09T01:17:48.367000Z,1707441424,6
371,10,3,35.717877,139.654732,N2-05.野方3丁目,2024-02-09T01:17:48.368000Z,1707441424,13
372,4,0,35.582756,139.6925,K1-88.大田久が原西郵便局,2024-02-09T01:17:48.370000Z,1707441424,4
373,11,0,35.634627,139.77663,C5-51.トミンタワー台場一番街,2024-02-09T01:17:49.916000Z,1707441424,11
374,7,2,35.642764,139.741174,C4-10.亀塚公園,2024-02-09T01:17:48.373000Z,1707441424,9
375,12,7,35.664845,139.796643,H1-190.福山通運 東京支店,2024-02-09T01:17:48.375000Z,1707441424,19
376,5,6,35.654289,139.75557,C1-80.浜松町262ビル,2024-02-09T01:17:49.932000Z,1707441424,11
377,4,6,35.670506,139.77854,B2-19.リエトコートアルクスタワー,2024-02-09T01:17:48.378000Z,1707441424,10
378,3,0,35.648765,139.753363,C1-79.髙松コンストラクショングループ 東京本社ビル,2024-02-09T01:17:48.380000Z,1707441424,3
379,9,0,35.644798,139.752697,C5-43.オアーゼ芝浦MJビル,2024-02-09T01:17:48.383000Z,1707441424,9
380,2,5,35.634441,139.687186,J1-44.五本木2丁目,2024-02-09T01:17:48.385000Z,1707441424,7
381,1,2,35.67518,139.77364,B2-17.アーバネックス八丁堀,2024-02-09T01:17:48.386000Z,1707441424,3
382,2,0,35.67464,139.67876,M6-16.パールマンション,2024-02-09T01:17:48.388000Z,1707441424,2
383,7,1,35.700453,139.798978,G4-06.ドムス・スタイル両国,2024-02-09T01:17:48.404000Z,1707441424,8
384,4,1,35.712157,139.815298,G2-04.ラ　ステュディオ押上,2024-02-09T01:17:48.404000Z,1707441424,5
385,2,4,35.768105,139.646049,T3-15.セブン-イレブン練馬北町8丁目店,2024-02-09T01:17:48.408000Z,1707441424,6
386,16,1,35.65513,139.749645,C1-77.芝公園,2024-02-09T01:17:48.410000Z,1707441424,17
387,0,26,35.620699,139.730904,I1-27.小関橋公園,2024-02-09T01:17:48.411000Z,1707441424,26
388,0,14,35.670855,139.772052,B3-01.中央区役所,2024-02-09T01:17:48.413000Z,1707441424,14
389,3,2,35.685489,139.734562,A6-08.二番町ガーデン,2024-02-09T01:17:48.414000Z,1707441424,5
390,0,7,35.691058,139.777915,B1-01.十思公園,2024-02-09T01:17:48.416000Z,1707441424,7
391,20,7,35.662197,139.782719,B4-02.月島特別出張所,2024-02-09T01:17:48.418000Z,1707441424,27
392,0,36,35.685938,139.764886,A4-05.大手町タワー,2024-02-09T01:17:48.419000Z,1707441424,36
393,23,47,35.6447,139.784512,H1-22.豊洲市場（7街区）,2024-02-09T01:17:48.424000Z,1707441424,70
394,0,7,35.685966,139.736328,A6-07.二番町センタービル,2024-02-09T01:17:48.426000Z,1707441424,7
395,0,14,35.694532,139.760695,A2-12.神保町三井ビルディング,2024-02-09T01:17:48.427000Z,1707441424,14
396,0,3,35.713991,139.725665,E2-06.oto no ha Cafe,2024-02-09T01:17:48.428000Z,1707441424,3
397,8,0,35.668795,139.784784,B4-10.リバーシティ,2024-02-09T01:17:48.433000Z,1707441424,8
398,6,3,35.688405,139.770068,B1-03.常盤公園（北側）,2024-02-09T01:17:48.435000Z,1707441424,9
399,7,0,35.645537,139.754899,C5-19.グランドメゾン田町,2024-02-09T01:17:48.438000Z,1707441424,7
400,1,1,35.558289,139.697403,K1-11.ファミリーマート かわだ多摩川２丁目店,2024-02-09T01:17:48.440000Z,1707441424,2
401,0,14,35.63237,139.712681,J1-43.アルコタワー・ホテル雅叙園東京,2024-02-09T01:17:48.446000Z,1707441424,14
402,6,3,35.721827,139.635949,N1-03.鷺宮南駐輪場,2024-02-09T01:17:48.447000Z,1707441424,9
403,6,0,35.72515,139.672614,N2-06.江古田1丁目B,2024-02-09T01:17:48.449000Z,1707441424,6
404,3,2,35.715538,139.701683,D7-12.プラウド高田馬場,2024-02-09T01:17:48.450000Z,1707441424,5
405,2,7,35.580741,139.687152,K1-118.久が原3丁目,2024-02-09T01:17:48.452000Z,1707441424,9
406,1,1,35.571866,139.703214,K1-125.池上駅南口第1,2024-02-09T01:17:48.458000Z,1707441424,2
407,15,4,35.581798,139.695222,K1-117.安詳寺,2024-02-09T01:17:48.463000Z,1707441424,19
408,8,1,35.634019,139.719749,I1-91.アクロス目黒タワー,2024-02-09T01:17:50.286000Z,1707441424,9
409,0,3,35.571815,139.702387,K1-126.池上駅南口第2,2024-02-09T01:17:48.467000Z,1707441424,3
410,12,0,35.633133,139.777315,C5-50.お台場レインボー公園,2024-02-09T01:17:48.468000Z,1707441424,12
411,0,8,35.73701,139.627244,T3-26.富士見ランド公園,2024-02-09T01:17:49.136000Z,1707441424,8
412,3,1,35.765144,139.636606,T1-15.つのの山緑地,2024-02-09T01:17:48.478000Z,1707441424,4
413,3,1,35.767582,139.636304,T1-16.ゆりの木通り南公園,2024-02-09T01:17:48.480000Z,1707441424,4
414,4,0,35.690038,139.833252,H1-185.UR大島六丁目団地(第二),2024-02-09T01:17:48.488000Z,1707441424,4
415,0,6,35.694804,139.831357,H1-186.セブン-イレブン亀戸昭和橋通り店,2024-02-09T01:17:48.494000Z,1707441424,6
416,2,12,35.586408,139.705425,K1-96.西馬込駅前自転車駐車場,2024-02-09T01:17:48.496000Z,1707441424,14
417,3,1,35.689913,139.833279,H1-184.UR大島六丁目団地(第一),2024-02-09T01:17:48.497000Z,1707441424,4
418,0,4,35.679192,139.74019,A6-25.麹町仮住宅,2024-02-09T01:17:48.509000Z,1707441424,4
419,1,3,35.662908,139.755014,C1-69.塩釜公園,2024-02-09T01:17:48.513000Z,1707441424,4
420,27,1,35.665214,139.757008,C1-68.桜田公園,2024-02-09T01:17:48.514000Z,1707441424,28
421,0,16,35.6927,139.759311,A2-14.興和一橋ビル,2024-02-09T01:17:48.515000Z,1707441424,16
422,5,0,35.639644,139.745532,C5-41.トヨタモビリティ東京 芝浦店,2024-02-09T01:17:48.516000Z,1707441424,5
423,5,0,35.731909,139.579685,T2-22.ファミリーマート 石神井台7丁目店,2024-02-09T01:17:48.516000Z,1707441424,5
424,0,11,35.68369,139.736936,A6-20.紀尾井町PREX,2024-02-09T01:17:48.517000Z,1707441424,11
425,15,0,35.647713,139.755534,C5-24.GLOBAL FRONT TOWER,2024-02-09T01:17:48.518000Z,1707441424,15
426,13,1,35.70861,139.75768,E5-09.文京区 男女平等センター,2024-02-09T01:17:48.523000Z,1707441424,14
427,4,17,35.563874,139.685011,K1-37.東京サーハウス前,2024-02-09T01:17:48.528000Z,1707441424,21
428,6,1,35.669188,139.785301,B4-15.リバーシティ　イーストタワーズ,2024-02-09T01:17:48.532000Z,1707441424,7
429,11,1,35.682453,139.677687,M6-08.Be Good 幡ヶ谷,2024-02-09T01:17:48.533000Z,1707441424,12
430,14,1,35.702277,139.701214,D5-09.ハウジングステージ新宿,2024-02-09T01:17:48.534000Z,1707441424,15
431,5,1,35.691613,139.711233,D6-21.新宿5丁目,2024-02-09T01:17:48.536000Z,1707441424,6
432,0,28,35.581752,139.748705,K1-39.東京モノレール 流通センター駅前,2024-02-09T01:17:48.539000Z,1707441424,28
433,9,0,35.558916,139.717253,K1-38.ネクストサイト蒲田ビル,2024-02-09T01:17:48.540000Z,1707441424,9
434,4,1,35.735585,139.652544,T3-17.練馬区役所東庁舎(第二),2024-02-09T01:17:48.542000Z,1707441424,5
435,7,20,35.692641,139.846346,H1-107.大島小松川公園,2024-02-09T01:17:48.550000Z,1707441424,27
436,37,10,35.684158,139.787649,B1-11.浜町川緑道,2024-02-09T01:17:48.556000Z,1707441424,47
437,10,2,35.685578,139.732078,A6-19.番町麹町ビルディング,2024-02-09T01:17:48.557000Z,1707441424,12
438,8,9,35.665254,139.769301,B3-12.築地場外市場,2024-02-09T01:17:48.558000Z,1707441424,17
439,20,6,35.622371,139.737457,I1-40.御殿山トラストタワー,2024-02-09T01:17:48.560000Z,1707441424,26
440,2,0,35.668091,139.680243,M5-08.古賀政男音楽博物館,2024-02-09T01:17:48.562000Z,1707441424,2
441,1,4,35.655102,139.805205,H1-90.富士倉庫運輸(株) FACE-1前,2024-02-09T01:17:48.563000Z,1707441424,5
442,0,5,35.695163,139.769566,A3-38.パークホームズ千代田淡路町,2024-02-09T01:17:48.567000Z,1707441424,5
443,4,2,35.702833,139.739,D2-11.神楽坂アインスタワー,2024-02-09T01:17:48.568000Z,1707441424,6
444,3,1,35.656991,139.740739,C2-04.飯倉いきいきプラザ,2024-02-09T01:17:48.570000Z,1707441424,4
445,12,4,35.686101,139.776089,B1-09.スマイルホテル日本橋三越前,2024-02-09T01:17:48.580000Z,1707441424,16
446,10,1,35.726499,139.759884,E5-15.文京千駄木の郷,2024-02-09T01:17:48.597000Z,1707441424,11
447,13,0,35.651046,139.727745,C2-05.ありすいきいきプラザ,2024-02-09T01:17:48.598000Z,1707441424,13
448,5,15,35.632303,139.742393,C5-06.品川シーズンテラス,2024-02-09T01:17:48.600000Z,1707441424,20
449,9,0,35.680833,139.784267,B1-10.箱崎川第二公園,2024-02-09T01:17:48.601000Z,1707441424,9
450,0,3,35.663222,139.587803,L1-15.ソフィア,2024-02-09T01:17:48.217000Z,1707441424,3
451,0,14,35.70111,139.772855,A3-12.秋葉原UDX北側駐輪場前,2024-02-09T01:17:48.625000Z,1707441424,14
452,2,8,35.700568,139.76013,A2-08.KDX御茶ノ水ビル,2024-02-09T01:17:48.632000Z,1707441424,10
453,0,14,35.696942,139.767302,A3-07.淡路公園,2024-02-09T01:17:48.634000Z,1707441424,14
454,4,5,35.699132,139.74462,A1-08.飯田橋サクラテラス（早稲田通り）,2024-02-09T01:17:47.946000Z,1707441424,9
455,1,18,35.700486,139.774254,A3-13.富士ソフトビル（駐車場入口横）,2024-02-09T01:17:48.637000Z,1707441424,19
456,0,8,35.6931,139.7599,A2-09.テラススクエア,2024-02-09T01:17:48.645000Z,1707441424,8
457,0,23,35.67962,139.7364,A6-11.東京ガーデンテラス紀尾井町,2024-02-09T01:17:48.647000Z,1707441424,23
458,5,1,35.564161,139.695187,K1-124.矢口2丁目,2024-02-09T01:17:48.650000Z,1707441424,6
459,0,3,35.71046,139.6855,N3-15.ライオンズマンション中野東,2024-02-09T01:17:48.652000Z,1707441424,3
460,9,0,35.65718,139.698687,M3-11.渋谷道玄坂東急ビル,2024-02-09T01:17:48.655000Z,1707441424,9
461,6,2,35.691954,139.836462,H1-180.シティコート大島,2024-02-09T01:17:48.656000Z,1707441424,8
462,23,4,35.68973,139.77598,B1-27.日本橋本町4丁目,2024-02-09T01:17:48.658000Z,1707441424,27
463,14,0,35.64514,139.71686,M3-22.森谷ビル,2024-02-09T01:17:48.660000Z,1707441424,14
464,10,0,35.70862,139.680679,N3-17.東中野3丁目,2024-02-09T01:17:48.661000Z,1707441424,10
465,0,5,35.733432,139.671241,N2-10.関根ビル,2024-02-09T01:17:48.662000Z,1707441424,5
466,3,2,35.762326,139.635226,T1-06.秋の陽公園,2024-02-09T01:17:48.664000Z,1707441424,5
467,0,12,35.721556,139.640397,N1-02.鷺宮東駐輪場,2024-02-09T01:17:48.665000Z,1707441424,12
468,2,12,35.586382,139.705116,K1-140.西馬込駅前自転車駐車場(奥),2024-02-09T01:17:48.667000Z,1707441424,14
469,10,4,35.695695,139.820507,H1-182.錦糸町プライムタワー,2024-02-09T01:17:48.668000Z,1707441424,14
470,9,0,35.728644,139.752183,E5-05.駒込地域活動センター,2024-02-09T01:17:48.673000Z,1707441424,9
471,0,10,35.657556,139.704129,M3-06.渋谷第一生命ビル,2024-02-09T01:17:48.675000Z,1707441424,10
472,1,4,35.74553,139.608939,T2-42.石神井公園駅北第二自転車駐車場,2024-02-09T01:17:48.676000Z,1707441424,5
473,8,1,35.559809,139.716993,K1-144.蒲田五丁目44番自転車駐車場,2024-02-09T01:17:48.682000Z,1707441424,9
474,5,5,35.65506,139.69384,M3-07.渋谷ファーストプレイス,2024-02-09T01:17:48.683000Z,1707441424,10
475,3,7,35.63848,139.832305,H1-74.タダノ教習センター,2024-02-09T01:17:48.692000Z,1707441424,10
476,0,3,35.532615,139.700332,Z22.みんちゅう京急川崎駅前駐輪場内ラックスペース,2024-02-09T01:17:48.693000Z,1707441424,3
477,7,2,35.701347,139.819973,H1-151.コスモリード錦糸町,2024-02-09T01:17:48.695000Z,1707441424,9
478,6,0,35.750185,139.579216,T2-23.セブン-イレブン 練馬南大泉5丁目店,2024-02-09T01:17:48.699000Z,1707441424,6
479,1,2,35.66616,139.70458,M4-13.J-cube,2024-02-09T01:17:48.701000Z,1707441424,3
480,4,1,35.734805,139.599906,T2-65.さくらの辻公園,2024-02-09T01:17:48.702000Z,1707441424,5
481,0,23,35.754586,139.606409,T2-24.セブン-イレブン 練馬インター店,2024-02-09T01:17:48.704000Z,1707441424,23
482,0,2,35.701454,139.650518,O5-05.モンテ・ベルテ,2024-02-09T01:17:48.706000Z,1707441424,2
483,7,2,35.618622,139.67596,J1-42.都立大学駅北口バス停前,2024-02-09T01:17:48.709000Z,1707441424,9
484,13,0,35.555561,139.704345,K1-97.トミンタワー多摩川二丁目,2024-02-09T01:17:48.712000Z,1707441424,13
485,2,2,35.68752,139.72818,D1-14.コモレ四谷,2024-02-09T01:17:48.714000Z,1707441424,4
486,5,4,35.599329,139.703343,K1-106.ファミリーマート上池台夫婦坂店,2024-02-09T01:17:48.715000Z,1707441424,9
487,3,4,35.655483,139.687325,J1-39.松見坂公園,2024-02-09T01:17:48.716000Z,1707441424,7
488,5,2,35.616541,139.697369,J1-40.西小山公園,2024-02-09T01:17:48.717000Z,1707441424,7
489,13,0,35.626355,139.700153,J1-38.林試の森公園 北,2024-02-09T01:17:48.719000Z,1707441424,13
490,0,4,35.613819,139.728418,I1-84.セブン-イレブン西品川2丁目店,2024-02-09T01:17:48.893000Z,1707441424,4
491,7,2,35.694951,139.708219,D6-26.セブン-イレブン新宿６丁目文化センター通り店,2024-02-09T01:17:48.722000Z,1707441424,9
492,0,5,35.746045,139.620087,T2-25.ファミリーマート 高野台二丁目店,2024-02-09T01:17:48.723000Z,1707441424,5
493,4,1,35.621081,139.741178,I1-85.GOODOFFICE品川,2024-02-09T01:17:48.724000Z,1707441424,5
494,0,9,35.587423,139.753871,K1-74.大田スタジアム,2024-02-09T01:17:48.727000Z,1707441424,9
495,0,5,35.669941,139.749261,C1-64.東京虎ノ門グローバルスクエア,2024-02-09T01:17:48.729000Z,1707441424,5
496,4,0,35.573358,139.723105,K1-72.ファミリーマート大森西四丁目店,2024-02-09T01:17:48.732000Z,1707441424,4
497,6,5,35.69839,139.825484,H1-118.ファミリーマート亀戸駅前店,2024-02-09T01:17:48.735000Z,1707441424,11
498,4,0,35.622277,139.745638,I1-62.天王洲Rim,2024-02-09T01:17:48.736000Z,1707441424,4
499,1,3,35.674076,139.795008,H1-40.深川東京モダン館,2024-02-09T01:17:48.738000Z,1707441424,4
500,8,3,35.671225,139.808561,H1-117.東京パークサイドビル,2024-02-09T01:17:48.739000Z,1707441424,11
501,7,2,35.640675,139.698088,J1-01.目黒区総合庁舎,2024-02-09T01:17:48.743000Z,1707441424,9
502,0,23,35.626704,139.742174,C5-16.品川インターシティ,2024-02-09T01:17:48.944000Z,1707441424,23
503,6,1,35.695515,139.750213,A1-12.北の丸スクエア,2024-02-09T01:17:48.746000Z,1707441424,7
504,4,0,35.659287,139.807358,H1-46.セブン-イレブン 江東枝川2丁目店,2024-02-09T01:17:48.747000Z,1707441424,4
505,4,9,35.698991,139.76091,A2-25.プラウド神田駿河台,2024-02-09T01:17:48.748000Z,1707441424,13
506,9,0,35.638912,139.747422,C5-49.プラウドタワー芝浦,2024-02-09T01:17:48.750000Z,1707441424,9
507,2,2,35.767627,139.65243,T3-25.北町みのり公園,2024-02-09T01:17:48.751000Z,1707441424,4
508,10,0,35.684247,139.815638,H1-75.ジオ深川住吉,2024-02-09T01:17:48.753000Z,1707441424,10
509,4,1,35.765704,139.625178,T1-09.ローソン練馬旭町一丁目店,2024-02-09T01:17:48.756000Z,1707441424,5
510,0,5,35.767388,139.587625,T2-26.ファミリーマート 大泉学園町四丁目店,2024-02-09T01:17:48.757000Z,1707441424,5
511,4,1,35.773841,139.591456,T2-27.ファミリーマート 大泉長久保通り店,2024-02-09T01:17:48.759000Z,1707441424,5
512,0,9,35.678179,139.720809,C3-19.明治記念館西,2024-02-09T01:17:48.765000Z,1707441424,9
513,13,1,35.603984,139.744504,I1-11.鮫洲入江広場,2024-02-09T01:17:48.767000Z,1707441424,14
514,9,9,35.607717,139.749478,I1-10.品川シーサイド公園第1,2024-02-09T01:17:48.768000Z,1707441424,18
515,7,0,35.616633,139.748945,I1-09.東品川海上公園第1,2024-02-09T01:17:48.770000Z,1707441424,7
516,2,3,35.713872,139.698301,D3-06.セブン-イレブン高田馬場3丁目中央店,2024-02-09T01:17:48.771000Z,1707441424,5
517,4,1,35.579649,139.720263,K1-40.大田文化の森,2024-02-09T01:17:48.773000Z,1707441424,5
518,3,4,35.658709,139.757036,C1-41.港区立エコプラザ,2024-02-09T01:17:48.774000Z,1707441424,7
519,0,13,35.613421,139.75375,I1-13.八潮北公園,2024-02-09T01:17:48.776000Z,1707441424,13
520,5,0,35.596091,139.740884,I1-12.しながわ区民公園（北側）,2024-02-09T01:17:48.777000Z,1707441424,5
521,6,4,35.763741,139.588847,T2-09.こぐれの森緑地,2024-02-09T01:17:48.779000Z,1707441424,10
522,7,1,35.74097,139.63836,T3-31.パークサイド関口,2024-02-09T01:17:48.781000Z,1707441424,8
523,0,7,35.643958,139.838358,H1-183.MFLP新木場1,2024-02-09T01:17:48.782000Z,1707441424,7
524,2,4,35.74642,139.581204,T2-33.ウインドヒルズ189,2024-02-09T01:17:48.783000Z,1707441424,6
525,1,4,35.761211,139.603316,T2-67.陽和病院,2024-02-09T01:17:48.785000Z,1707441424,5
526,0,6,35.683514,139.827081,H1-82.セブンｰイレブン 北砂3丁目明治通り店,2024-02-09T01:17:48.786000Z,1707441424,6
527,9,0,35.724747,139.565817,T2-60.武蔵関公園（第一）,2024-02-09T01:17:48.788000Z,1707441424,9
528,6,2,35.632191,139.725002,I1-48.NTT 東日本 関東病院(北側),2024-02-09T01:17:48.720000Z,1707441424,8
529,3,2,35.716776,139.577975,T2-58.立野公園,2024-02-09T01:17:48.791000Z,1707441424,5
530,7,0,35.610444,139.712333,I1-100.東急荏原中延駅駐輪場,2024-02-09T01:17:48.792000Z,1707441424,7
531,3,1,35.77228,139.58325,T2-56.大泉公園（第一）,2024-02-09T01:17:48.794000Z,1707441424,4
532,1,2,35.767296,139.602321,T2-55.大泉町もみじやま公園,2024-02-09T01:17:48.795000Z,1707441424,3
533,4,5,35.760939,139.609264,T2-54.土支田農業公園,2024-02-09T01:17:48.797000Z,1707441424,9
534,6,1,35.604606,139.734483,I1-44.大井三ツ又商店街入口,2024-02-09T01:17:48.799000Z,1707441424,7
535,6,4,35.746681,139.57754,T2-62.大泉井頭公園,2024-02-09T01:17:48.800000Z,1707441424,10
536,4,0,35.727826,139.570056,T2-61.武蔵関公園（第二）,2024-02-09T01:17:48.802000Z,1707441424,4
537,5,0,35.730428,139.648704,T3-09.学田公園,2024-02-09T01:17:48.803000Z,1707441424,5
538,0,9,35.555702,139.740802,K1-105.東糀谷二丁目児童公園,2024-02-09T01:17:48.805000Z,1707441424,9
539,4,2,35.513644,139.712594,Z02.NTT渡田ビル,2024-02-09T01:17:48.806000Z,1707441424,6
540,8,4,35.759827,139.659121,T3-04.サンパレス平和台,2024-02-09T01:17:48.808000Z,1707441424,12
541,4,2,35.543573,139.714393,K1-104.六郷BASE,2024-02-09T01:17:48.809000Z,1707441424,6
542,2,0,35.668673,139.702816,M4-16.神宮前6丁目,2024-02-09T01:17:48.811000Z,1707441424,2
543,4,0,35.585747,139.735242,K1-69.京急平和島第2Bバイク駐輪場,2024-02-09T01:17:48.812000Z,1707441424,4
544,0,54,35.645726,139.784496,H1-155.メブクス豊洲,2024-02-09T01:17:48.814000Z,1707441424,54
545,27,26,35.654726,139.737491,C2-11.一の橋,2024-02-09T01:17:48.815000Z,1707441424,53
546,13,0,35.64816,139.737991,C4-11.ザ・パークハウス 三田ガーデン,2024-02-09T01:17:48.816000Z,1707441424,13
547,6,0,35.684003,139.794983,H1-161.昭文社制作本部ビル,2024-02-09T01:17:48.818000Z,1707441424,6
548,3,2,35.714292,139.663327,N2-07.新井区民活動センター,2024-02-09T01:17:48.819000Z,1707441424,5
549,0,12,35.547061,139.756277,K1-87.羽田イノベーションシティ,2024-02-09T01:17:48.824000Z,1707441424,12
550,5,0,35.699743,139.664608,N3-16.COURT 5,2024-02-09T01:17:48.825000Z,1707441424,5
551,4,7,35.641833,139.734519,C4-01.高輪地区総合支所(5F),2024-02-09T01:17:48.828000Z,1707441424,11
552,5,3,35.636808,139.752517,C5-48.セブンイレブン港区海岸三丁目店,2024-02-09T01:17:49.542000Z,1707441424,8
553,20,1,35.683961,139.821559,H1-42.江東区スポーツ会館,2024-02-09T01:17:48.832000Z,1707441424,21
554,0,12,35.675702,139.785229,B2-10.東京ダイヤビルディング（北側）,2024-02-09T01:17:48.834000Z,1707441424,12
555,1,9,35.675639,139.815255,H1-43.東京イースト21,2024-02-09T01:17:48.835000Z,1707441424,10
556,0,7,35.670106,139.768041,B3-20.歌舞伎座タワー駐輪場2F,2024-02-09T01:17:48.836000Z,1707441424,7
557,3,7,35.6701,139.76801,B3-21.歌舞伎座タワー駐輪場3F,2024-02-09T01:17:48.838000Z,1707441424,10
558,5,8,35.537434,139.744509,Z06.ローソン川崎殿町店,2024-02-09T01:17:48.842000Z,1707441424,13
559,8,2,35.548104,139.748889,K1-139.プラットホステル京急 羽田ホーム,2024-02-09T01:17:48.843000Z,1707441424,10
560,3,0,35.629011,139.69716,J1-58.目黒女子会館前,2024-02-09T01:17:48.845000Z,1707441424,3
561,4,0,35.745505,139.580878,T2-18.ファミリーマート練馬西税務署前店,2024-02-09T01:17:48.382000Z,1707441424,4
562,11,17,35.669916,139.725701,C3-23.LIFORK 南青山 北エントランス,2024-02-09T01:17:48.848000Z,1707441424,28
563,6,11,35.665124,139.754054,C1-46.新虎通りCORE,2024-02-09T01:17:48.849000Z,1707441424,17
564,16,0,35.656324,139.755927,C1-45.浜松町クレアタワー,2024-02-09T01:17:48.851000Z,1707441424,16
565,20,0,35.589309,139.678587,K1-53.セブン-イレブン 田園調布郵便局前店,2024-02-09T01:17:48.854000Z,1707441424,20
566,7,0,35.564152,139.727422,K1-52.大田区総合体育館,2024-02-09T01:17:48.855000Z,1707441424,7
567,1,3,35.756873,139.616612,T1-12.ファミリーマート 高松六丁目店,2024-02-09T01:17:48.857000Z,1707441424,4
568,5,0,35.725171,139.675897,D7-07.ローソン 新宿西落合三丁目店,2024-02-09T01:17:48.859000Z,1707441424,5
569,4,1,35.688351,139.744321,A6-16.一番町第二TGビル,2024-02-09T01:17:48.861000Z,1707441424,5
570,13,0,35.667462,139.716058,C3-33.PASONA SQUARE,2024-02-09T01:17:48.862000Z,1707441424,13
571,2,0,35.69441,139.777715,A3-24.岩本町ほほえみプラザ,2024-02-09T01:17:48.864000Z,1707441424,2
572,1,4,35.652376,139.797724,H1-35.ヒューリック豊洲プライムスクエア,2024-02-09T01:17:48.865000Z,1707441424,5
573,10,0,35.631729,139.749767,C5-11.フェイバリッチタワー品川,2024-02-09T01:17:48.867000Z,1707441424,10
574,5,0,35.70781,139.732227,E2-13.デルックス文京神楽坂,2024-02-09T01:17:48.868000Z,1707441424,5
575,0,46,35.629697,139.742167,C5-01.こうなん星の公園,2024-02-09T01:17:48.870000Z,1707441424,46
576,42,0,35.628955,139.750731,C5-02.港南緑水公園,2024-02-09T01:17:48.871000Z,1707441424,42
577,7,0,35.693234,139.779702,A3-22.龍閑児童公園,2024-02-09T01:17:48.873000Z,1707441424,7
578,12,1,35.695176,139.772832,A3-21.神田ふれあい通り第３,2024-02-09T01:17:48.875000Z,1707441424,13
579,0,12,35.67338,139.8164,H1-30.江東区役所（北側）,2024-02-09T01:17:48.877000Z,1707441424,12
580,1,3,35.657866,139.751068,C1-17.港区役所,2024-02-09T01:17:48.878000Z,1707441424,4
581,3,13,35.67214,139.8166,H1-31.江東区役所（南側）,2024-02-09T01:17:48.883000Z,1707441424,16
582,0,26,35.662051,139.748132,C1-09.愛宕グリーンヒルズ,2024-02-09T01:17:48.885000Z,1707441424,26
583,8,9,35.687435,139.714169,D1-02.四谷特別出張所（新宿御苑大木戸門前）,2024-02-09T01:17:50.023000Z,1707441424,17
584,2,3,35.690612,139.711631,D1-01.花園西公園,2024-02-09T01:17:48.890000Z,1707441424,5
585,0,41,35.666527,139.748804,C1-04.虎ノ門ヒルズ,2024-02-09T01:17:48.891000Z,1707441424,41
586,6,7,35.665593,139.752617,C1-05.西新橋2丁目（新虎通り）,2024-02-09T01:17:48.892000Z,1707441424,13
587,1,13,35.669871,139.753147,C1-73.日比谷フォートタワー,2024-02-09T01:17:48.895000Z,1707441424,14
588,5,1,35.595119,139.6996,K1-102.上池台四丁目公園,2024-02-09T01:17:48.896000Z,1707441424,6
589,6,3,35.64524,139.71946,M2-01.恵比寿保健相談所（恵比寿社会教育館）,2024-02-09T01:17:48.898000Z,1707441424,9
590,4,2,35.60411,139.709784,I1-98.コーポ荏原,2024-02-09T01:17:48.899000Z,1707441424,6
591,0,41,35.670308,139.743242,C3-17.セブン-イレブン 港区溜池山王店,2024-02-09T01:17:48.901000Z,1707441424,41
592,3,0,35.739471,139.595578,T2-11.石神井松の風文化公園,2024-02-09T01:17:48.902000Z,1707441424,3
593,5,10,35.646581,139.710613,M2-03.サイカパーク恵比寿,2024-02-09T01:17:48.906000Z,1707441424,15
594,0,8,35.643606,139.713099,M2-02.アメリカ橋公園,2024-02-09T01:17:48.907000Z,1707441424,8
595,7,2,35.72305,139.579555,T2-50.North Ridge 吉祥寺,2024-02-09T01:17:48.909000Z,1707441424,9
596,3,3,35.634574,139.710332,J1-35.目黒川田道街かど公園,2024-02-09T01:17:48.920000Z,1707441424,6
597,1,1,35.682712,139.823961,H1-174.ジュネス(エントランス側),2024-02-09T01:17:49.464000Z,1707441424,2
598,7,0,35.672922,139.668729,M6-17.笹塚一丁目駐輪場,2024-02-09T01:17:48.945000Z,1707441424,7
599,5,5,35.643711,139.724753,C4-14.神応ほっとプラザ,2024-02-09T01:17:48.946000Z,1707441424,10
600,5,4,35.596854,139.712139,K1-107.馬込駅A2出口,2024-02-09T01:17:48.948000Z,1707441424,9
601,1,2,35.740321,139.631256,T3-11.ガラクタ公園,2024-02-09T01:17:48.949000Z,1707441424,3
602,3,2,35.756825,139.590528,T2-80.みその緑地,2024-02-09T01:17:48.964000Z,1707441424,5
603,5,2,35.743962,139.670315,T3-24.AZEST新桜台,2024-02-09T01:17:48.965000Z,1707441424,7
604,4,1,35.698512,139.716482,D4-07.新宿余丁町ビル,2024-02-09T01:17:48.974000Z,1707441424,5
605,0,9,35.524976,139.697495,Z23.NA川崎南町,2024-02-09T01:17:48.975000Z,1707441424,9
606,3,4,35.751438,139.641265,T3-01.練馬春日町駅自転車駐車場,2024-02-09T01:17:48.984000Z,1707441424,7
607,0,24,35.637041,139.781088,H1-89.BUDDY スポーツアリーナ,2024-02-09T01:17:48.992000Z,1707441424,24
608,0,20,35.707313,139.771857,E5-14.上野広小路駅（湯島側）,2024-02-09T01:17:49Z,1707441424,20
609,5,0,35.648008,139.803487,H1-109.Brillia ist 東雲キャナルコート東側,2024-02-09T01:17:47.707000Z,1707441424,5
610,8,0,35.648431,139.803125,H1-108.Brillia ist 東雲キャナルコート北側,2024-02-09T01:17:47.709000Z,1707441424,8
611,2,1,35.661149,139.754612,C1-53.ホテルリブマックス新橋,2024-02-09T01:17:49.021000Z,1707441424,3
612,6,0,35.715211,139.689788,D7-10.染の里 おちあい,2024-02-09T01:17:49.053000Z,1707441424,6
613,2,0,35.697167,139.745629,A1-15.富士見みらい館,2024-02-09T01:17:49.054000Z,1707441424,2
614,4,1,35.729153,139.741368,E4-15.千石4丁目,2024-02-09T01:17:49.066000Z,1707441424,5
615,1,1,35.66688,139.80779,H1-111.ファミリーマート木場六丁目店,2024-02-09T01:17:49.067000Z,1707441424,2
616,0,3,35.62974,139.778178,C5-36.お台場海浜公園駅,2024-02-09T01:17:49.090000Z,1707441424,3
617,10,5,35.625029,139.777344,H1-10.出会い橋,2024-02-09T01:17:49.090000Z,1707441424,15
618,0,35,35.61813,139.778698,H1-11.テレコムセンター駅,2024-02-09T01:17:49.091000Z,1707441424,35
619,0,15,35.672481,139.835877,H1-47.トピレックプラザ,2024-02-09T01:17:49.109000Z,1707441424,15
620,3,16,35.654067,139.792376,H1-13.アーバンドック ららぽーと豊洲,2024-02-09T01:17:49.111000Z,1707441424,19
621,0,4,35.778605,139.588883,T2-66.大泉学園町希望ヶ丘公園,2024-02-09T01:17:48.073000Z,1707441424,4
622,0,31,35.626388,139.772453,C5-37.台場駅,2024-02-09T01:17:49.113000Z,1707441424,31
623,0,84,35.657477,139.796629,H1-16.豊洲三丁目公園,2024-02-09T01:17:49.114000Z,1707441424,84
624,23,0,35.64704,139.80469,H1-17.東雲水辺公園,2024-02-09T01:17:49.115000Z,1707441424,23
625,9,0,35.646307,139.746428,C1-72.新田町ビル,2024-02-09T01:17:49.122000Z,1707441424,9
626,3,4,35.577433,139.680752,K1-98.鵜の木松山公園,2024-02-09T01:17:49.123000Z,1707441424,7
627,0,12,35.65583,139.759896,C1-71.芝商業高校前交差点,2024-02-09T01:17:49.124000Z,1707441424,12
628,5,6,35.679167,139.839746,H1-122.東砂スポーツセンター,2024-02-09T01:17:49.125000Z,1707441424,11
629,0,5,35.687531,139.60439,O6-05.コージーコート久我山,2024-02-09T01:17:49.126000Z,1707441424,5
630,3,5,35.758929,139.597548,T2-39.ローソン 練馬大泉町五丁目店,2024-02-09T01:17:49.127000Z,1707441424,8
631,4,0,35.609958,139.684087,J1-50.大岡山公園,2024-02-09T01:17:49.132000Z,1707441424,4
632,1,4,35.650627,139.687228,J1-51.池尻大橋駅東口駐輪場,2024-02-09T01:17:49.133000Z,1707441424,5
633,7,0,35.584086,139.67898,K1-99.東原くすのき公園,2024-02-09T01:17:49.133000Z,1707441424,7
634,1,2,35.702414,139.667327,N3-12.桃園区民活動センター,2024-02-09T01:17:49.135000Z,1707441424,3
635,12,2,35.644863,139.831107,H1-191.三井リンクラボ新木場2,2024-02-09T01:17:49.231000Z,1707441424,14
636,0,8,35.66865,139.679251,M5-09.代々木上原駅前,2024-02-09T01:17:49.137000Z,1707441424,8
637,6,1,35.714151,139.61693,O3-09.NTT井草ビル第3ポート,2024-02-09T01:17:49.138000Z,1707441424,7
638,6,4,35.765913,139.619285,T1-07.土支田一丁目（笹目通り）,2024-02-09T01:17:49.140000Z,1707441424,10
639,5,0,35.562324,139.690486,K1-22.矢口特別出張所,2024-02-09T01:17:49.141000Z,1707441424,5
640,6,1,35.728268,139.649188,T3-08.中新井川児童遊園,2024-02-09T01:17:49.142000Z,1707441424,7
641,9,5,35.645604,139.834941,H1-78.ローソン新木場一丁目店,2024-02-09T01:17:49.145000Z,1707441424,14
642,3,3,35.689131,139.733071,A6-13.番町会館,2024-02-09T01:17:49.146000Z,1707441424,6
643,0,12,35.670906,139.819386,H1-71.セブン-イレブン 江東東陽4丁目,2024-02-09T01:17:49.146000Z,1707441424,12
644,3,0,35.700993,139.736355,D2-09.セブン-イレブン 新宿岩戸町店,2024-02-09T01:17:49.148000Z,1707441424,3
645,3,27,35.622294,139.751644,I1-08.天王洲アイル第一水辺広場,2024-02-09T01:17:49.149000Z,1707441424,30
646,16,0,35.590641,139.736354,I1-07.しながわ水族館,2024-02-09T01:17:49.152000Z,1707441424,16
647,4,0,35.712545,139.713319,D3-09.西早稲田3丁目,2024-02-09T01:17:49.153000Z,1707441424,4
648,8,13,35.714338,139.746346,E1-16.小石川3丁目緑地,2024-02-09T01:17:49.154000Z,1707441424,21
649,6,1,35.643683,139.7506,C5-28.芝浦ルネサイトタワー,2024-02-09T01:17:49.156000Z,1707441424,7
650,22,0,35.612357,139.721484,I1-59.文庫の森第一,2024-02-09T01:17:49.157000Z,1707441424,22
651,5,0,35.611368,139.720424,I1-60.文庫の森第二,2024-02-09T01:17:49.158000Z,1707441424,5
652,4,1,35.66495,139.750459,C1-38.KDX西新橋ビル（西側）,2024-02-09T01:17:49.162000Z,1707441424,5
653,0,6,35.665218,139.750827,C1-37.KDX西新橋ビル（北側）,2024-02-09T01:17:49.163000Z,1707441424,6
654,1,5,35.747807,139.593599,T2-14.NPC24H東大泉第6パーキング,2024-02-09T01:17:49.242000Z,1707441424,6
655,0,15,35.676732,139.733905,C3-12.赤坂センタービルディング前（青山通り）,2024-02-09T01:17:49.166000Z,1707441424,15
656,13,2,35.66605,139.806699,H1-36.フジゴルフセンター,2024-02-09T01:17:49.167000Z,1707441424,15
657,0,25,35.668547,139.747175,C1-27.虎ノ門2丁目タワー,2024-02-09T01:17:49.168000Z,1707441424,25
658,0,9,35.633742,139.748281,C5-12.第2東運ビル,2024-02-09T01:17:49.172000Z,1707441424,9
659,0,7,35.697158,139.707887,D6-08.新宿イーストサイドスクエア,2024-02-09T01:17:49.172000Z,1707441424,7
660,5,20,35.684349,139.766958,A4-08.永代通り（大手町駅B2c出口前）,2024-02-09T01:17:49.173000Z,1707441424,25
661,33,1,35.640618,139.802455,H1-37.東雲駅（東京湾岸道路）,2024-02-09T01:17:49.174000Z,1707441424,34
662,2,0,35.676566,139.737083,C3-11.赤坂見附南,2024-02-09T01:17:49.175000Z,1707441424,2
663,0,4,35.687126,139.680702,M6-04.本町東べんてん橋公園,2024-02-09T01:17:49.176000Z,1707441424,4
664,14,0,35.621904,139.741429,I1-79.品川浦第二,2024-02-09T01:17:49.178000Z,1707441424,14
665,13,0,35.549568,139.731093,K1-81.コーナン本羽田萩中店,2024-02-09T01:17:49.179000Z,1707441424,13
666,30,0,35.689755,139.701323,D6-25.新宿駅東南口自転車駐輪場,2024-02-09T01:17:49.180000Z,1707441424,30
667,12,0,35.601431,139.718659,I1-78.セブン-イレブン西大井店,2024-02-09T01:17:49.182000Z,1707441424,12
668,11,6,35.683542,139.839763,H1-136.東砂一丁目公園,2024-02-09T01:17:49.183000Z,1707441424,17
669,0,5,35.689466,139.745316,A6-23.セブン-イレブン 千代田三番町店,2024-02-09T01:17:49.185000Z,1707441424,5
670,0,1,35.636644,139.751798,C5-34.五色橋ビル,2024-02-09T01:17:49.188000Z,1707441424,1
671,0,9,35.588644,139.710413,K1-41.郷土博物館,2024-02-09T01:17:49.189000Z,1707441424,9
672,3,2,35.71408,139.810588,G2-06.ディアレイシャス押上スカイヴィレッジ,2024-02-09T01:17:49.190000Z,1707441424,5
673,2,6,35.707877,139.618926,O3-11.ハイリビング関根,2024-02-09T01:17:49.191000Z,1707441424,8
674,6,0,35.67121,139.64145,O7-02.永福中央公園,2024-02-09T01:17:49.200000Z,1707441424,6
675,3,6,35.55017,139.728146,K1-29.萩中文化センター,2024-02-09T01:17:49.201000Z,1707441424,9
676,0,8,35.567922,139.746181,K1-30.テクノFRONT森ケ崎,2024-02-09T01:17:49.202000Z,1707441424,8
677,16,2,35.578728,139.735238,K1-130.COCOONひろば平和島,2024-02-09T01:17:49.203000Z,1707441424,18
678,15,7,35.659829,139.793243,H1-81.豊洲IHIビル（北側）,2024-02-09T01:17:49.203000Z,1707441424,22
679,32,1,35.73166,139.748625,E4-03.昭和小学校北側（不忍通り）,2024-02-09T01:17:49.204000Z,1707441424,33
680,0,26,35.66249,139.741397,C2-12.六本木ファーストビル,2024-02-09T01:17:49.205000Z,1707441424,26
681,14,1,35.708734,139.730509,D3-16.セジョリ江戸川橋,2024-02-09T01:17:49.206000Z,1707441424,15
682,0,28,35.671514,139.753952,A5-04.日比谷パークフロント前　日比谷公園南面向い歩道上,2024-02-09T01:17:49.207000Z,1707441424,28
683,6,2,35.674929,139.736053,C3-22.OMO3東京赤坂 by 星野リゾート,2024-02-09T01:17:49.208000Z,1707441424,8
684,0,32,35.688301,139.768958,B1-20.竜閑さくら橋際街角広場,2024-02-09T01:17:49.209000Z,1707441424,32
685,12,0,35.642165,139.800439,H1-83.ローソン江東東雲店,2024-02-09T01:17:49.212000Z,1707441424,12
686,0,22,35.647091,139.817333,H1-84.NTT東日本辰巳ビル,2024-02-09T01:17:49.213000Z,1707441424,22
687,12,1,35.644155,139.756216,C5-26.ピアシティ芝浦ビル,2024-02-09T01:17:49.221000Z,1707441424,13
688,1,2,35.755137,139.661208,T3-28.ほしぞら緑地,2024-02-09T01:17:48.473000Z,1707441424,3
689,0,3,35.58768,139.734515,I1-88.セブン-イレブン品川南大井3丁目店,2024-02-09T01:17:49.223000Z,1707441424,3
690,3,0,35.599774,139.723467,I1-87.セブン-イレブン西大井滝王子通り店,2024-02-09T01:17:49.223000Z,1707441424,3
691,0,10,35.540589,139.752918,Z20.川崎キングスカイフロント 東急 REI ホテル,2024-02-09T01:17:49.228000Z,1707441424,10
692,21,1,35.703972,139.797327,G4-11.ホテルマイステイズ浅草,2024-02-09T01:17:49.229000Z,1707441424,22
693,11,0,35.647872,139.75391,C5-30.フェイム芝浦インターウェーブ,2024-02-09T01:17:49.232000Z,1707441424,11
694,12,0,35.673409,139.675203,M6-13.JICA東京,2024-02-09T01:17:49.233000Z,1707441424,12
695,0,13,35.68557,139.766929,A4-13.アーバンネット大手町ビル,2024-02-09T01:17:49.240000Z,1707441424,13
696,16,1,35.670491,139.784447,B4-27.リバーシティ西ブロック,2024-02-09T01:17:49.241000Z,1707441424,17
697,57,2,35.584914,139.730504,K1-143.大森北1丁目,2024-02-09T01:17:49.242000Z,1707441424,59
698,5,0,35.712445,139.758157,E5-24.本郷6丁目,2024-02-09T01:17:49.243000Z,1707441424,5
699,9,1,35.690657,139.73255,D2-17.genten市ヶ谷店,2024-02-09T01:17:49.248000Z,1707441424,10
700,2,5,35.675739,139.763712,A4-14.東京国際フォーラム（有楽町駅ガード側）,2024-02-09T01:17:49.252000Z,1707441424,7
701,0,25,35.690958,139.759876,A2-27.丸紅ビル,2024-02-09T01:17:49.253000Z,1707441424,25
702,3,3,35.608633,139.693653,K1-135.北千束2丁目,2024-02-09T01:17:49.254000Z,1707441424,6
703,1,4,35.694065,139.751801,A1-19.九段会館テラス,2024-02-09T01:17:49.255000Z,1707441424,5
704,0,11,35.585489,139.740194,K1-136.BIG FUN 平和島,2024-02-09T01:17:49.256000Z,1707441424,11
705,0,16,35.571578,139.770532,K1-137.京浜島つばさ公園,2024-02-09T01:17:49.260000Z,1707441424,16
706,5,5,35.690155,139.713377,D1-16.ルネ新宿御苑タワー,2024-02-09T01:17:49.262000Z,1707441424,10
707,7,0,35.692547,139.799231,G6-01.オーキッドレジデンス森下,2024-02-09T01:17:49.263000Z,1707441424,7
708,2,5,35.751471,139.599835,T2-63.三原台公園,2024-02-09T01:17:49.268000Z,1707441424,7
709,2,0,35.70328,139.62981,O4-01.阿佐ヶ谷南公園,2024-02-09T01:17:49.269000Z,1707441424,2
710,0,4,35.656565,139.775073,B4-11.ダンスキューブ勝どき,2024-02-09T01:17:49.270000Z,1707441424,4
711,9,0,35.681754,139.715256,D1-06.四谷第六小学校北,2024-02-09T01:17:49.273000Z,1707441424,9
712,3,0,35.746768,139.613885,T2-64.高野台中央公園,2024-02-09T01:17:47.793000Z,1707441424,3
713,6,4,35.697157,139.839835,H1-169.セブンイレブン江東亀戸7丁目東店,2024-02-09T01:17:49.280000Z,1707441424,10
714,0,20,35.695937,139.838017,H1-170.セブンイレブン江東亀戸7丁目南店,2024-02-09T01:17:49.281000Z,1707441424,20
715,0,9,35.67684,139.77876,B2-16.ホテルサードニクス東京,2024-02-09T01:17:49.289000Z,1707441424,9
716,6,0,35.595498,139.750654,I1-93.中央海浜公園前交差点（南側）,2024-02-09T01:17:49.290000Z,1707441424,6
717,10,0,35.595873,139.75134,I1-92.中央海浜公園前交差点（北側）,2024-02-09T01:17:49.291000Z,1707441424,10
718,3,3,35.68802,139.78112,B1-26.Dash Living Nihonbashi,2024-02-09T01:17:49.292000Z,1707441424,6
719,9,3,35.621845,139.776833,H1-158.東京国際交流館,2024-02-09T01:17:49.292000Z,1707441424,12
720,4,3,35.606793,139.678372,J1-32.緑が丘駅前高架下,2024-02-09T01:17:49.293000Z,1707441424,7
721,4,2,35.5873,139.701644,K1-90.ファミリーマート大田仲池上一丁目店,2024-02-09T01:17:49.294000Z,1707441424,6
722,0,11,35.550027,139.74973,K1-91.穴守稲荷神社,2024-02-09T01:17:49.295000Z,1707441424,11
723,0,34,35.669228,139.751668,C1-67.京阪神 虎ノ門ビル,2024-02-09T01:17:49.296000Z,1707441424,34
724,5,0,35.572086,139.68708,K1-89.ファミリーマート大田千鳥三丁目店,2024-02-09T01:17:49.297000Z,1707441424,5
725,19,0,35.613387,139.749307,I1-97.トミンハイム東品川三丁目第二,2024-02-09T01:17:49.298000Z,1707441424,19
726,0,10,35.743772,139.603317,T2-51.練馬区役所石神井庁舎,2024-02-09T01:17:49.300000Z,1707441424,10
727,3,0,35.734684,139.593628,T2-75.石神井台二丁目緑地,2024-02-09T01:17:48.358000Z,1707441424,3
728,7,0,35.728333,139.757629,E5-19.千駄木公園,2024-02-09T01:17:49.302000Z,1707441424,7
729,7,4,35.724921,139.75903,E5-18.団子坂上広場,2024-02-09T01:17:49.305000Z,1707441424,11
730,0,15,35.670452,139.75557,A5-07.富国生命ビル,2024-02-09T01:17:49.305000Z,1707441424,15
731,0,13,35.630791,139.787396,H1-156.つどい橋下,2024-02-09T01:17:49.306000Z,1707441424,13
732,14,2,35.627599,139.782953,H1-159.夢の大橋西,2024-02-09T01:17:49.308000Z,1707441424,16
733,9,1,35.624619,139.776006,H1-143.ダイバーシティ東京 プラザ,2024-02-09T01:17:49.309000Z,1707441424,10
734,28,46,35.589972,139.729368,I1-57.大井水神公園,2024-02-09T01:17:49.312000Z,1707441424,74
735,0,32,35.68168,139.77825,B2-15.KABUTO ONE,2024-02-09T01:17:49.312000Z,1707441424,32
736,5,5,35.545459,139.719489,K1-64.多摩川グリーンスクエア,2024-02-09T01:17:49.313000Z,1707441424,10
737,2,2,35.519137,139.705791,Z07.ローソン川崎渡田三丁目店,2024-02-09T01:17:49.314000Z,1707441424,4
738,5,1,35.771708,139.583551,T2-57.大泉公園（第二）,2024-02-09T01:17:49.316000Z,1707441424,6
739,0,36,35.686037,139.764472,A4-06.大手町ファーストスクエア,2024-02-09T01:17:49.317000Z,1707441424,36
740,0,14,35.666075,139.748008,C1-50.NTT虎ノ門ビル,2024-02-09T01:17:49.318000Z,1707441424,14
741,9,0,35.648637,139.749834,C1-23.三田いきいきプラザ,2024-02-09T01:17:49.322000Z,1707441424,9
742,3,0,35.647618,139.792152,H1-29.スカイズタワー＆ガーデン,2024-02-09T01:17:49.323000Z,1707441424,3
743,2,8,35.657363,139.75918,C1-21.汐留ビルディング,2024-02-09T01:17:49.324000Z,1707441424,10
744,5,0,35.691069,139.775376,A3-16.地蔵橋東児童遊園,2024-02-09T01:17:49.325000Z,1707441424,5
745,0,7,35.526238,139.72907,Z08.ファミリーマート観音二丁目店,2024-02-09T01:17:49.325000Z,1707441424,7
746,2,2,35.69703,139.779928,A3-18.美倉橋北児童遊園,2024-02-09T01:17:49.332000Z,1707441424,4
747,5,5,35.680514,139.764002,A4-01.丸ビル（南側駐輪場）,2024-02-09T01:17:49.333000Z,1707441424,10
748,1,7,35.703735,139.770629,A3-11.練成公園,2024-02-09T01:17:49.333000Z,1707441424,8
749,0,6,35.701978,139.7698,A3-10.芳林公園（北側）,2024-02-09T01:17:49.334000Z,1707441424,6
750,7,1,35.687031,139.739327,A6-02.いきいきプラザ一番町（西側駐輪場）,2024-02-09T01:17:49.336000Z,1707441424,8
751,4,1,35.689879,139.740178,A6-01.東郷元帥記念公園（南側）,2024-02-09T01:17:49.337000Z,1707441424,5
752,7,8,35.677763,139.74271,A5-03.参議院第二別館（永田町駅2番出口）,2024-02-09T01:17:49.337000Z,1707441424,15
753,6,3,35.675843,139.763329,A4-03.東京国際フォーラム（メトロD5出口）,2024-02-09T01:17:49.338000Z,1707441424,9
754,0,4,35.56694,139.716331,K1-15.セブン‐イレブン 大田区西蒲田店,2024-02-09T01:17:49.340000Z,1707441424,4
755,10,0,35.586585,139.698552,K1-49.ローソン仲池上一丁目店,2024-02-09T01:17:49.342000Z,1707441424,10
756,0,7,35.69919,139.75701,A2-06.東光電気工事 別館（屋内駐輪場）,2024-02-09T01:17:49.343000Z,1707441424,7
757,5,0,35.68714,139.702775,M4-01.新宿タカシマヤ,2024-02-09T01:17:49.344000Z,1707441424,5
758,6,4,35.684451,139.702884,M4-03.NTTドコモ代々木ビル,2024-02-09T01:17:49.349000Z,1707441424,10
759,0,8,35.649823,139.700139,M3-03.代官山 T-SITE,2024-02-09T01:17:49.349000Z,1707441424,8
760,4,0,35.578239,139.723262,K1-14.大森地域庁舎,2024-02-09T01:17:49.350000Z,1707441424,4
761,11,0,35.630961,139.746875,C5-46.ウエリスアーバン品川タワー,2024-02-09T01:17:49.351000Z,1707441424,11
762,7,7,35.637765,139.739128,C4-13.コシダコネクトビル,2024-02-09T01:17:49.352000Z,1707441424,14
763,0,7,35.559286,139.722611,K1-127.第二石井ビル,2024-02-09T01:17:49.353000Z,1707441424,7
764,1,4,35.645155,139.744543,C1-74.札の辻スクエア,2024-02-09T01:17:49.353000Z,1707441424,5
765,18,0,35.68546,139.80244,H1-164.森下三丁目第三児童遊園,2024-02-09T01:17:49.354000Z,1707441424,18
766,2,7,35.66646,139.752138,C1-78.CIRCLES新橋,2024-02-09T01:17:49.356000Z,1707441424,9
767,0,5,35.668622,139.715957,C3-34.3rd MINAMI AOYAMA,2024-02-09T01:17:49.357000Z,1707441424,5
768,1,4,35.699328,139.636343,O4-06.杉並区役所本庁舎,2024-02-09T01:17:49.357000Z,1707441424,5
769,6,0,35.712413,139.70168,D3-14.コーシャハイム高田馬場,2024-02-09T01:17:49.362000Z,1707441424,6
770,5,1,35.716359,139.704377,D7-11.新宿清掃事務所,2024-02-09T01:17:49.363000Z,1707441424,6
771,3,5,35.704597,139.708397,D5-08.ウエリス新宿早稲田の森,2024-02-09T01:17:50.141000Z,1707441424,8
772,8,0,35.709147,139.739183,E2-12.水道2丁目,2024-02-09T01:17:50.146000Z,1707441424,8
773,5,0,35.6772,139.678117,M6-10.京王コインパーク幡ヶ谷,2024-02-09T01:17:49.373000Z,1707441424,5
774,45,15,35.721045,139.735687,E3-05.文京スポーツセンター,2024-02-09T01:17:49.374000Z,1707441424,60
775,2,2,35.629067,139.711779,J1-36.WJ Haus,2024-02-09T01:17:49.375000Z,1707441424,4
776,2,9,35.555808,139.722791,K1-51.テクノポートカマタ 第2,2024-02-09T01:17:49.376000Z,1707441424,11
777,0,23,35.688945,139.706536,D1-13.新宿御苑新宿門【西側】,2024-02-09T01:17:49.376000Z,1707441424,23
778,6,0,35.608193,139.719139,I1-31.セブン-イレブン 品川戸越5丁目店,2024-02-09T01:17:49.379000Z,1707441424,6
779,1,3,35.738427,139.632251,T3-27.貫井川緑地,2024-02-09T01:17:49.383000Z,1707441424,4
780,14,2,35.68744,139.827075,H1-147.大島四丁目団地,2024-02-09T01:17:49.391000Z,1707441424,16
781,2,0,35.69638,139.63482,O4-02.成宗さくら公園,2024-02-09T01:17:48.132000Z,1707441424,2
782,2,2,35.72077,139.6045,O1-01.上瀬戸公園,2024-02-09T01:17:49.068000Z,1707441424,4
783,0,9,35.748611,139.584251,T2-15.NPC24H大泉学園南口パーキング,2024-02-09T01:17:49.396000Z,1707441424,9
784,7,0,35.71013,139.61194,O3-03.桃井1丁目5番地,2024-02-09T01:17:49.402000Z,1707441424,7
785,35,6,35.627087,139.779779,H1-08.東京テレポート駅,2024-02-09T01:17:49.406000Z,1707441424,41
786,3,11,35.632148,139.79017,H1-05.相鉄グランドフレッサ 東京ベイ有明,2024-02-09T01:17:49.406000Z,1707441424,14
787,0,22,35.630185,139.786618,H1-06.武蔵野大学,2024-02-09T01:17:49.407000Z,1707441424,22
788,0,30,35.686389,139.769237,A4-15.TOKIWAブリッジ,2024-02-09T01:17:49.408000Z,1707441424,30
789,0,17,35.633908,139.793322,H1-160.花の広場,2024-02-09T01:17:49.412000Z,1707441424,17
790,0,9,35.658911,139.792531,H1-01.豊洲ＩＨＩビル前（晴海通り）,2024-02-09T01:17:49.416000Z,1707441424,9
791,0,59,35.654196,139.79626,H1-02.豊洲駅,2024-02-09T01:17:49.417000Z,1707441424,59
792,3,0,35.615098,139.675954,J1-19.NTT東日本自由が丘ビル,2024-02-09T01:17:49.422000Z,1707441424,3
793,2,3,35.650732,139.72256,C2-19.広尾駅,2024-02-09T01:17:49.423000Z,1707441424,5
794,4,10,35.651987,139.830691,H1-114.東京夢の島マリーナ,2024-02-09T01:17:49.424000Z,1707441424,14
795,5,0,35.562769,139.74327,K1-71.ファミリーマート大田大森南店,2024-02-09T01:17:49.428000Z,1707441424,5
796,7,1,35.617773,139.685351,J1-20.すずめのお宿緑地公園,2024-02-09T01:17:49.429000Z,1707441424,8
797,2,12,35.650235,139.835993,H1-115.東京夢の島マリーナ 第4駐車場,2024-02-09T01:17:49.430000Z,1707441424,14
798,15,2,35.665961,139.686491,M5-10.富ヶ谷2丁目,2024-02-09T01:17:49.432000Z,1707441424,17
799,5,0,35.630694,139.690482,J1-21.中央緑地公園,2024-02-09T01:17:49.433000Z,1707441424,5
800,26,23,35.625037,139.777646,H1-116.出会い橋高架下,2024-02-09T01:17:49.436000Z,1707441424,49
801,3,4,35.656228,139.706284,M3-12.渋谷南東急ビル,2024-02-09T01:17:49.441000Z,1707441424,7
802,1,4,35.749918,139.58618,T2-01.大泉学園駅北口,2024-02-09T01:17:49.441000Z,1707441424,5
803,5,1,35.585269,139.726279,K1-06.大森駅入新井自転車駐車場,2024-02-09T01:17:49.442000Z,1707441424,6
804,0,17,35.691199,139.687966,D6-06.新宿中央公園（エコギャラリー下）,2024-02-09T01:17:49.449000Z,1707441424,17
805,6,8,35.689529,139.695995,D6-14.新宿ファーストウエスト,2024-02-09T01:17:49.450000Z,1707441424,14
806,2,9,35.69465,139.695911,D6-15.住友不動産西新宿ビル,2024-02-09T01:17:49.451000Z,1707441424,11
807,0,19,35.672361,139.829825,H1-56.南砂三丁目緑地公園西,2024-02-09T01:17:49.452000Z,1707441424,19
808,3,2,35.731791,139.588844,T2-74.扇橋公園,2024-02-09T01:17:49.453000Z,1707441424,5
809,2,1,35.675398,139.779962,B2-20.SHビル,2024-02-09T01:17:49.456000Z,1707441424,3
810,11,1,35.616364,139.749171,I1-17.東品川海上公園第2,2024-02-09T01:17:49.457000Z,1707441424,12
811,14,0,35.6214,139.741958,I1-16.品川浦,2024-02-09T01:17:49.458000Z,1707441424,14
812,0,14,35.680753,139.762069,A4-11.二重橋前駅(メトロ4番出口),2024-02-09T01:17:49.459000Z,1707441424,14
813,5,13,35.638571,139.78829,H1-76.有明物流センター,2024-02-09T01:17:49.460000Z,1707441424,18
814,0,7,35.600707,139.703216,K1-43.北馬込わくわく公園,2024-02-09T01:17:49.462000Z,1707441424,7
815,12,2,35.58849,139.70376,K1-42.馬込西公園,2024-02-09T01:17:49.463000Z,1707441424,14
816,0,4,35.756506,139.620347,T1-08.セブン-イレブン 練馬高松6丁目店,2024-02-09T01:17:49.398000Z,1707441424,4
817,0,4,35.74755,139.597968,T2-17.ファミリーマート 練馬石神井町八丁目店,2024-02-09T01:17:49.465000Z,1707441424,4
818,0,8,35.546252,139.731708,K1-31.テクノWING,2024-02-09T01:17:49.472000Z,1707441424,8
819,5,0,35.601958,139.682876,K1-32.石川町文化センター,2024-02-09T01:17:49.473000Z,1707441424,5
820,19,0,35.59632,139.751279,I1-20.しおじ公園,2024-02-09T01:17:49.474000Z,1707441424,19
821,0,7,35.607571,139.749108,I1-19.品川シーサイド公園第2,2024-02-09T01:17:49.475000Z,1707441424,7
822,4,1,35.626121,139.688576,J1-29.カスタリア目黒鷹番,2024-02-09T01:17:49.476000Z,1707441424,5
823,15,8,35.669291,139.795364,H1-127.古石場川親水公園,2024-02-09T01:17:49.477000Z,1707441424,23
824,0,8,35.700732,139.711472,D4-05.カスタリア新宿7丁目,2024-02-09T01:17:49.477000Z,1707441424,8
825,4,0,35.596483,139.7355,I1-71.セブン-イレブン南大井浜川店,2024-02-09T01:17:49.478000Z,1707441424,4
826,6,0,35.600081,139.728193,I1-72.セブン-イレブン大井店,2024-02-09T01:17:49.479000Z,1707441424,6
827,4,1,35.747038,139.667965,T3-21.くまのやま緑地,2024-02-09T01:17:49.480000Z,1707441424,5
828,12,2,35.550479,139.739538,K1-110.萩中集会所裏,2024-02-09T01:17:49.482000Z,1707441424,14
829,30,0,35.708265,139.612703,O2-02.シエール荻窪,2024-02-09T01:17:49.484000Z,1707441424,30
830,18,17,35.645162,139.785386,H1-128.豊洲市場（5街区）,2024-02-09T01:17:49.492000Z,1707441424,35
831,2,3,35.716184,139.643905,N1-09.若宮レジデンス,2024-02-09T01:17:49.493000Z,1707441424,5
832,7,0,35.683156,139.67338,M6-12.LIVART SEASON 幡ヶ谷,2024-02-09T01:17:49.493000Z,1707441424,7
833,10,1,35.660632,139.817294,H1-142.東京ベイ潮見プリンスホテル,2024-02-09T01:17:49.494000Z,1707441424,11
834,2,7,35.732291,139.82012,G1-01.鐘ヶ淵駅南自転車駐車場,2024-02-09T01:17:49.495000Z,1707441424,9
835,0,23,35.66362,139.69801,M1-01.渋谷区役所,2024-02-09T01:17:49.496000Z,1707441424,23
836,2,10,35.600161,139.749902,I1-83.かもめ歩道橋,2024-02-09T01:17:49.497000Z,1707441424,12
837,2,3,35.693815,139.668571,N4-05.セブン-イレブン中野鍋横店,2024-02-09T01:17:50.058000Z,1707441424,5
838,7,0,35.694927,139.731328,D4-02.JICA市ヶ谷ビル（地球ひろば／研究所）,2024-02-09T01:17:49.499000Z,1707441424,7
839,1,4,35.749388,139.651824,T3-19.なかみや児童遊園,2024-02-09T01:17:49.502000Z,1707441424,5
840,2,5,35.729056,139.627864,N1-08.上鷺自転車保管場所,2024-02-09T01:17:49.503000Z,1707441424,7
841,2,11,35.686015,139.642784,O7-06.松木1丁目,2024-02-09T01:17:49.503000Z,1707441424,13
842,7,0,35.723723,139.740143,E4-16.ビレッジワン,2024-02-09T01:17:49.504000Z,1707441424,7
843,3,5,35.68768,139.71937,D1-15.フロンティア四谷,2024-02-09T01:17:49.505000Z,1707441424,8
844,12,2,35.571975,139.732137,K1-128.大森西3丁目,2024-02-09T01:17:49.508000Z,1707441424,14
845,4,1,35.713562,139.649075,N1-06.大和区民活動センター,2024-02-09T01:17:49.509000Z,1707441424,5
846,2,5,35.69566,139.79214,G4-01.両国ビューホテル1,2024-02-09T01:17:49.510000Z,1707441424,7
847,5,3,35.69562,139.79206,G4-02.両国ビューホテル2,2024-02-09T01:17:49.512000Z,1707441424,8
848,17,3,35.698588,139.792946,G4-05.両国駅西口臨時自転車駐車場,2024-02-09T01:17:49.513000Z,1707441424,20
849,11,2,35.702525,139.796632,G4-03.本所1-6-5,2024-02-09T01:17:49.516000Z,1707441424,13
850,13,5,35.693059,139.813417,G5-01.牡丹橋自転車駐車場,2024-02-09T01:17:49.517000Z,1707441424,18
851,21,16,35.70378,139.814298,G5-02.横川3-7-10,2024-02-09T01:17:49.518000Z,1707441424,37
852,18,3,35.697898,139.795345,G4-04.NTTドコモ墨田ビル,2024-02-09T01:17:49.519000Z,1707441424,21
853,4,4,35.710111,139.81488,G2-02.押上1-23-8,2024-02-09T01:17:49.524000Z,1707441424,8
854,39,0,35.638245,139.749754,C5-13.区立芝浦西運河沿緑地,2024-02-09T01:17:49.525000Z,1707441424,39
855,1,1,35.69342,139.710568,D6-12.東京ビジネスホテル,2024-02-09T01:17:49.526000Z,1707441424,2
856,0,2,35.693029,139.711327,D6-11.ホテルリステル新宿,2024-02-09T01:17:49.527000Z,1707441424,2
857,0,4,35.694201,139.707047,D6-10.ホテルサンライト新宿,2024-02-09T01:17:49.528000Z,1707441424,4
858,15,10,35.645823,139.812178,H1-39.辰巳駅東口自転車駐車場,2024-02-09T01:17:49.536000Z,1707441424,25
859,89,0,35.646857,139.808912,H1-38.辰巳駅西口自転車駐車場,2024-02-09T01:17:49.537000Z,1707441424,89
860,3,4,35.655865,139.730566,C2-10.元麻布三丁目,2024-02-09T01:17:49.538000Z,1707441424,7
861,0,2,35.660614,139.734771,C2-09.麻布地区総合支所,2024-02-09T01:17:49.539000Z,1707441424,2
862,7,1,35.65494,139.70534,M3-20.東急ステイ渋谷新南口,2024-02-09T01:17:49.540000Z,1707441424,8
863,1,0,35.601694,139.719778,I1-86.ファミリーマート二葉三丁目店,2024-02-09T01:17:49.541000Z,1707441424,1
864,3,4,35.696126,139.763297,A2-23.axle御茶ノ水,2024-02-09T01:17:49.542000Z,1707441424,7
865,2,3,35.63756,139.724981,C4-02.白金台いきいきプラザ,2024-02-09T01:17:48.829000Z,1707441424,5
866,0,23,35.707883,139.683284,N3-04.東中野駅地下駐輪場,2024-02-09T01:17:49.543000Z,1707441424,23
867,0,8,35.698068,139.682781,N3-05.中野坂上駅地下駐輪場,2024-02-09T01:17:49.544000Z,1707441424,8
868,0,8,35.697024,139.677846,N3-03.青桐公園,2024-02-09T01:17:49.545000Z,1707441424,8
869,0,14,35.708487,139.662135,N3-01.中野四季の森公園,2024-02-09T01:17:49.546000Z,1707441424,14
870,7,2,35.69693,139.672721,N4-01.本四公園,2024-02-09T01:17:49.547000Z,1707441424,9
871,9,0,35.686474,139.671383,N4-02.栄町公園,2024-02-09T01:17:49.548000Z,1707441424,9
872,6,0,35.579585,139.705377,K1-57.池上本門寺,2024-02-09T01:17:49.549000Z,1707441424,6
873,0,17,35.666213,139.760907,C1-49.汐留シティセンター,2024-02-09T01:17:49.550000Z,1707441424,17
874,2,11,35.642771,139.733046,C4-15.クロスレジデンス白金高輪,2024-02-09T01:17:49.551000Z,1707441424,13
875,3,1,35.588106,139.718852,K1-56.NTT馬込ビル,2024-02-09T01:17:49.552000Z,1707441424,4
876,7,2,35.631319,139.70237,J1-41.CASSIA目黒,2024-02-09T01:17:49.552000Z,1707441424,9
877,1,5,35.696147,139.753709,A2-22.専修大学,2024-02-09T01:17:49.562000Z,1707441424,6
878,1,3,35.75312,139.65661,T3-20.はやいち公園,2024-02-09T01:17:49.565000Z,1707441424,4
879,0,9,35.67363,139.77623,B3-19.本の森ちゅうおう,2024-02-09T01:17:49.567000Z,1707441424,9
880,20,1,35.556267,139.727246,K1-86.IMPREST STAY TOKYO 蒲田,2024-02-09T01:17:49.569000Z,1707441424,21
881,3,1,35.756575,139.669689,T3-23.氷川台二丁目緑地,2024-02-09T01:17:49.570000Z,1707441424,4
882,2,1,35.750547,139.66707,T3-22.氷川台三丁目ちびっこ公園,2024-02-09T01:17:49.572000Z,1707441424,3
883,5,1,35.679616,139.784341,B1-23.NANAEI日本橋,2024-02-09T01:17:49.580000Z,1707441424,6
884,0,31,35.677576,139.769822,B2-11.京橋エドグラン,2024-02-09T01:17:49.585000Z,1707441424,31
885,2,3,35.7266,139.62948,N1-05.大野ハイツ,2024-02-09T01:17:49.587000Z,1707441424,5
886,0,11,35.680203,139.778679,B2-09.茅場町一丁目平和ビル,2024-02-09T01:17:49.589000Z,1707441424,11
887,3,6,35.681012,139.778569,B2-08.共同ビル（茅場町交差点前）,2024-02-09T01:17:49.590000Z,1707441424,9
888,0,7,35.680864,139.779331,B2-07.東京証券会館（北側）,2024-02-09T01:17:49.609000Z,1707441424,7
889,1,2,35.696567,139.610517,O3-12.大宮前体育館,2024-02-09T01:17:49.613000Z,1707441424,3
890,0,8,35.688038,139.786561,B1-08.明治座,2024-02-09T01:17:49.615000Z,1707441424,8
891,0,53,35.654165,139.781568,B4-05.ドコモ・バイクシェア晴海ポート,2024-02-09T01:17:49.617000Z,1707441424,53
892,0,0,35.65443,139.77843,B4-04.ＫＤＸ晴海ビル,2024-02-09T01:17:49.621000Z,1707441424,0
893,0,30,35.658665,139.782553,B4-03.桜の散歩道（晴海トリトンスクエア前）,2024-02-09T01:17:49.623000Z,1707441424,30
894,5,0,35.727778,139.756296,E5-08.セブン-イレブン 文京動坂上店,2024-02-09T01:17:49.634000Z,1707441424,5
895,15,0,35.669507,139.825553,H1-65.ローソン南砂日曹橋店,2024-02-09T01:17:49.636000Z,1707441424,15
896,6,2,35.687732,139.846383,H1-66.中川船番所資料館,2024-02-09T01:17:49.637000Z,1707441424,8
897,5,2,35.594658,139.700133,K1-113.ファミリーマート大田上池台四丁目店,2024-02-09T01:17:49.638000Z,1707441424,7
898,4,6,35.640228,139.804267,H1-64.ローソン東雲駅前店,2024-02-09T01:17:49.640000Z,1707441424,10
899,3,12,35.703914,139.747061,E1-11.小石川運動場前,2024-02-09T01:17:49.641000Z,1707441424,15
900,2,2,35.720318,139.570762,T2-70.三ツ塚けやき緑地,2024-02-09T01:17:49.642000Z,1707441424,4
901,16,4,35.638985,139.793653,H1-137.住友不動産ショッピングシティ有明ガーデン,2024-02-09T01:17:49.645000Z,1707441424,20
902,0,5,35.64096,139.75754,C5-40.芝浦ふ頭駅前暫定自転車駐車場,2024-02-09T01:17:49.657000Z,1707441424,5
903,5,7,35.65618,139.69612,M3-21.渋谷ソラスタ,2024-02-09T01:17:49.670000Z,1707441424,12
904,29,2,35.715645,139.687486,D7-03.中井駅北,2024-02-09T01:17:49.677000Z,1707441424,31
905,4,0,35.58223,139.72763,K1-119.シーンズ大森パークサイド,2024-02-09T01:17:49.678000Z,1707441424,4
906,1,0,35.67741,139.67383,M6-15.cova Hatagaya,2024-02-09T01:17:49.679000Z,1707441424,1
907,16,26,35.661783,139.737242,C2-25.アパホテル＆リゾート＜六本木駅東＞,2024-02-09T01:17:49.680000Z,1707441424,42
908,6,0,35.696585,139.713081,D4-10.東新宿ポート(余丁町6番),2024-02-09T01:17:49.681000Z,1707441424,6
909,5,9,35.72424,139.61431,O1-02.井荻南地下自転車駐車場,2024-02-09T01:17:49.683000Z,1707441424,14
910,1,3,35.72489,139.62383,O1-03.LUCKY HOUSE,2024-02-09T01:17:49.685000Z,1707441424,4
911,4,3,35.6897,139.694823,D6-30.京王プラザホテル,2024-02-09T01:17:49.686000Z,1707441424,7
912,11,3,35.688735,139.692249,D6-29.都庁第二本庁舎前,2024-02-09T01:17:49.688000Z,1707441424,14
913,6,2,35.71355,139.6199,O3-02.アートメゾン荻窪,2024-02-09T01:17:49.689000Z,1707441424,8
914,4,1,35.606667,139.667324,J1-57.トレインチ自由が丘,2024-02-09T01:17:49.690000Z,1707441424,5
915,10,1,35.70535,139.61497,O2-01.サカエフラット荻窪,2024-02-09T01:17:49.693000Z,1707441424,11
916,7,0,35.69575,139.62065,O3-01.西田公園,2024-02-09T01:17:49.695000Z,1707441424,7
917,11,0,35.598601,139.684747,K1-47.NTT雪ヶ谷ビル,2024-02-09T01:17:49.699000Z,1707441424,11
918,9,0,35.529519,139.704845,Z17.NTT川崎ビル,2024-02-09T01:17:49.822000Z,1707441424,9
919,7,1,35.67161,139.64527,O7-04.永福町西幸モータープール西,2024-02-09T01:17:49.708000Z,1707441424,8
920,1,4,35.590934,139.696915,K1-48.ファミリーマート大田上池台三丁目店,2024-02-09T01:17:49.709000Z,1707441424,5
921,6,1,35.546499,139.736761,K1-111.本羽田公園,2024-02-09T01:17:49.710000Z,1707441424,7
922,0,9,35.655937,139.763251,C1-58.ウォーターズ竹芝,2024-02-09T01:17:49.711000Z,1707441424,9
923,8,0,35.549323,139.737091,K1-109.萩中公園プール駐輪場,2024-02-09T01:17:49.716000Z,1707441424,8
924,3,0,35.557999,139.732564,K1-108.仲江名公園,2024-02-09T01:17:49.716000Z,1707441424,3
925,10,0,35.713913,139.745416,E1-17.小石川パークスクエア,2024-02-09T01:17:49.717000Z,1707441424,10
926,0,2,35.697535,139.703633,D6-23.アパホテル 東新宿 歌舞伎町西,2024-02-09T01:17:49.718000Z,1707441424,2
927,8,1,35.668705,139.810549,H1-98.洲崎川緑道公園,2024-02-09T01:17:49.719000Z,1707441424,9
928,15,9,35.669695,139.831874,H1-99.南砂三丁目公園,2024-02-09T01:17:49.720000Z,1707441424,24
929,0,14,35.668757,139.790156,H1-96.越中島公園,2024-02-09T01:17:49.721000Z,1707441424,14
930,7,0,35.661852,139.802224,H1-97.浜園公園,2024-02-09T01:17:49.724000Z,1707441424,7
931,1,8,35.64423,139.835823,H1-94.新木場一丁目緑地公園,2024-02-09T01:17:49.727000Z,1707441424,9
932,6,18,35.619451,139.834429,H1-95.若洲公園,2024-02-09T01:17:49.734000Z,1707441424,24
933,4,0,35.629252,139.712716,J1-09.ファミリーマート佐野久下目黒店,2024-02-09T01:17:49.740000Z,1707441424,4
934,0,22,35.64143,139.835455,H1-93.新木場一丁目公園,2024-02-09T01:17:49.741000Z,1707441424,22
935,6,2,35.593559,139.734704,I1-55.鈴ヶ森公園,2024-02-09T01:17:49.742000Z,1707441424,8
936,1,4,35.67834,139.62711,O6-04.柏の宮公園,2024-02-09T01:17:49.743000Z,1707441424,5
937,8,2,35.660526,139.776816,B4-14.Brillia ist Tower 勝どき,2024-02-09T01:17:49.743000Z,1707441424,10
938,0,15,35.71115,139.68232,D7-08.上落合3丁目,2024-02-09T01:17:49.744000Z,1707441424,15
939,13,0,35.646041,139.804495,H1-21.UR東雲キャナルコート,2024-02-09T01:17:49.748000Z,1707441424,13
940,10,19,35.619377,139.777582,H1-20.日本科学未来館,2024-02-09T01:17:49.749000Z,1707441424,29
941,19,2,35.653603,139.80144,H1-19.UR豊洲四丁目団地,2024-02-09T01:17:49.755000Z,1707441424,21
942,3,4,35.771068,139.586798,T2-45.風致地区バス停第三自転車駐車場,2024-02-09T01:17:49.756000Z,1707441424,7
943,1,7,35.66789,139.803,H1-33.深川ギャザリア（ウエストスクエア）,2024-02-09T01:17:49.760000Z,1707441424,8
944,3,17,35.664591,139.813954,H1-32.区営塩浜住宅前,2024-02-09T01:17:49.765000Z,1707441424,20
945,0,15,35.648085,139.798986,H1-23.KDX豊洲グランスクエア,2024-02-09T01:17:49.766000Z,1707441424,15
946,8,0,35.655649,139.74427,C2-22.飯倉公園,2024-02-09T01:17:49.767000Z,1707441424,8
947,5,0,35.608402,139.726118,I1-89.下神明駅自転車駐車場,2024-02-09T01:17:49.767000Z,1707441424,5
948,13,0,35.631021,139.778109,C5-39.お台場海浜公園東,2024-02-09T01:17:49.768000Z,1707441424,13
949,0,20,35.628743,139.773915,C5-38.お台場海浜公園乗船場,2024-02-09T01:17:49.776000Z,1707441424,20
950,0,5,35.703203,139.62804,O4-08.ローソン阿佐ヶ谷青梅街道店,2024-02-09T01:17:49.777000Z,1707441424,5
951,5,1,35.733132,139.570311,T2-72.高塚南緑地,2024-02-09T01:17:48.685000Z,1707441424,6
952,5,5,35.68073,139.62803,O6-03.みなみ荘,2024-02-09T01:17:50.186000Z,1707441424,10
953,0,6,35.557427,139.739126,K1-129.ローソン東糀谷一丁目店,2024-02-09T01:17:49.790000Z,1707441424,6
954,6,2,35.70319,139.751888,E1-03.東京ドーム（黄色いビル横）,2024-02-09T01:17:49.792000Z,1707441424,8
955,8,1,35.561183,139.716339,K1-23.大田区役所本庁舎前,2024-02-09T01:17:49.793000Z,1707441424,9
956,2,1,35.761474,139.592735,T2-78.北大泉くれはし公園,2024-02-09T01:17:49.795000Z,1707441424,3
957,2,3,35.612833,139.675047,J1-53.ボヌールAllamanda,2024-02-09T01:17:49.795000Z,1707441424,5
958,2,2,35.694834,139.780333,A3-39.トーシン東神田ビル,2024-02-09T01:17:49.796000Z,1707441424,4
959,5,4,35.67912,139.61074,O6-01.高井戸みどり公園,2024-02-09T01:17:50.202000Z,1707441424,9
960,5,1,35.774457,139.596182,T2-79.大泉学園町八丁目緑地,2024-02-09T01:17:49.800000Z,1707441424,6
961,18,2,35.70104,139.65839,O5-04.リヴィエール,2024-02-09T01:17:49.803000Z,1707441424,20
962,2,3,35.707968,139.663519,N3-08.中野区役所(西側),2024-02-09T01:17:49.804000Z,1707441424,5
963,6,0,35.61663,139.74192,I1-99.北品川２丁目,2024-02-09T01:17:49.805000Z,1707441424,6
964,3,4,35.728846,139.718577,P1-01.サンシャインシティ,2024-02-09T01:17:49.808000Z,1707441424,7
965,0,6,35.713227,139.680966,N3-14.ヴィラソンサ落合,2024-02-09T01:17:49.813000Z,1707441424,6
966,0,20,35.667892,139.8311,H1-49.セブン-イレブン 江東新砂３丁目店,2024-02-09T01:17:49.816000Z,1707441424,20
967,8,1,35.593489,139.72967,I1-06.大森貝塚遺跡庭園,2024-02-09T01:17:49.820000Z,1707441424,9
968,8,0,35.650541,139.713361,M2-12.恵比寿プライムスクエアタワー北,2024-02-09T01:17:49.824000Z,1707441424,8
969,7,2,35.680474,139.812316,H1-69.ファミリーマート 江東石島店,2024-02-09T01:17:49.825000Z,1707441424,9
970,8,5,35.66523,139.776313,B3-09.築地永谷コーポラス,2024-02-09T01:17:49.826000Z,1707441424,13
971,9,0,35.720349,139.746924,E4-10.白山四丁目第二児童遊園横,2024-02-09T01:17:49.828000Z,1707441424,9
972,5,2,35.605617,139.73472,I1-03.大井町駅中央口（西側）,2024-02-09T01:17:49.836000Z,1707441424,7
973,4,1,35.605146,139.734694,I1-04.大井町歩道橋,2024-02-09T01:17:49.837000Z,1707441424,5
974,9,0,35.609052,139.729825,I1-01.品川区役所 本庁舎前,2024-02-09T01:17:49.838000Z,1707441424,9
975,8,1,35.608161,139.730048,I1-02.品川区役所 第三庁舎前,2024-02-09T01:17:49.838000Z,1707441424,9
976,6,0,35.691677,139.793857,G4-08.ブオンサンヴァレンティーノ,2024-02-09T01:17:49.842000Z,1707441424,6
977,14,3,35.61061,139.693443,J1-13.洗足二丁目駐輪場,2024-02-09T01:17:49.846000Z,1707441424,17
978,5,0,35.617353,139.672256,J1-16.八雲橋自転車置場,2024-02-09T01:17:49.848000Z,1707441424,5
979,4,25,35.634453,139.824,H1-189.MFLP新木場2,2024-02-09T01:17:49.849000Z,1707441424,29
980,2,1,35.683756,139.684965,M6-09.ファミリーマート渋谷本町店,2024-02-09T01:17:49.850000Z,1707441424,3
981,24,1,35.646366,139.801492,H1-113.123+N東雲店,2024-02-09T01:17:49.860000Z,1707441424,25
982,5,1,35.613902,139.691476,J1-17.ファミリーマート原町二丁目店,2024-02-09T01:17:49.861000Z,1707441424,6
983,10,1,35.73176,139.756669,E5-21.動坂公園,2024-02-09T01:17:49.862000Z,1707441424,11
984,0,5,35.704391,139.758575,E5-20.本郷2丁目,2024-02-09T01:17:49.863000Z,1707441424,5
985,2,2,35.726064,139.578015,T2-48.武蔵関駅南第二自転車駐車場,2024-02-09T01:17:49.120000Z,1707441424,4
986,7,5,35.683378,139.743189,A6-26.相互半蔵門ビル,2024-02-09T01:17:49.865000Z,1707441424,12
987,18,2,35.634194,139.688833,J1-31.守屋図書館,2024-02-09T01:17:48.234000Z,1707441424,20
988,10,11,35.662146,139.702793,M3-19.渋谷キャスト,2024-02-09T01:17:49.880000Z,1707441424,21
989,2,5,35.721679,139.645265,N1-04.都立家政南駐輪場,2024-02-09T01:17:49.881000Z,1707441424,7
990,0,9,35.529781,139.727511,Z09.ファミリーマート川崎川中島二丁目店,2024-02-09T01:17:49.882000Z,1707441424,9
991,2,1,35.724988,139.672511,N2-02.江古田1丁目A,2024-02-09T01:17:49.886000Z,1707441424,3
992,0,10,35.654873,139.762103,C1-56.鈴与竹芝ビル,2024-02-09T01:17:49.889000Z,1707441424,10
993,0,5,35.71429,139.70507,D3-07.戸塚特別出張所,2024-02-09T01:17:49.890000Z,1707441424,5
994,7,0,35.70103,139.803341,G4-12.プレミアムキューブ両国,2024-02-09T01:17:49.892000Z,1707441424,7
995,3,4,35.694578,139.754434,A2-21.神田神保町3丁目,2024-02-09T01:17:49.895000Z,1707441424,7
996,0,5,35.668044,139.785801,B4-19.コーシャタワー佃,2024-02-09T01:17:49.898000Z,1707441424,5
997,20,0,35.608127,139.717865,I1-81.戸越6丁目,2024-02-09T01:17:49.900000Z,1707441424,20
998,0,15,35.682218,139.743292,A6-24.国立劇場,2024-02-09T01:17:49.906000Z,1707441424,15
999,3,3,35.722353,139.760966,E5-23.ビレッジ千駄木,2024-02-09T01:17:49.907000Z,1707441424,6
1000,0,22,35.638319,139.834741,H1-119.榎戸材木店,2024-02-09T01:17:49.908000Z,1707441424,22
1001,7,1,35.651672,139.760549,C5-29.Hi-NODE(ハイノード),2024-02-09T01:17:49.909000Z,1707441424,8
1002,4,0,35.627373,139.692044,J1-22.NTTコミュニケーションズ唐ヶ崎ビル,2024-02-09T01:17:49.912000Z,1707441424,4
1003,5,1,35.698654,139.759762,A2-18.猿楽町SSビル東,2024-02-09T01:17:49.913000Z,1707441424,6
1004,0,4,35.698641,139.759306,A2-19.猿楽町SSビル西,2024-02-09T01:17:49.914000Z,1707441424,4
1005,13,7,35.669267,139.756018,C1-55.アーバンネット内幸町ビル,2024-02-09T01:17:49.915000Z,1707441424,20
1006,4,1,35.697143,139.718739,D4-06.グリーンフォート河田,2024-02-09T01:17:48.465000Z,1707441424,5
1007,10,0,35.588363,139.69042,K1-134.東調布公園,2024-02-09T01:17:49.917000Z,1707441424,10
1008,21,0,35.533627,139.700527,Z12.京急川崎西口駐輪場B,2024-02-09T01:17:49.925000Z,1707441424,21
1009,4,1,35.679182,139.68596,M5-18.Luxe初台,2024-02-09T01:17:49.926000Z,1707441424,5
1010,5,0,35.721064,139.677128,D7-06.エムアイセミナーハウス,2024-02-09T01:17:49.927000Z,1707441424,5
1011,4,0,35.695737,139.78162,A3-37.ポータル秋葉原,2024-02-09T01:17:49.928000Z,1707441424,4
1012,5,3,35.688154,139.698975,M5-11.あおい通り,2024-02-09T01:17:49.929000Z,1707441424,8
1013,5,0,35.727046,139.760439,E5-04.保健サービスセンター本郷支所,2024-02-09T01:17:49.930000Z,1707441424,5
1014,2,3,35.725538,139.76116,E5-03.汐見地域活動センター（本郷図書館）,2024-02-09T01:17:49.930000Z,1707441424,5
1015,22,9,35.708121,139.763583,E5-01.文京総合体育館,2024-02-09T01:17:49.982000Z,1707441424,31
1016,17,8,35.72707,139.746112,E4-01.千石南自転車駐車場,2024-02-09T01:17:49.937000Z,1707441424,25
1017,10,10,35.724286,139.730954,E3-03.大塚公園,2024-02-09T01:17:49.937000Z,1707441424,20
1018,11,6,35.719345,139.736198,E3-02.教育の森公園,2024-02-09T01:17:49.938000Z,1707441424,17
1019,3,0,35.607084,139.705007,I1-25.セブン-イレブン 品川旗の台2丁目店,2024-02-09T01:17:49.939000Z,1707441424,3
1020,0,9,35.680861,139.774493,B1-21.日本橋二丁目街角広場,2024-02-09T01:17:49.940000Z,1707441424,9
1021,4,5,35.672652,139.738908,C3-30.東京赤坂NKビル (ヴィアインプライム赤坂),2024-02-09T01:17:49.941000Z,1707441424,9
1022,0,4,35.694943,139.782718,A3-36.クロックカフェ東神田,2024-02-09T01:17:49.946000Z,1707441424,4
1023,9,0,35.711147,139.747386,E1-14.いきいき礫川,2024-02-09T01:17:49.947000Z,1707441424,9
1024,2,3,35.69617,139.722021,D4-09.トミンハイム仲之町,2024-02-09T01:17:49.947000Z,1707441424,5
1025,1,5,35.63534,139.601602,L1-08.NTT砧ビル,2024-02-09T01:17:49.948000Z,1707441424,6
1026,1,2,35.632689,139.654804,L1-09.コージーK・駒沢,2024-02-09T01:17:49.951000Z,1707441424,3
1027,0,7,35.652913,139.644825,L1-10.宮坂2-4-10,2024-02-09T01:17:49.953000Z,1707441424,7
1028,0,5,35.596579,139.745009,I1-22.ウィラ大井 (ショッピングモール),2024-02-09T01:17:49.954000Z,1707441424,5
1029,9,1,35.585178,139.726339,K1-76.グリーンベルト,2024-02-09T01:17:49.955000Z,1707441424,10
1030,2,14,35.676603,139.829736,H1-121.南砂5丁目,2024-02-09T01:17:49.956000Z,1707441424,16
1031,2,2,35.65558,139.69966,M3-02.文化総合センター大和田,2024-02-09T01:17:49.965000Z,1707441424,4
1032,6,0,35.700033,139.71983,D4-04.ジェノヴィア新宿早稲田グリーンヴェール,2024-02-09T01:17:49.966000Z,1707441424,6
1033,0,2,35.695005,139.772747,A3-20.神田ふれあい通り第２,2024-02-09T01:17:49.967000Z,1707441424,2
1034,16,2,35.650948,139.799711,H1-120.豊洲5丁目,2024-02-09T01:17:49.967000Z,1707441424,18
1035,6,0,35.644241,139.753834,C5-42.DHC芝浦2丁目ビル,2024-02-09T01:17:49.968000Z,1707441424,6
1036,6,0,35.605996,139.743037,I1-65.セブン-イレブン品川東大井1丁目店,2024-02-09T01:17:49.969000Z,1707441424,6
1037,6,0,35.653382,139.721059,M2-04.広尾東公園,2024-02-09T01:17:49.970000Z,1707441424,6
1038,15,4,35.657682,139.703307,M3-13.渋谷駅東口地下駐輪場,2024-02-09T01:17:49.971000Z,1707441424,19
1039,3,2,35.694904,139.772712,A3-19.神田ふれあい通り第１,2024-02-09T01:17:49.972000Z,1707441424,5
1040,2,3,35.689639,139.613516,O6-07.ローソン杉並宮前一丁目店,2024-02-09T01:17:49.976000Z,1707441424,5
1041,2,1,35.736378,139.632485,T3-10.貫井一丁目緑地,2024-02-09T01:17:49.977000Z,1707441424,3
1042,0,10,35.65519,139.718559,M2-05.日本赤十字医療センター,2024-02-09T01:17:49.980000Z,1707441424,10
1043,0,4,35.741769,139.591103,T2-20.パークサイド石神井,2024-02-09T01:17:49.981000Z,1707441424,4
1044,1,3,35.695819,139.674326,N4-06.ローソン中野本町新橋通り店,2024-02-09T01:17:48.302000Z,1707441424,4
1045,3,1,35.726728,139.65874,T3-07.徳殿公園,2024-02-09T01:17:49.983000Z,1707441424,4
1046,5,0,35.549778,139.707362,K1-35.セブン-イレブン 大田区西六郷2丁目店,2024-02-09T01:17:49.986000Z,1707441424,5
1047,8,3,35.698986,139.774099,A3-27.秋葉原駅中央口（ヨドバシカメラ前）,2024-02-09T01:17:49.987000Z,1707441424,11
1048,2,3,35.699173,139.772629,A3-28.秋葉原駅電気街口(西側交通広場),2024-02-09T01:17:49.988000Z,1707441424,5
1049,39,26,35.64508,139.826456,H1-57.新木場駅,2024-02-09T01:17:49.988000Z,1707441424,65
1050,0,22,35.658703,139.817251,H1-58.潮見駅,2024-02-09T01:17:49.989000Z,1707441424,22
1051,0,5,35.722202,139.691712,D7-02.セブン-イレブン 新宿中落合3丁目店,2024-02-09T01:17:49.996000Z,1707441424,5
1052,5,9,35.70057,139.74301,D2-06.飯田濠,2024-02-09T01:17:49.997000Z,1707441424,14
1053,1,9,35.651103,139.759092,C5-17.鈴与浜松町ビル,2024-02-09T01:17:49.998000Z,1707441424,10
1054,13,1,35.681316,139.792176,H1-59.LYURO 東京清澄,2024-02-09T01:17:49.999000Z,1707441424,14
1055,0,10,35.679678,139.844892,H1-60.荒川・砂町庭球場西,2024-02-09T01:17:50.012000Z,1707441424,10
1056,7,0,35.594795,139.704951,K1-44.中馬込貝塚公園,2024-02-09T01:17:50.013000Z,1707441424,7
1057,5,0,35.674337,139.668801,M6-11.京王サイクルパーク笹塚,2024-02-09T01:17:50.014000Z,1707441424,5
1058,0,2,35.638864,139.696568,J1-49.伊勢脇公園,2024-02-09T01:17:50.014000Z,1707441424,2
1059,8,0,35.592801,139.715472,K1-45.たぬき山公園,2024-02-09T01:17:50.016000Z,1707441424,8
1060,9,8,35.702286,139.741093,D2-01.あずさセンタービル,2024-02-09T01:17:50.017000Z,1707441424,17
1061,0,5,35.668791,139.753582,C1-02.西新橋1丁目（外堀通り）,2024-02-09T01:17:48.887000Z,1707441424,5
1062,3,0,35.714044,139.61688,O3-07.NTT井草ビル第1ポート,2024-02-09T01:17:50.024000Z,1707441424,3
1063,2,2,35.74248,139.58715,T2-41.ローソン 練馬東大泉五丁目店,2024-02-09T01:17:50.025000Z,1707441424,4
1064,7,0,35.674199,139.822018,H1-144.南砂住宅,2024-02-09T01:17:50.027000Z,1707441424,7
1065,0,13,35.672477,139.739743,C3-28.ヒューリックＪＰ赤坂ビル,2024-02-09T01:17:50.028000Z,1707441424,13
1066,5,0,35.643131,139.797784,H1-145.東雲都橋住宅,2024-02-09T01:17:50.028000Z,1707441424,5
1067,18,0,35.609664,139.730006,I1-58.品川区役所　第二庁舎前,2024-02-09T01:17:50.029000Z,1707441424,18
1068,21,3,35.561101,139.715173,K1-92.蒲田駅西口自転車駐車場,2024-02-09T01:17:50.032000Z,1707441424,24
1069,2,4,35.702271,139.752619,A2-24.水道橋駅西口前,2024-02-09T01:17:50.033000Z,1707441424,6
1070,1,4,35.572188,139.749613,K1-94.昭和島駅前,2024-02-09T01:17:50.034000Z,1707441424,5
1071,13,7,35.686567,139.699355,M5-15.新宿マインズタワー,2024-02-09T01:17:50.034000Z,1707441424,20
1072,15,0,35.71936,139.679083,D7-13.日本光電本社南側,2024-02-09T01:17:50.036000Z,1707441424,15
1073,0,5,35.708259,139.663829,N3-09.中野区役所(北側),2024-02-09T01:17:50.045000Z,1707441424,5
1074,3,1,35.68663,139.799529,H1-163.森下公園,2024-02-09T01:17:50.046000Z,1707441424,4
1075,4,7,35.653771,139.769295,B4-23.交通広場（豊海町）,2024-02-09T01:17:50.047000Z,1707441424,11
1076,1,6,35.689689,139.698231,D6-18.ヨドバシカメラ 新宿西口本店前,2024-02-09T01:17:50.048000Z,1707441424,7
1077,0,9,35.630151,139.725215,I1-47.NTT 東日本 関東病院(南側),2024-02-09T01:17:50.049000Z,1707441424,9
1078,3,0,35.66305,139.8087,H1-112.ファミリーマート江東塩浜二丁目店,2024-02-09T01:17:50.056000Z,1707441424,3
1079,0,4,35.594515,139.691219,K1-103.雪谷特別出張所,2024-02-09T01:17:50.057000Z,1707441424,4
1080,5,0,35.720896,139.76422,E5-17.Village藍染,2024-02-09T01:17:50.058000Z,1707441424,5
1081,7,1,35.527562,139.737102,Z04.ローソン川崎四谷上町店,2024-02-09T01:17:50.059000Z,1707441424,8
1082,0,6,35.523754,139.746356,Z03.ローソン川崎塩浜三丁目店,2024-02-09T01:17:50.060000Z,1707441424,6
1083,6,0,35.603815,139.741362,I1-49.京急鮫洲バイク駐輪場,2024-02-09T01:17:50.061000Z,1707441424,6
1084,5,2,35.599196,139.739158,I1-50.京急立会川第2バイク駐輪場,2024-02-09T01:17:50.066000Z,1707441424,7
1085,0,7,35.726188,139.741375,E4-14.NTT東日本大塚ビル,2024-02-09T01:17:50.067000Z,1707441424,7
1086,3,4,35.6471,139.712818,M2-07.ファミリーマート恵比寿駅東店,2024-02-09T01:17:50.068000Z,1707441424,7
1087,1,2,35.68082,139.71188,M4-07.千駄ヶ谷駅前,2024-02-09T01:17:50.069000Z,1707441424,3
1088,8,12,35.698169,139.655665,O5-07.バーンホーフ キクチ,2024-02-09T01:17:50.069000Z,1707441424,20
1089,0,8,35.649023,139.696086,J1-11.コンフォリア目黒青葉台,2024-02-09T01:17:50.070000Z,1707441424,8
1090,0,12,35.664335,139.590114,L1-14.給田3丁目,2024-02-09T01:17:50.071000Z,1707441424,12
1091,1,16,35.66291,139.782564,B4-06.月島駅地下駐輪場,2024-02-09T01:17:50.072000Z,1707441424,17
1092,20,1,35.643202,139.746244,C5-09.グランパーク,2024-02-09T01:17:50.073000Z,1707441424,21
1093,4,5,35.637366,139.74844,C5-08.AQUACITY芝浦,2024-02-09T01:17:50.073000Z,1707441424,9
1094,3,2,35.671792,139.733668,C3-08.赤坂パークビルヂング,2024-02-09T01:17:50.076000Z,1707441424,5
1095,10,8,35.672659,139.725644,C3-07.新青山ビル,2024-02-09T01:17:50.076000Z,1707441424,18
1096,2,7,35.67064,139.728166,C3-06.ホテルアジア会館,2024-02-09T01:17:50.077000Z,1707441424,9
1097,0,29,35.653159,139.744673,C1-24.三田国際ビル,2024-02-09T01:17:50.080000Z,1707441424,29
1098,8,1,35.632842,139.7495,C5-07.港区立港南図書館,2024-02-09T01:17:50.081000Z,1707441424,9
1099,16,4,35.697642,139.774867,A3-04.秋葉原公園,2024-02-09T01:17:50.082000Z,1707441424,20
1100,5,0,35.698817,139.778898,A3-05.和泉公園（西側入口）,2024-02-09T01:17:50.083000Z,1707441424,5
1101,4,3,35.689575,139.767848,A3-02.絶滅メディア博物館（楓ビル）,2024-02-09T01:17:50.086000Z,1707441424,7
1102,6,2,35.716265,139.618954,O3-10.メゾンパークス,2024-02-09T01:17:50.087000Z,1707441424,8
1103,0,25,35.689665,139.764091,A2-05.神田橋公園,2024-02-09T01:17:50.088000Z,1707441424,25
1104,0,7,35.692983,139.76773,A3-01.神田児童公園（西側交番横）,2024-02-09T01:17:50.088000Z,1707441424,7
1105,5,0,35.698338,139.754876,A2-03.西神田公園（西側）,2024-02-09T01:17:50.089000Z,1707441424,5
1106,7,0,35.675198,139.663587,M6-03.十三号通り公園,2024-02-09T01:17:50.092000Z,1707441424,7
1107,6,0,35.673444,139.666553,M6-02.サイカパーク笹塚,2024-02-09T01:17:50.095000Z,1707441424,6
1108,0,8,35.701318,139.825916,H1-165.亀戸梅屋敷,2024-02-09T01:17:50.096000Z,1707441424,8
1109,8,9,35.696574,139.82972,H1-166.亀戸クロック,2024-02-09T01:17:50.098000Z,1707441424,17
1110,0,6,35.684423,139.692262,M5-02.あいおいニッセイ同和損保新宿ビル,2024-02-09T01:17:50.099000Z,1707441424,6
1111,32,5,35.677175,139.676769,M6-01.幡ヶ谷駅高架下第一,2024-02-09T01:17:50.102000Z,1707441424,37
1112,0,18,35.673555,139.741293,A5-02.山王パークタワー,2024-02-09T01:17:50.103000Z,1707441424,18
1113,12,0,35.567176,139.742345,K1-116.旧呑川緑地（大森東五丁目）,2024-02-09T01:17:50.103000Z,1707441424,12
1114,4,0,35.565685,139.736195,K1-115.旧呑川緑地（大森中三丁目）,2024-02-09T01:17:50.104000Z,1707441424,4
1115,8,0,35.568722,139.680736,K1-114.下丸子公園,2024-02-09T01:17:50.105000Z,1707441424,8
1116,3,7,35.767129,139.664365,T3-05.東武練馬駅南,2024-02-09T01:17:50.106000Z,1707441424,10
1117,4,0,35.761038,139.623148,T1-14.ファミリーマート 練馬高松五丁目北店,2024-02-09T01:17:50.109000Z,1707441424,4
1118,3,3,35.674094,139.728895,C3-29.高橋是清翁記念公園,2024-02-09T01:17:50.116000Z,1707441424,6
1119,1,4,35.561291,139.715076,K1-141.蒲田駅西口歩道,2024-02-09T01:17:50.117000Z,1707441424,5
1120,11,6,35.667069,139.713423,C3-35.ワールド北青山ビル,2024-02-09T01:17:50.119000Z,1707441424,17
1121,16,0,35.671282,139.675307,M5-03.代々木大山公園,2024-02-09T01:17:50.120000Z,1707441424,16
1122,2,4,35.715592,139.76192,E5-13.弥生二丁目,2024-02-09T01:17:50.122000Z,1707441424,6
1123,4,1,35.704475,139.763041,E5-12.NK本郷ビル,2024-02-09T01:17:50.123000Z,1707441424,5
1124,2,8,35.668395,139.769849,B3-18.銀座松竹スクエア,2024-02-09T01:17:50.126000Z,1707441424,10
1125,4,2,35.64115,139.741471,C1-44.三田Avanti,2024-02-09T01:17:50.132000Z,1707441424,6
1126,0,5,35.739488,139.590273,T2-31.ファミリーマート 石神井台二丁目店,2024-02-09T01:17:50.133000Z,1707441424,5
1127,8,1,35.636978,139.791858,H1-150.ホテルヴィラフォンテーヌ南側,2024-02-09T01:17:50.134000Z,1707441424,9
1128,2,6,35.639132,139.793047,H1-149.有明ガーデン 公園口,2024-02-09T01:17:50.136000Z,1707441424,8
1129,0,13,35.694104,139.840278,H1-148.大島七丁目団地,2024-02-09T01:17:50.137000Z,1707441424,13
1130,12,1,35.654371,139.779545,B4-26.東武ストア晴海三丁目店,2024-02-09T01:17:50.137000Z,1707441424,13
1131,5,2,35.623459,139.687128,J1-26.田向公園,2024-02-09T01:17:50.140000Z,1707441424,7
1132,6,2,35.625081,139.682632,J1-25.碑文谷公園,2024-02-09T01:17:50.144000Z,1707441424,8
1133,10,9,35.65238,139.815613,H1-195.東京アクアティクスセンター,2024-02-09T01:17:50.145000Z,1707441424,19
1134,2,4,35.761613,139.61349,T1-13.ファミリーマート 練馬土支田二丁目店,2024-02-09T01:17:50.152000Z,1707441424,6
1135,1,4,35.73969,139.62125,T2-34.ファミリーマート 練馬富士見台店,2024-02-09T01:17:50.153000Z,1707441424,5
1136,1,3,35.738607,139.585331,T2-35.ファミリーマート 石神井台六丁目店,2024-02-09T01:17:50.154000Z,1707441424,4
1137,16,4,35.646534,139.748913,C1-81.田町タワー,2024-02-09T01:17:50.156000Z,1707441424,20
1138,13,2,35.641992,139.701588,J1-07.目黒川船入場,2024-02-09T01:17:50.156000Z,1707441424,15
1139,18,0,35.634533,139.708868,J1-08.目黒区民センター公園,2024-02-09T01:17:50.160000Z,1707441424,18
1140,6,0,35.695102,139.723345,D4-01.市谷仲之町,2024-02-09T01:17:50.164000Z,1707441424,6
1141,14,2,35.652151,139.698426,M2-11.鉢山町,2024-02-09T01:17:50.165000Z,1707441424,16
1142,7,2,35.720546,139.756685,E4-08.ドコモ・バイクシェア向丘ポート,2024-02-09T01:17:50.166000Z,1707441424,9
1143,4,0,35.695636,139.727882,D4-03.市谷加賀町2丁目,2024-02-09T01:17:50.167000Z,1707441424,4
1144,8,2,35.506142,139.701005,Z10.ローソン川崎浅田三丁目店,2024-02-09T01:17:48.231000Z,1707441424,10
1145,1,8,35.719717,139.64785,N1-01.BeGood野方,2024-02-09T01:17:50.171000Z,1707441424,9
1146,0,17,35.666357,139.73923,C2-03.アークヒルズサウスタワー,2024-02-09T01:17:50.177000Z,1707441424,17
1147,0,19,35.667107,139.739565,C2-01.アークヒルズ（アーク森ビル）,2024-02-09T01:17:50.178000Z,1707441424,19
1148,1,24,35.661158,139.728533,C2-02.六本木ヒルズ,2024-02-09T01:17:50.179000Z,1707441424,25
1149,1,24,35.624966,139.746657,C5-03.港南公園C,2024-02-09T01:17:50.180000Z,1707441424,25
1150,7,0,35.646801,139.751208,C5-04.みなとパーク芝浦,2024-02-09T01:17:50.187000Z,1707441424,7
1151,3,3,35.659442,139.745549,C1-16.機械振興会館,2024-02-09T01:17:50.191000Z,1707441424,6
1152,4,1,35.664461,139.756082,C1-14.新橋プラザビル,2024-02-09T01:17:50.192000Z,1707441424,5
1153,4,1,35.67386,139.79976,H1-73.イシマビル,2024-02-09T01:17:50.193000Z,1707441424,5
1154,5,0,35.67753,139.63667,O7-01.西永福公園,2024-02-09T01:17:50.197000Z,1707441424,5
1155,6,2,35.68296,139.60861,O6-02.富士見ヶ丘南自転車駐車場,2024-02-09T01:17:50.200000Z,1707441424,8
1156,1,4,35.556199,139.721476,K1-50.テクノポートカマタ 第1,2024-02-09T01:17:50.201000Z,1707441424,5
1157,38,1,35.614856,139.678208,J1-14.二の橋自転車置場1,2024-02-09T01:17:50.209000Z,1707441424,39
1158,3,0,35.714077,139.61694,O3-08.NTT井草ビル第２ポート,2024-02-09T01:17:50.211000Z,1707441424,3
1159,13,0,35.680636,139.817977,H1-124.セブン-イレブン 江東海辺店,2024-02-09T01:17:50.212000Z,1707441424,13
1160,1,4,35.679807,139.715931,D1-11.三井ガーデンホテル神宮外苑の杜プレミア,2024-02-09T01:17:50.216000Z,1707441424,5
1161,3,5,35.678913,139.639944,O7-07.ハレ永福,2024-02-09T01:17:50.223000Z,1707441424,8
1162,0,18,35.627891,139.776896,C5-32.トレードピアお台場,2024-02-09T01:17:50.224000Z,1707441424,18
1163,4,0,35.653531,139.769431,B4-18.豊海センタービル,2024-02-09T01:17:50.225000Z,1707441424,4
1164,6,1,35.707388,139.700204,D5-04.西戸山公園野球場,2024-02-09T01:17:50.228000Z,1707441424,7
1165,0,7,35.702288,139.68862,D5-03.北新宿公園,2024-02-09T01:17:50.233000Z,1707441424,7
1166,3,3,35.706182,139.723394,D3-04.鶴巻南公園,2024-02-09T01:17:50.233000Z,1707441424,6
1167,3,1,35.712431,139.715418,D3-03.甘泉園公園,2024-02-09T01:17:50.234000Z,1707441424,4
1168,0,6,35.576593,139.706597,K1-03.池上会館,2024-02-09T01:17:50.235000Z,1707441424,6
1169,14,1,35.579049,139.739878,K1-02.平和の森公園,2024-02-09T01:17:50.236000Z,1707441424,15
1170,0,16,35.57685,139.742496,K1-01.大森海苔のふるさと館,2024-02-09T01:17:50.237000Z,1707441424,16
1171,3,6,35.687652,139.689254,D6-13.新宿中央公園（ジャブジャブ池下）,2024-02-09T01:17:50.238000Z,1707441424,9
1172,4,1,35.752217,139.571095,T2-28.ファミリーマート 南大泉六丁目店,2024-02-09T01:17:50.240000Z,1707441424,5
1173,10,7,35.581832,139.741581,K1-05.平和島公園プール,2024-02-09T01:17:50.241000Z,1707441424,17
1174,19,1,35.559483,139.724273,K1-04.京急蒲田駅東口,2024-02-09T01:17:50.242000Z,1707441424,20
1175,15,0,35.716586,139.727705,E2-10.音羽パークロード（北入口）,2024-02-09T01:17:50.246000Z,1707441424,15
1176,18,1,35.715382,139.728533,E2-11.音羽パークロード（キャッチボール場横）,2024-02-09T01:17:50.246000Z,1707441424,19
1177,10,0,35.593887,139.741204,I1-21.大井競馬場(正門前),2024-02-09T01:17:50.247000Z,1707441424,10
1178,0,4,35.623215,139.668472,J1-27.衾町公園,2024-02-09T01:17:50.256000Z,1707441424,4
1179,4,3,35.75372,139.584332,T2-44.中島橋自転車駐車場,2024-02-09T01:17:50.257000Z,1707441424,7
1180,0,6,35.668845,139.765144,B3-15.ACホテル・バイ・マリオット東京銀座,2024-02-09T01:17:50.258000Z,1707441424,6
1181,3,3,35.699252,139.697606,D5-07.百人町1丁目,2024-02-09T01:17:50.259000Z,1707441424,6
1182,4,1,35.632128,139.732097,C4-04.ショパン高輪,2024-02-09T01:17:50.260000Z,1707441424,5
1183,0,3,35.681352,139.781436,B1-18.セブン-イレブン 日本橋小網町店,2024-02-09T01:17:50.261000Z,1707441424,3
1184,4,3,35.7211,139.574669,T2-71.わかば児童公園,2024-02-09T01:17:50.266000Z,1707441424,7
1185,0,18,35.647076,139.703964,M3-15.co-ba ebisu,2024-02-09T01:17:50.268000Z,1707441424,18
1186,0,5,35.66206,139.735501,C2-20.三井ガーデンホテル六本木プレミア,2024-02-09T01:17:50.269000Z,1707441424,5
1187,1,8,35.624566,139.72448,I1-70.五反田リバーステーション,2024-02-09T01:17:50.270000Z,1707441424,9
1188,10,0,35.711875,139.759306,E5-25.ジェノヴィア東大前グリーンヴェール,2024-02-09T01:17:50.272000Z,1707441424,10
1189,3,5,35.689017,139.714755,D1-12.ジェノヴィア新宿御苑グリーンヴェール,2024-02-09T01:17:50.276000Z,1707441424,8
1190,24,12,35.645682,139.748768,C5-33.msb Tamachi,2024-02-09T01:17:50.278000Z,1707441424,36
1191,1,0,35.690348,139.796133,G4-09.SYFORME MORISHITA Ⅱ 1,2024-02-09T01:17:50.280000Z,1707441424,1
1192,5,0,35.690307,139.796128,G4-10.SYFORME MORISHITA Ⅱ 2,2024-02-09T01:17:50.281000Z,1707441424,5
1193,1,11,35.715878,139.673669,N3-19.上高田パーキング,2024-02-09T01:17:49.395000Z,1707441424,12
1194,7,4,35.528361,139.696499,Z13.京急川崎日進町駐輪場,2024-02-09T01:17:50.287000Z,1707441424,11
1195,2,3,35.707305,139.773657,F6-01.松坂屋上野店,2024-02-09T01:17:48.711000Z,1707441424,5
1196,3,1,35.718832,139.791133,F4-01.SYFORME ASAKUSA,2024-02-09T01:17:47.711000Z,1707441424,4
1197,1,1,35.716062,139.799552,F2-02.アップルパーク浅草6丁目第3,2024-02-09T01:17:49.002000Z,1707441424,2
1198,3,17,35.71283,139.787754,F2-01.松が谷2丁目2,2024-02-09T01:17:49.009000Z,1707441424,20
1199,3,4,35.706023,139.783751,F1-02.台東デザイナーズビレッジ,2024-02-09T01:17:49.088000Z,1707441424,7
1200,0,6,35.717497,139.790055,F2-03.台東区生涯学習センター,2024-02-09T01:17:49.391000Z,1707441424,6
1201,3,0,35.582743,139.710561,K1-146.南馬込6丁目25-11,2024-02-09T01:17:49.384000Z,1707441424,3
1202,1,16,35.724944,139.801684,F3-01.清川1丁目18-11,2024-02-09T01:17:49.033000Z,1707441424,17
1203,2,12,35.706793,139.782985,F1-03.新御徒町駅自転車駐車場,2024-02-09T01:17:49.077000Z,1707441424,14
1204,0,7,35.717571,139.804216,F3-02.台東区リバーサイドスポーツセンター,2024-02-09T01:17:48.690000Z,1707441424,7
1205,0,6,35.62541,139.718135,I1-45.セブン-イレブン品川西五反田3丁目店,2024-02-09T01:17:48.789000Z,1707441424,6
1206,0,17,35.684218,139.832843,H1-135.北砂5丁目団地,2024-02-09T01:17:49.186000Z,1707441424,17
1207,0,11,35.6738,139.731525,C3-16.赤坂ガーデンシティ,2024-02-09T01:17:49.272000Z,1707441424,11
1208,10,0,35.636269,139.709073,J1-34.田道広場公園,2024-02-09T01:17:48.708000Z,1707441424,10
1209,0,3,35.69714,139.65432,O5-08.セシオン杉並,2024-02-09T01:17:48.245000Z,1707441424,3
1210,0,30,35.691456,139.762228,A2-04.ちよだプラットフォームスクウェア,2024-02-09T01:17:50.090000Z,1707441424,30
1211,7,0,35.598244,139.722447,I1-102.J.GRAN Court 品川西大井 EAST,2024-02-09T01:17:47.790000Z,1707441424,7
1212,4,2,35.665288,139.824294,H1-196.フットサルクラブ東京東陽町,2024-02-09T01:17:47.791000Z,1707441424,6
1213,1,2,35.717241,139.801674,F2-04.コンフォラス浅草マンション,2024-02-09T01:17:47.788000Z,1707441424,3
1214,2,3,35.693492,139.81506,G5-03.京成リッチモンドホテル東京錦糸町,2024-02-09T01:17:47.789000Z,1707441424,5
1215,4,0,35.544715,139.707623,K1-27.六郷文化センター,2024-02-09T01:17:49.288000Z,1707441424,4
1216,2,0,35.552741,139.718404,K1-147.トヨタモビリティ東京GRGarage東京蒲田店,2024-02-09T01:17:48.279000Z,1707441424,2
1217,6,0,35.552068,139.71747,K1-148.トヨタモビリティ東京 蒲田仲六郷店,2024-02-09T01:17:48.278000Z,1707441424,6
1218,4,1,35.568019,139.696379,K1-150.トヨタモビリティ東京 池上第二京浜店,2024-02-09T01:17:48.265000Z,1707441424,5
1219,6,0,35.59336,139.715879,K1-149.トヨタモビリティ東京 大田店,2024-02-09T01:17:48.264000Z,1707441424,6
1220,5,0,35.647831,139.739048,C1-82.トヨタモビリティ東京 港三田店,2024-02-09T01:17:48.266000Z,1707441424,5
1221,2,0,35.699835,139.70808,D4-11.トヨタモビリティ東京 新宿明治通り南店,2024-02-09T01:17:48.266000Z,1707441424,2
1222,7,10,35.670239,139.744285,C3-31.赤坂一丁目,2024-02-09T01:17:47.908000Z,1707441424,17
1223,30,10,35.707853,139.751518,E1-04.礫川公園,2024-02-09T01:17:47.668000Z,1707441424,40
1224,4,5,35.658229,139.694885,M3-23.円山町7-1,2024-02-09T01:17:48.933000Z,1707441424,9
1225,2,15,35.66026,139.69684,M3-24.渋谷道玄坂２丁目駐輪場,2024-02-09T01:17:50.118000Z,1707441424,17
1226,1,5,35.764452,139.666299,T3-32.練馬北町1丁目,2024-02-09T01:17:49.126000Z,1707441424,6
1227,3,0,35.675361,139.825034,H1-197.セブン-イレブン江東南砂葛西橋通り店,2024-02-09T01:17:48.379000Z,1707441424,3
1228,0,3,35.748395,139.605958,T2-84.石神井町二丁目緑地,2024-02-09T01:17:49.230000Z,1707441424,3
1229,2,3,35.737899,139.576584,T2-82.梅の木児童遊園,2024-02-09T01:17:47.894000Z,1707441424,5
1230,5,3,35.760442,139.573145,T2-83.西大泉さくら緑地,2024-02-09T01:17:50.022000Z,1707441424,8
1231,7,1,35.725818,139.678976,D7-05.西落合図書館,2024-02-09T01:17:47.877000Z,1707441424,8
1232,0,7,35.690899,139.706348,D6-28.東急ステイ新宿,2024-02-09T01:17:49.134000Z,1707441424,7
1233,3,1,35.7547,139.601497,T2-85.泉新公園,2024-02-09T01:17:48.179000Z,1707441424,4
1234,2,1,35.746956,139.600798,T2-86.石神井町八丁目緑地,2024-02-09T01:17:49.089000Z,1707441424,3
1235,1,3,35.745607,139.573947,T2-87.南大泉四丁目児童遊園,2024-02-09T01:17:49.301000Z,1707441424,4
1236,0,4,35.739633,139.570457,T2-88.南大泉かたまち緑地,2024-02-09T01:17:48.149000Z,1707441424,4
1237,0,3,35.742755,139.568335,T2-89.南大泉三丁目児童遊園,2024-02-09T01:17:49.964000Z,1707441424,3
1238,23,0,35.719421,139.725584,E2-05.護国寺駅西自転車駐車場,2024-02-09T01:17:47.657000Z,1707441424,23
1239,0,4,35.647704,139.693671,J1-59.第44興和ビル,2024-02-09T01:17:50.100000Z,1707441424,4
1240,10,6,35.65928,139.744767,C1-15.東京タワー,2024-02-09T01:17:50.186000Z,1707441424,16
1241,2,0,35.645254,139.754765,C5-20.ローソン芝浦二丁目店,2024-02-09T01:17:49.281000Z,1707441424,2
1242,16,1,35.651382,139.724392,C2-27.有栖川宮記念公園第一,2024-02-09T01:17:49.397000Z,1707441424,17
1243,7,1,35.651129,139.726003,C2-28.有栖川宮記念公園第二,2024-02-09T01:17:49.392000Z,1707441424,8
1244,5,0,35.658204,139.738935,C2-29.狸穴公園,2024-02-09T01:17:49.393000Z,1707441424,5
1245,2,2,35.733195,139.612327,T2-90.南田中四丁目緑地,2024-02-09T01:17:49.394000Z,1707441424,4
1246,4,1,35.745272,139.604579,T2-91.石神井町四丁目緑地,2024-02-09T01:17:48.947000Z,1707441424,5
1247,1,6,35.698917,139.771856,A3-41.秋葉原ダイビル,2024-02-09T01:17:50.206000Z,1707441424,7
1248,2,2,35.638904,139.712518,J1-54.田道住区センター三田分室,2024-02-09T01:17:47.650000Z,1707441424,4
1249,9,6,35.689896,139.815116,H1-140.キャナルパレス住吉,2024-02-09T01:17:49.231000Z,1707441424,15
1250,0,37,35.667259,139.745643,C1-57.虎ノ門ツインビルディング,2024-02-09T01:17:48.233000Z,1707441424,37
1251,3,2,35.579435,139.698552,K1-54.ファミリーマート大田久が原五丁目店,2024-02-09T01:17:48.852000Z,1707441424,5
1252,7,1,35.685504,139.790817,B1-29.ASTILE日本橋浜町,2024-02-09T01:17:50.176000Z,1707441424,8
1253,3,2,35.701157,139.679617,N3-20.SYFORME NAKANO-SAKAUE,2024-02-09T01:17:49.999000Z,1707441424,5
1254,3,6,35.696207,139.700521,D6-31.東急歌舞伎町タワー駐輪場,2024-02-09T01:17:50.120000Z,1707441424,9
1255,6,0,35.603327,139.729006,I1-30.ローソン 大井三丁目店,2024-02-09T01:17:50.222000Z,1707441424,6
1256,9,0,35.549465,139.711157,K1-151.PATH仲六郷,2024-02-09T01:17:49.396000Z,1707441424,9
1257,2,5,35.63464,139.783445,H1-198.Br Tower 有明 MID CROSS,2024-02-09T01:17:50.167000Z,1707441424,7
1258,40,23,35.63363,139.79082,H1-04.石と光の広場（国際展示場駅）,2024-02-09T01:17:50.026000Z,1707441424,63
1259,5,2,35.66288,139.78329,B4-24.ミュプレ月島,2024-02-09T01:17:49.418000Z,1707441424,7
1260,10,0,35.664244,139.814506,H1-199.ラ・ヴェール東陽町,2024-02-09T01:17:49.164000Z,1707441424,10
1261,5,1,35.662414,139.813333,H1-200.ヴェッセル木場南,2024-02-09T01:17:49.165000Z,1707441424,6
1262,3,2,35.703465,139.780325,F1-04.台東2丁目21,2024-02-09T01:17:49.166000Z,1707441424,5
1263,1,4,35.728704,139.801867,F3-03.ヴェルステージ南千住,2024-02-09T01:17:48.471000Z,1707441424,5
1264,4,0,35.632735,139.683899,J1-46.五本木西みどり街かど公園,2024-02-09T01:17:48.197000Z,1707441424,4
1265,1,4,35.525854,139.717848,Z24.総合川崎臨港病院,2024-02-09T01:17:49.385000Z,1707441424,5
1266,11,4,35.567146,139.693344,K1-131.東急武蔵新田駅駐輪場,2024-02-09T01:17:48.314000Z,1707441424,15
1267,0,7,35.543327,139.703223,K1-152.アットホームスクエア前,2024-02-09T01:17:49.121000Z,1707441424,7
1268,1,13,35.676119,139.772895,B2-04.清水建設本社（都営地下鉄宝町駅 Ａ８出口）,2024-02-09T01:17:47.695000Z,1707441424,14
1269,8,4,35.648107,139.813572,H1-202.辰巳の森海浜公園,2024-02-09T01:17:49.871000Z,1707441424,12
1270,5,1,35.678099,139.791831,H1-201.ウエリスアーバン水天宮前2,2024-02-09T01:17:49.866000Z,1707441424,6
1271,0,3,35.622389,139.721552,I1-103.五反田ＪＰビルディング,2024-02-09T01:17:50.218000Z,1707441424,3
1272,13,1,35.65838,139.59231,L1-16.上祖師谷7丁目,2024-02-09T01:17:49.864000Z,1707441424,14
1273,1,1,35.700772,139.66063,O5-09.AppCruise中野,2024-02-09T01:17:49.877000Z,1707441424,2
1274,0,1,35.67517,139.804087,H1-203.セブン-イレブン江東木場３丁目店,2024-02-09T01:17:47.794000Z,1707441424,1
1275,25,0,35.648726,139.790877,H1-44.テプコ豊洲ビル,2024-02-09T01:17:48.334000Z,1707441424,25
1276,2,5,35.659787,139.636696,L1-17.赤堤3丁目,2024-02-09T01:17:47.776000Z,1707441424,7
1277,20,10,35.662796,139.626795,L1-18.上北沢1丁目,2024-02-09T01:17:47.798000Z,1707441424,30
1278,0,18,35.666001,139.778102,B3-16.明石町区民館,2024-02-09T01:17:48.726000Z,1707441424,18
1279,4,1,35.603521,139.712345,I1-104.源氏前ビル,2024-02-09T01:17:48.698000Z,1707441424,5
1280,2,1,35.617699,139.664826,J1-28.宮前公園,2024-02-09T01:17:50.252000Z,1707441424,3
1281,3,0,35.686521,139.685017,M6-18.セブン-イレブン渋谷本町3丁目店,2024-02-09T01:17:48.696000Z,1707441424,3
1282,1,3,35.67187,139.65474,O7-08.杉並区和泉2-3-17,2024-02-09T01:17:48.679000Z,1707441424,4
1283,6,1,35.75987,139.640474,T1-17.セブン-イレブン練馬田柄通店,2024-02-09T01:17:48.261000Z,1707441424,7
1284,8,8,35.631192,139.79401,H1-18.東京ビッグサイト,2024-02-09T01:17:49.116000Z,1707441424,16
1285,12,1,35.657726,139.697802,M3-01.渋谷マークシティ,2024-02-09T01:17:49.339000Z,1707441424,13
1286,10,7,35.63403,139.784319,H1-70.有明スポーツセンター,2024-02-09T01:17:48.258000Z,1707441424,17
1287,13,0,35.676475,139.804741,H1-41.深川北スポーツセンター,2024-02-09T01:17:48.831000Z,1707441424,13
1288,0,7,35.681089,139.800777,H1-55.深川江戸資料館,2024-02-09T01:17:49.448000Z,1707441424,7
1289,4,2,35.622588,139.716159,I1-61.五反田文化センター,2024-02-09T01:17:49.152000Z,1707441424,6
1290,5,0,35.700052,139.673715,N3-13.中部すこやか福祉センター,2024-02-09T01:17:47.760000Z,1707441424,5
1291,0,17,35.686847,139.765151,A4-02.東京サンケイビル,2024-02-09T01:17:47.923000Z,1707441424,17
1292,10,8,35.661475,139.699296,M3-09.ティップ.クロス TOKYO 渋谷,2024-02-09T01:17:49.804000Z,1707441424,18
1293,4,2,35.670336,139.771911,B3-02.サンクンガーデン,2024-02-09T01:17:47.701000Z,1707441424,6
1294,3,2,35.748153,139.58765,T2-10.勤労福祉会館,2024-02-09T01:17:50.045000Z,1707441424,5
1295,12,0,35.584217,139.759232,K1-133.東京港野鳥公園,2024-02-09T01:17:48.934000Z,1707441424,12
1296,4,0,35.55079,139.716517,K1-21.六郷特別出張所,2024-02-09T01:17:49.144000Z,1707441424,4
1297,5,14,35.680052,139.831874,H1-54.砂町文化センター,2024-02-09T01:17:49.445000Z,1707441424,19
1298,4,0,35.689984,139.725261,D1-08.新宿歴史博物館,2024-02-09T01:17:48.158000Z,1707441424,4
1299,23,4,35.708291,139.753335,E1-05.春日地下自転車駐車場,2024-02-09T01:17:47.669000Z,1707441424,27
1300,5,0,35.71724,139.74289,E1-15.播磨坂事業所,2024-02-09T01:17:49.210000Z,1707441424,5
1301,9,3,35.719356,139.764308,E5-02.不忍通りふれあい館,2024-02-09T01:17:49.931000Z,1707441424,12
1302,11,2,35.717357,139.757817,E4-02.向丘地域活動センター,2024-02-09T01:17:49.936000Z,1707441424,13
1303,3,2,35.678509,139.721207,C3-18.明治記念館,2024-02-09T01:17:48.763000Z,1707441424,5
1304,12,3,35.705018,139.706841,D5-05.中央図書館,2024-02-09T01:17:49.443000Z,1707441424,15
1305,13,0,35.713223,139.721699,E2-07.肥後細川庭園,2024-02-09T01:17:48.754000Z,1707441424,13
1306,1,2,35.699187,139.746348,A1-05.富士見出張所,2024-02-09T01:17:48.082000Z,1707441424,3
1307,5,3,35.707296,139.769393,E5-07.湯島三丁目児童遊園,2024-02-09T01:17:49.625000Z,1707441424,8
1308,1,6,35.705154,139.697562,D5-10.桜美林大学 新宿キャンパス,2024-02-09T01:17:48.741000Z,1707441424,7
1309,9,4,35.702029,139.768245,A3-08.神田明神（神田神社）,2024-02-09T01:17:49.335000Z,1707441424,13
1310,5,0,35.713145,139.723342,E2-14.永青文庫 ミュージアム,2024-02-09T01:17:48.285000Z,1707441424,5
1311,5,3,35.6866,139.70014,M5-17.小田急サザンタワー,2024-02-09T01:17:47.716000Z,1707441424,8
1312,6,0,35.563092,139.693548,K1-16.ファミリーマート 矢口二丁目店,2024-02-09T01:17:49.279000Z,1707441424,6
1313,0,5,35.683866,139.831809,H1-206.北砂5丁目団地2,2024-02-09T01:17:49.789000Z,1707441424,5
1314,4,10,35.727495,139.828499,G1-02.八広駅高架下,2024-02-09T01:17:49.779000Z,1707441424,14
1315,0,4,35.717963,139.791025,F4-02.Risingplace浅草四番館,2024-02-09T01:17:49.778000Z,1707441424,4
1316,8,0,35.68832,139.828829,H1-204.大島四丁目団地2,2024-02-09T01:17:47.758000Z,1707441424,8
1317,9,1,35.688236,139.827711,H1-205.大島四丁目団地3,2024-02-09T01:17:47.759000Z,1707441424,10
1318,15,4,35.699874,139.834263,H1-106.亀戸中央公園,2024-02-09T01:17:47.714000Z,1707441424,19
1319,2,8,35.705148,139.769314,E5-30.湯島3丁目15,2024-02-09T01:17:49.276000Z,1707441424,10
1320,0,22,35.650347,139.771785,B4-38.HARUMI FLAG SUN VILLAGE,2024-02-09T01:17:47.913000Z,1707441424,22
1321,3,8,35.648731,139.774995,B4-32.HARUMI FLAG SEA VILLAGE,2024-02-09T01:17:47.933000Z,1707441424,11
1322,0,18,35.650604,139.77724,B4-31.HARUMI FLAG PORT VILLAGE,2024-02-09T01:17:47.942000Z,1707441424,18
1323,0,14,35.649552,139.776369,B4-33.HARUMI FLAG SEA VILLAGE,2024-02-09T01:17:47.953000Z,1707441424,14
1324,4,8,35.650742,139.778097,B4-36.HARUMI FLAG SEA VILLAGE,2024-02-09T01:17:48.605000Z,1707441424,12
1325,5,7,35.650573,139.777908,B4-35.HARUMI FLAG SEA VILLAGE,2024-02-09T01:17:48.611000Z,1707441424,12
1326,0,17,35.649419,139.771447,B4-37.HARUMI FLAG SUN VILLAGE,2024-02-09T01:17:48.631000Z,1707441424,17
1327,5,7,35.649932,139.776958,B4-34.HARUMI FLAG SEA VILLAGE,2024-02-09T01:17:48.635000Z,1707441424,12
1328,0,15,35.650863,139.772549,B4-39.HARUMI FLAG SUN VILLAGE,2024-02-09T01:17:48.649000Z,1707441424,15
1329,0,17,35.651305,139.773379,B4-40.HARUMI FLAG SUN VILLAGE,2024-02-09T01:17:48.677000Z,1707441424,17
1330,0,13,35.649854,139.77334,B4-41.HARUMI FLAG SUN VILLAGE,2024-02-09T01:17:48.686000Z,1707441424,13
1331,2,9,35.649329,139.772656,B4-42.HARUMI FLAG SUN VILLAGE,2024-02-09T01:17:48.687000Z,1707441424,11
1332,0,12,35.651183,139.776119,B4-28.HARUMI FLAG PORT VILLAGE,2024-02-09T01:17:49.364000Z,1707441424,12
1333,4,5,35.648295,139.773973,B4-50.HARUMI FLAG PARK VILLAGE,2024-02-09T01:17:49.364000Z,1707441424,9
1334,8,8,35.648636,139.774251,B4-49.HARUMI FLAG PARK VILLAGE,2024-02-09T01:17:49.365000Z,1707441424,16
1335,0,4,35.649513,139.775287,B4-48.HARUMI FLAG PARK VILLAGE,2024-02-09T01:17:49.366000Z,1707441424,4
1336,2,4,35.649119,139.775138,B4-47.HARUMI FLAG PARK VILLAGE,2024-02-09T01:17:49.367000Z,1707441424,6
1337,0,25,35.649642,139.773859,B4-46.HARUMI FLAG PARK VILLAGE,2024-02-09T01:17:49.368000Z,1707441424,25
1338,0,26,35.649002,139.772764,B4-45.HARUMI FLAG PARK VILLAGE,2024-02-09T01:17:49.369000Z,1707441424,26
1339,3,10,35.648221,139.772666,B4-44.HARUMI FLAG PARK VILLAGE,2024-02-09T01:17:49.373000Z,1707441424,13
1340,3,8,35.651136,139.778218,B4-30.HARUMI FLAG PORT VILLAGE,2024-02-09T01:17:49.380000Z,1707441424,11
1341,6,5,35.651907,139.777391,B4-29.HARUMI FLAG PORT VILLAGE,2024-02-09T01:17:49.381000Z,1707441424,11
1342,1,4,35.639302,139.674744,L1-19.三軒茶屋1丁目駐輪場,2024-02-09T01:17:48.187000Z,1707441424,5
1343,11,6,35.678921,139.658289,O7-09.方南月極パーキング,2024-02-09T01:17:48.186000Z,1707441424,17
1344,1,3,35.68942,139.662118,O5-10.ローソン ツルハドラッグ杉並和田店,2024-02-09T01:17:48.192000Z,1707441424,4
1345,2,3,35.708082,139.607543,O2-04.西荻北1丁目,2024-02-09T01:17:48.680000Z,1707441424,5
1346,0,12,35.556231,139.751408,K1-75.三井不動産インダストリアルパーク羽田,2024-02-09T01:17:48.839000Z,1707441424,12
1347,2,1,35.703024,139.78052,F1-05.ホウエイコート秋葉原,2024-02-09T01:17:49.404000Z,1707441424,3
1348,0,3,35.666349,139.741781,C3-36.第35興和ビル,2024-02-09T01:17:49.403000Z,1707441424,3
1349,27,79,35.651627,139.773103,B4-53.晴海五丁目ターミナル,2024-02-09T01:17:49.405000Z,1707441424,106
1350,9,0,35.643105,139.753039,C5-44.ブランズタワー芝浦,2024-02-09T01:17:47.665000Z,1707441424,9
1351,10,3,35.690602,139.766916,A3-47.ホテルヴィラフォンテーヌ東京大手町,2024-02-09T01:17:48.376000Z,1707441424,13
1352,4,0,35.693021,139.740317,A1-20.菱和パレス九段,2024-02-09T01:17:48.372000Z,1707441424,4
