,empty_slots,free_bikes,latitude,longitude,name,timestamp,extra.last_updated,extra.slots
0,0,5,35.708596,139.758269,E5-26.本郷4丁目,2024-02-08T19:00:25.413000Z,1707418805,5
1,31,4,35.692599,139.770109,A3-42.内神田3丁目,2024-02-08T19:00:25.420000Z,1707418805,35
2,3,2,35.748736,139.574839,T2-76.東中前の森緑地,2024-02-08T19:00:25.421000Z,1707418805,5
3,19,0,35.693408,139.762809,A2-20.神田スクエア,2024-02-08T19:00:25.422000Z,1707418805,19
4,3,4,35.586993,139.736491,K1-79.Tマークシティホテル東京大森,2024-02-08T19:00:25.423000Z,1707418805,7
5,1,3,35.579849,139.731241,K1-80.大森北6丁目,2024-02-08T19:00:25.424000Z,1707418805,4
6,2,8,35.676643,139.816054,H1-130.トヨタモビリティ東京 深川店,2024-02-08T19:00:25.425000Z,1707418805,10
7,0,18,35.679029,139.793535,H1-131.セブン-イレブン 江東佐賀2丁目店,2024-02-08T19:00:25.428000Z,1707418805,18
8,0,36,35.681418,139.809287,H1-132.セブン-イレブン 江東三好4丁目店,2024-02-08T19:00:25.429000Z,1707418805,36
9,12,3,35.683433,139.740756,A6-22.半蔵門PREX South,2024-02-08T19:00:25.430000Z,1707418805,15
10,2,4,35.622403,139.71771,I1-74.セブン-イレブン西五反田6丁目店,2024-02-08T19:00:25.431000Z,1707418805,6
11,4,3,35.709777,139.810189,G2-01.東京ソラマチ,2024-02-08T19:00:25.432000Z,1707418805,7
12,2,1,35.722917,139.587864,T2-59.平成公園,2024-02-08T19:00:25.433000Z,1707418805,3
13,0,6,35.52928,139.722762,Z15.ファミリーマート藤崎一丁目店,2024-02-08T19:00:25.434000Z,1707418805,6
14,4,4,35.617475,139.729221,I1-26.大崎西口公園,2024-02-08T19:00:25.435000Z,1707418805,8
15,10,0,35.627599,139.720463,I1-96.西五反田２丁目,2024-02-08T19:00:25.436000Z,1707418805,10
16,0,11,35.668856,139.794069,H1-172.サンヨーパシフィックマンション,2024-02-08T19:00:25.439000Z,1707418805,11
17,4,0,35.654009,139.692727,J1-56.青葉台四丁目街かど公園,2024-02-08T19:00:25.440000Z,1707418805,4
18,6,33,35.687837,139.79654,H1-173.森下駅前,2024-02-08T19:00:25.443000Z,1707418805,39
19,5,5,35.718656,139.734556,E3-01.大塚地域活動センター跡地,2024-02-08T19:00:25.445000Z,1707418805,10
20,26,15,35.715556,139.721988,E2-03.目白台運動公園,2024-02-08T19:00:25.448000Z,1707418805,41
21,3,1,35.759861,139.581682,T2-77.大泉なかよし緑地,2024-02-08T19:00:25.449000Z,1707418805,4
22,42,39,35.710381,139.732137,E2-01.江戸川橋Ｂ自転車駐車場,2024-02-08T19:00:25.450000Z,1707418805,81
23,8,11,35.710958,139.731165,E2-02.江戸川公園,2024-02-08T19:00:25.979000Z,1707418805,19
24,4,2,35.720028,139.678936,D7-14.大栄パーク西落合１丁目,2024-02-08T19:00:25.452000Z,1707418805,6
25,0,8,35.712015,139.750284,E1-07.礫川地域活動センター,2024-02-08T19:00:25.463000Z,1707418805,8
26,0,15,35.67917,139.67493,M6-05.七号通り公園,2024-02-08T19:00:25.467000Z,1707418805,15
27,0,9,35.687416,139.795588,H1-138.HW.HILLS新大橋,2024-02-08T19:00:25.473000Z,1707418805,9
28,15,19,35.663681,139.785651,B4-21.月島駅前第一駐輪場,2024-02-08T19:00:25.477000Z,1707418805,34
29,5,2,35.712179,139.65603,N2-03.野方1丁目,2024-02-08T19:00:25.483000Z,1707418805,7
30,7,4,35.630109,139.747094,C5-52.港南四丁目第3アパート駐車場,2024-02-08T19:00:25.484000Z,1707418805,11
31,0,4,35.714875,139.76394,E5-27.真正館駐車場,2024-02-08T19:00:25.485000Z,1707418805,4
32,6,0,35.62822,139.741135,C5-35.品川駅港南口,2024-02-08T19:00:25.485000Z,1707418805,6
33,2,3,35.710285,139.66173,N2-01.NTT野方ビル,2024-02-08T19:00:25.486000Z,1707418805,5
34,8,1,35.686334,139.692881,D6-27.新宿三井ビルディング二号館,2024-02-08T19:00:25.492000Z,1707418805,9
35,3,13,35.691888,139.724365,D1-10.曙橋駐輪場,2024-02-08T19:00:25.493000Z,1707418805,16
36,3,2,35.628116,139.713149,I1-39.MID POINT 目黒不動前,2024-02-08T19:00:25.501000Z,1707418805,5
37,0,20,35.713388,139.737009,E3-07.小日向1丁目,2024-02-08T19:00:25.501000Z,1707418805,20
38,8,1,35.641791,139.740734,C1-47.パークプレイス三田,2024-02-08T19:00:25.503000Z,1707418805,9
39,25,20,35.594544,139.760423,I1-38.ローソン 八潮三丁目店,2024-02-08T19:00:25.504000Z,1707418805,45
40,6,0,35.655135,139.744449,C2-24.Dash Living HigashiAzabu,2024-02-08T19:00:25.505000Z,1707418805,6
41,7,1,35.650351,139.692853,J1-04.菅刈公園,2024-02-08T19:00:25.512000Z,1707418805,8
42,0,3,35.712496,139.632778,O4-09.ローソン杉並本天沼一丁目店,2024-02-08T19:00:25.513000Z,1707418805,3
43,1,2,35.755773,139.661913,T3-29.平和台もものき緑地,2024-02-08T19:00:25.514000Z,1707418805,3
44,4,8,35.696242,139.735776,D2-10.市谷砂土原町3丁目,2024-02-08T19:00:25.514000Z,1707418805,12
45,10,5,35.655139,139.762812,C1-48.竹芝客船ターミナル,2024-02-08T19:00:25.515000Z,1707418805,15
46,3,2,35.687624,139.777125,B1-06.伊場仙ビル,2024-02-08T19:00:25.520000Z,1707418805,5
47,0,21,35.67224,139.779348,B2-01.鉄砲洲児童公園（西側）,2024-02-08T19:00:25.521000Z,1707418805,21
48,2,3,35.694164,139.787057,B1-04.産業会館,2024-02-08T19:00:25.521000Z,1707418805,5
49,0,11,35.687419,139.779053,B1-05.日本橋保健センター,2024-02-08T19:00:25.522000Z,1707418805,11
50,0,9,35.670674,139.775993,B2-05.ＮＴＴ東日本築地ビル,2024-02-08T19:00:25.524000Z,1707418805,9
51,12,0,35.676393,139.768319,B2-02.柳通り（東京スクエアガーデン前）,2024-02-08T19:00:25.525000Z,1707418805,12
52,8,3,35.673923,139.778671,B2-03.男女平等センター（ブーケ21）,2024-02-08T19:00:25.540000Z,1707418805,11
53,8,0,35.651718,139.728165,C2-13.麻布運動場,2024-02-08T19:00:25.541000Z,1707418805,8
54,0,18,35.70074,139.731363,D2-08.旧市ヶ谷商業高校,2024-02-08T19:00:25.542000Z,1707418805,18
55,4,1,35.649032,139.750147,C1-35.セブン-イレブン 三田駅北店,2024-02-08T19:00:26.582000Z,1707418805,5
56,0,99,35.655497,139.774556,B4-12.THE TOKYO TOWERS,2024-02-08T19:00:25.543000Z,1707418805,99
57,4,2,35.642399,139.746992,C5-21.セブン-イレブン 芝浦3丁目店,2024-02-08T19:00:25.544000Z,1707418805,6
58,1,15,35.69766,139.843408,H1-67.セブン-イレブン 江東亀戸9丁目店,2024-02-08T19:00:25.545000Z,1707418805,16
59,0,14,35.664367,139.737185,C2-15.住友不動産六本木グランドタワー,2024-02-08T19:00:25.546000Z,1707418805,14
60,0,10,35.653608,139.73138,C2-14.元麻布ヒルズ,2024-02-08T19:00:25.547000Z,1707418805,10
61,0,5,35.67323,139.66393,M6-14.ドコモショップ笹塚店,2024-02-08T19:00:25.548000Z,1707418805,5
62,2,10,35.68509,139.671102,N4-07.南台2丁目,2024-02-08T19:00:25.553000Z,1707418805,12
63,6,2,35.580511,139.775957,K1-68.ART FACTORY 城南島,2024-02-08T19:00:28.404000Z,1707418805,8
64,0,4,35.678031,139.837193,H1-178.北砂7丁目団地(第二),2024-02-08T19:00:25.554000Z,1707418805,4
65,1,10,35.678246,139.8366,H1-179.北砂7丁目団地(第三),2024-02-08T19:00:25.555000Z,1707418805,11
66,6,0,35.692605,139.755761,A1-17.雉子橋集積所,2024-02-08T19:00:25.556000Z,1707418805,6
67,0,13,35.678537,139.837391,H1-177.北砂7丁目団地(第一),2024-02-08T19:00:25.502000Z,1707418805,13
68,11,5,35.578259,139.783505,K1-95.城南島海浜公園,2024-02-08T19:00:25.563000Z,1707418805,16
69,7,0,35.66711,139.76643,B3-17.銀座6丁目-SQUARE,2024-02-08T19:00:25.564000Z,1707418805,7
70,12,1,35.629861,139.666293,J1-33.芳窪街かど公園,2024-02-08T19:00:25.565000Z,1707418805,13
71,1,4,35.70442,139.67141,N3-07.なかのZERO,2024-02-08T19:00:25.566000Z,1707418805,5
72,3,9,35.690897,139.668345,N4-04.弥生町5丁目,2024-02-08T19:00:25.567000Z,1707418805,12
73,0,9,35.694679,139.779504,A3-44.THE WAVES AKIHABARA,2024-02-08T19:00:25.568000Z,1707418805,9
74,6,3,35.544534,139.763244,K1-138.羽田エアポートガーデン,2024-02-08T19:00:25.573000Z,1707418805,9
75,2,3,35.67011,139.733375,C3-26.ホテルリブマックス赤坂,2024-02-08T19:00:25.573000Z,1707418805,5
76,3,3,35.652549,139.747789,C1-52.NTT三田ビル,2024-02-08T19:00:25.574000Z,1707418805,6
77,4,0,35.689757,139.710091,D1-07.Dash Living Shinjuku,2024-02-08T19:00:25.576000Z,1707418805,4
78,0,5,35.690311,139.62178,O4-07.ローソン成田西三丁目店,2024-02-08T19:00:25.576000Z,1707418805,5
79,0,9,35.699187,139.82429,H1-152.コンポジット亀戸ウエスト,2024-02-08T19:00:25.577000Z,1707418805,9
80,0,39,35.71399,139.75137,E1-13.エルアージュ小石川,2024-02-08T19:00:25.578000Z,1707418805,39
81,0,61,35.65554,139.77102,B4-22.リビオレゾン勝どきNEX,2024-02-08T19:00:25.583000Z,1707418805,61
82,4,2,35.667677,139.823552,H1-176.JMFビル東陽町02,2024-02-08T19:00:25.584000Z,1707418805,6
83,0,17,35.672714,139.837914,H1-102.ファミリーマート東砂七丁目店,2024-02-08T19:00:25.584000Z,1707418805,17
84,5,1,35.642571,139.836766,H1-101.ファミリーマート新木場一丁目店,2024-02-08T19:00:25.585000Z,1707418805,6
85,0,15,35.570508,139.764013,K1-67.京浜島防災広場,2024-02-08T19:00:25.586000Z,1707418805,15
86,0,12,35.575097,139.751446,K1-66.昭和島二丁目公園,2024-02-08T19:00:25.587000Z,1707418805,12
87,4,0,35.528868,139.737762,Z11.ファミリーマートＭＧ川崎昭和店,2024-02-08T19:00:25.593000Z,1707418805,4
88,5,5,35.622714,139.74471,I1-80.リバーサイド品川港南ビル,2024-02-08T19:00:25.593000Z,1707418805,10
89,5,6,35.655779,139.680948,J1-10.NTTデータ駒場研修センター,2024-02-08T19:00:25.594000Z,1707418805,11
90,8,0,35.692396,139.75639,A2-17.竹橋ビル,2024-02-08T19:00:25.595000Z,1707418805,8
91,13,5,35.696913,139.823911,H1-91.亀戸駅北口第三自転車駐車場,2024-02-08T19:00:25.596000Z,1707418805,18
92,7,8,35.69788,139.830559,H1-92.亀戸駅東口第二自転車駐車場,2024-02-08T19:00:25.596000Z,1707418805,15
93,6,1,35.565768,139.727396,K1-59.京急梅屋敷第1駐車場,2024-02-08T19:00:25.597000Z,1707418805,7
94,1,8,35.576336,139.733691,K1-60.京急平和島第1駐車場,2024-02-08T19:00:25.598000Z,1707418805,9
95,3,0,35.611582,139.742528,I1-42.京急青横駐車場,2024-02-08T19:00:25.603000Z,1707418805,3
96,0,9,35.594722,139.737101,I1-43.京急南大井駐車場,2024-02-08T19:00:25.604000Z,1707418805,9
97,8,0,35.528801,139.694661,Z01.NTTドコモ川崎ビル,2024-02-08T19:00:25.605000Z,1707418805,8
98,1,1,35.680849,139.65626,O7-05.ジーベック方南町,2024-02-08T19:00:25.606000Z,1707418805,2
99,21,8,35.697935,139.821855,H1-100.URアーバンライフ亀戸,2024-02-08T19:00:25.607000Z,1707418805,29
100,9,3,35.682516,139.736494,A6-10.紀尾井町ビル（西側）,2024-02-08T19:00:25.608000Z,1707418805,12
101,0,7,35.674788,139.731423,C3-02.赤坂地区総合支所,2024-02-08T19:00:25.613000Z,1707418805,7
102,0,8,35.661673,139.721118,C2-08.ファミリーマート西麻布霞町店,2024-02-08T19:00:25.614000Z,1707418805,8
103,6,0,35.682902,139.736494,A6-09.紀尾井町ビル（北側）,2024-02-08T19:00:25.615000Z,1707418805,6
104,10,1,35.630063,139.792209,H1-28.有明客船ターミナル,2024-02-08T19:00:25.615000Z,1707418805,11
105,0,8,35.687786,139.78205,B1-12.ファミリーマート堀留町二丁目店,2024-02-08T19:00:25.616000Z,1707418805,8
106,15,0,35.619234,139.774485,H1-26.青海客船ターミナル,2024-02-08T19:00:25.623000Z,1707418805,15
107,10,0,35.624467,139.781305,H1-27.パレットタウン乗船場,2024-02-08T19:00:25.624000Z,1707418805,10
108,10,0,35.540579,139.754506,K1-121.東京広域ポート（川崎LiSE）,2024-02-08T19:00:25.625000Z,1707418805,10
109,8,5,35.581347,139.662265,K1-122.東急新丸子駅駐輪場,2024-02-08T19:00:25.628000Z,1707418805,13
110,12,0,35.577794,139.660751,K1-123.東急新丸子駅（東）駐輪場,2024-02-08T19:00:25.629000Z,1707418805,12
111,8,7,35.72758,139.62432,O1-04.井草1-34,2024-02-08T19:00:25.630000Z,1707418805,15
112,16,0,35.656647,139.758301,C1-76.浜松町駅北口交通広場(ハマサイト前),2024-02-08T19:00:25.633000Z,1707418805,16
113,7,2,35.629807,139.662398,J1-52.駒沢一丁目公園前,2024-02-08T19:00:25.634000Z,1707418805,9
114,6,1,35.665466,139.748014,C1-75.虎ノ門PFビル,2024-02-08T19:00:25.635000Z,1707418805,7
115,11,0,35.678291,139.78157,B2-18.旭ビルディング,2024-02-08T19:00:25.636000Z,1707418805,11
116,3,3,35.722991,139.673048,N2-09.松山駐車場No.1,2024-02-08T19:00:25.640000Z,1707418805,6
117,3,3,35.627386,139.711182,I1-82.トミンハイム西五反田四丁目,2024-02-08T19:00:25.641000Z,1707418805,6
118,0,12,35.707035,139.633066,O4-03.ザ・ハウス,2024-02-08T19:00:25.642000Z,1707418805,12
119,15,1,35.704147,139.631955,O4-04.阿佐谷南3-43,2024-02-08T19:00:25.643000Z,1707418805,16
120,6,0,35.611085,139.68599,K1-83.北千束北児童公園,2024-02-08T19:00:25.644000Z,1707418805,6
121,6,4,35.584998,139.761055,I1-95.東京レールゲート EAST,2024-02-08T19:00:25.644000Z,1707418805,10
122,1,4,35.68285,139.698528,M5-19.グランリヴィエール代々木,2024-02-08T19:00:25.648000Z,1707418805,5
123,3,6,35.537163,139.729625,Z14.ファミリーマート川崎中瀬店,2024-02-08T19:00:25.649000Z,1707418805,9
124,3,1,35.678296,139.791949,H1-192.ウエリスアーバン水天宮前,2024-02-08T19:00:25.651000Z,1707418805,4
125,3,1,35.728893,139.670119,N2-08.江古田区民活動センター,2024-02-08T19:00:25.653000Z,1707418805,4
126,1,2,35.722645,139.701982,D7-04.セブン-イレブン 新宿下落合3丁目店,2024-02-08T19:00:25.654000Z,1707418805,3
127,4,3,35.515344,139.722229,Z16.ファミリーマート川崎浜町四丁目店,2024-02-08T19:00:25.656000Z,1707418805,7
128,7,0,35.561499,139.71123,K1-82.西蒲田公園,2024-02-08T19:00:25.657000Z,1707418805,7
129,0,38,35.649274,139.792213,H1-68.芝浦工業大学附属中学高等学校,2024-02-08T19:00:25.663000Z,1707418805,38
130,0,16,35.557074,139.74575,K1-24.東糀谷防災公園,2024-02-08T19:00:25.664000Z,1707418805,16
131,13,2,35.640736,139.804331,H1-03.東雲駅,2024-02-08T19:00:25.665000Z,1707418805,15
132,0,15,35.574785,139.730762,K1-26.大森諏訪公園,2024-02-08T19:00:25.666000Z,1707418805,15
133,2,1,35.56892,139.725082,K1-25.鶴渡公園,2024-02-08T19:00:25.666000Z,1707418805,3
134,5,1,35.702659,139.662563,N3-10.エーエスホームズⅡ駐車場,2024-02-08T19:00:25.775000Z,1707418805,6
135,11,7,35.640398,139.704069,J1-37.中目黒公園,2024-02-08T19:00:26.972000Z,1707418805,18
136,6,0,35.696449,139.750784,A1-10.ヒューリック九段ビル,2024-02-08T19:00:25.674000Z,1707418805,6
137,2,2,35.548864,139.74484,K1-93.六間堀仲羽公園,2024-02-08T19:00:25.677000Z,1707418805,4
138,2,2,35.772863,139.626969,T2-53.上練馬公園,2024-02-08T19:00:25.679000Z,1707418805,4
139,0,12,35.680154,139.685937,M5-01.初台駅南口,2024-02-08T19:00:25.680000Z,1707418805,12
140,10,3,35.647659,139.745055,C1-60.専売ビル,2024-02-08T19:00:25.684000Z,1707418805,13
141,3,1,35.583555,139.743381,K1-85.大田区青少年交流センター ゆいっつ,2024-02-08T19:00:25.692000Z,1707418805,4
142,8,2,35.622965,139.731014,I1-64.株式会社ユアス ゆうパック取扱所：ポストのうしろ,2024-02-08T19:00:25.694000Z,1707418805,10
143,0,6,35.646375,139.740061,C4-09.ケーヨーデイツー三田店,2024-02-08T19:00:25.694000Z,1707418805,6
144,23,15,35.653096,139.75739,C1-61.環三浜松町駅南,2024-02-08T19:00:25.695000Z,1707418805,38
145,0,13,35.581698,139.71491,K1-84.佐伯山緑地,2024-02-08T19:00:25.696000Z,1707418805,13
146,5,8,35.650845,139.748346,C1-59.セレスティン芝三井ビルディング,2024-02-08T19:00:25.697000Z,1707418805,13
147,2,2,35.706167,139.815955,G2-07.レオーネ押上cube,2024-02-08T19:00:25.698000Z,1707418805,4
148,10,10,35.708265,139.751983,E1-06.文京シビックセンター,2024-02-08T19:00:25.698000Z,1707418805,20
149,0,23,35.695646,139.725722,D2-13.THE CENTER TOKYO,2024-02-08T19:00:25.699000Z,1707418805,23
150,2,4,35.724828,139.762583,E5-22.千駄木2丁目,2024-02-08T19:00:25.700000Z,1707418805,6
151,9,1,35.628266,139.734171,C4-07.品川プリンスホテル,2024-02-08T19:00:25.701000Z,1707418805,10
152,3,0,35.69474,139.77929,A3-43.unito CHIYODA,2024-02-08T19:00:25.702000Z,1707418805,3
153,0,22,35.644134,139.723432,C4-06.白金プラチナレジデンス,2024-02-08T19:00:25.703000Z,1707418805,22
154,3,0,35.62765,139.719212,I1-63.セブン-イレブン西五反田店,2024-02-08T19:00:25.705000Z,1707418805,3
155,18,0,35.653991,139.795513,H1-53.豊洲シビックセンター,2024-02-08T19:00:25.706000Z,1707418805,18
156,10,0,35.735428,139.652379,T3-16.練馬区役所東庁舎(第一),2024-02-08T19:00:25.710000Z,1707418805,10
157,2,3,35.731372,139.619164,T2-68.さくら原っぱ緑地,2024-02-08T19:00:25.710000Z,1707418805,5
158,0,4,35.76525,139.575978,T2-69.久保新田さくら公園,2024-02-08T19:00:25.711000Z,1707418805,4
159,0,5,35.685344,139.80234,H1-187.森下文化センター,2024-02-08T19:00:25.712000Z,1707418805,5
160,0,5,35.724707,139.750469,E4-04.セブン-イレブン 文京本駒込１丁目店,2024-02-08T19:00:25.713000Z,1707418805,5
161,8,0,35.649257,139.713272,M2-13.恵比寿プライムスクエアタワー南,2024-02-08T19:00:25.714000Z,1707418805,8
162,0,8,35.658249,139.815775,H1-48.セブン-イレブン 江東潮見２丁目店,2024-02-08T19:00:25.715000Z,1707418805,8
163,26,0,35.654958,139.795718,H1-51.豊洲交通広場　東,2024-02-08T19:00:25.716000Z,1707418805,26
164,14,1,35.646756,139.809295,H1-52.辰巳駅,2024-02-08T19:00:25.717000Z,1707418805,15
165,5,11,35.715894,139.698578,D7-01.下落合図書館,2024-02-08T19:00:25.717000Z,1707418805,16
166,11,0,35.655457,139.795161,H1-50.豊洲交通広場　北,2024-02-08T19:00:25.718000Z,1707418805,11
167,1,1,35.690861,139.736393,A6-14.MG市ヶ谷ビルディング,2024-02-08T19:00:25.719000Z,1707418805,2
168,1,3,35.768448,139.601679,T2-21.ファミリーマート 練馬大泉町一丁目店,2024-02-08T19:00:25.720000Z,1707418805,4
169,4,1,35.688929,139.7358,A6-15.東急番町ビル,2024-02-08T19:00:25.720000Z,1707418805,5
170,3,0,35.696202,139.752351,A1-18.東京区政会館別館(特別区研修所),2024-02-08T19:00:25.721000Z,1707418805,3
171,10,9,35.738585,139.653396,T3-18.練馬駅北,2024-02-08T19:00:25.722000Z,1707418805,19
172,3,3,35.658169,139.752509,C1-43.KDX浜松町プレイス,2024-02-08T19:00:25.723000Z,1707418805,6
173,9,12,35.648948,139.757895,C5-27.プレミア海岸ビル,2024-02-08T19:00:25.723000Z,1707418805,21
174,0,20,35.599987,139.745195,I1-29.ローソン 勝島一丁目店,2024-02-08T19:00:25.724000Z,1707418805,20
175,20,1,35.674578,139.797396,H1-72.ネクストサイト深川ビル,2024-02-08T19:00:25.725000Z,1707418805,21
176,0,3,35.768528,139.639807,T1-11.むつみ台,2024-02-08T19:00:25.726000Z,1707418805,3
177,5,0,35.758366,139.628982,T1-10.月見大橋下,2024-02-08T19:00:25.726000Z,1707418805,5
178,1,9,35.688074,139.838932,H1-167.大島八丁目公園,2024-02-08T19:00:25.727000Z,1707418805,10
179,0,12,35.587815,139.691748,K1-36.セブン-イレブン 大田区南雪谷5丁目店,2024-02-08T19:00:25.728000Z,1707418805,12
180,5,8,35.66088,139.654546,L1-01.羽根木公園,2024-02-08T19:00:25.729000Z,1707418805,13
181,8,0,35.721738,139.723103,P1-02.雑司ヶ谷一丁目,2024-02-08T19:00:25.730000Z,1707418805,8
182,2,4,35.596733,139.73804,I1-66.南大井文化センター駐車場,2024-02-08T19:00:25.731000Z,1707418805,6
183,1,2,35.669285,139.597931,L1-05.NTT烏山ビル,2024-02-08T19:00:25.732000Z,1707418805,3
184,0,5,35.63367,139.678139,L1-04.下馬中央公園,2024-02-08T19:00:25.741000Z,1707418805,5
185,0,6,35.645838,139.647799,L1-03.世田谷城阯公園,2024-02-08T19:00:25.741000Z,1707418805,6
186,5,2,35.647075,139.654472,L1-02.若林公園,2024-02-08T19:00:25.742000Z,1707418805,7
187,4,0,35.750804,139.58243,T2-30.ファミリーマート 練馬東大泉四丁目店,2024-02-08T19:00:25.744000Z,1707418805,4
188,2,1,35.648021,139.606529,L1-07.NTT成城ビル,2024-02-08T19:00:25.745000Z,1707418805,3
189,0,11,35.618357,139.626191,L1-06.NTT瀬田ビル,2024-02-08T19:00:25.746000Z,1707418805,11
190,3,1,35.748092,139.636587,T3-12.春日町西公園,2024-02-08T19:00:25.747000Z,1707418805,4
191,2,2,35.757298,139.664139,T3-13.平和台児童公園,2024-02-08T19:00:25.748000Z,1707418805,4
192,7,2,35.727195,139.590179,T2-38.ファミリーマート 練馬上石神井四丁目店,2024-02-08T19:00:25.749000Z,1707418805,9
193,8,1,35.684502,139.77906,B1-28.アイルイムーブル日本橋,2024-02-08T19:00:25.750000Z,1707418805,9
194,8,0,35.6915,139.75685,A2-28.NTTコミュニケーションズ一ツ橋ビル駐車場,2024-02-08T19:00:25.750000Z,1707418805,8
195,3,2,35.667936,139.72745,C3-32.乃木公園,2024-02-08T19:00:25.752000Z,1707418805,5
196,3,1,35.759774,139.654529,T3-14.わらべ児童遊園,2024-02-08T19:00:25.753000Z,1707418805,4
197,2,3,35.762395,139.641522,T2-52.田柄中央児童公園,2024-02-08T19:00:28.417000Z,1707418805,5
198,9,0,35.671823,139.708158,M4-06.THE SHARE 原宿,2024-02-08T19:00:25.754000Z,1707418805,9
199,1,3,35.559647,139.730098,K1-10.セブン‐イレブン 大田区西糀谷１丁目店,2024-02-08T19:00:25.755000Z,1707418805,4
200,0,22,35.570763,139.705895,K1-09.セブン‐イレブン 大田区西蒲田２丁目店,2024-02-08T19:00:25.756000Z,1707418805,22
201,0,14,35.65637,139.811765,H1-63.東京スイソミル,2024-02-08T19:00:25.757000Z,1707418805,14
202,6,0,35.683695,139.780043,B1-16.小網町児童遊園,2024-02-08T19:00:28.475000Z,1707418805,6
203,7,2,35.648281,139.786112,H1-61.Brilliaランニングスタジアムマギーズ東京前,2024-02-08T19:00:25.759000Z,1707418805,9
204,0,6,35.562368,139.730143,K1-08.セブン‐イレブン 大田区東蒲田キネマ通り店,2024-02-08T19:00:25.759000Z,1707418805,6
205,8,0,35.664479,139.743731,C1-34.城山ガーデン,2024-02-08T19:00:25.760000Z,1707418805,8
206,0,42,35.683343,139.812161,H1-62.扇橋一丁目公園南,2024-02-08T19:00:25.761000Z,1707418805,42
207,9,14,35.623756,139.692517,J1-23.清水池公園,2024-02-08T19:00:25.762000Z,1707418805,23
208,8,11,35.634529,139.748378,C5-18.パークタワー品川ベイワード,2024-02-08T19:00:25.764000Z,1707418805,19
209,3,1,35.727279,139.74627,E4-07.ファミリーマート 本駒込二丁目店,2024-02-08T19:00:25.764000Z,1707418805,4
210,2,7,35.644794,139.755688,C5-45.パークアクシス芝浦キャナル,2024-02-08T19:00:25.767000Z,1707418805,9
211,6,3,35.698591,139.755113,A2-02.西神田公園（北側）,2024-02-08T19:00:25.768000Z,1707418805,9
212,5,4,35.719674,139.593696,T2-49.善福寺公園テニスクラブ,2024-02-08T19:00:25.769000Z,1707418805,9
213,27,1,35.651833,139.79962,H1-193.ライフ豊洲店,2024-02-08T19:00:26.536000Z,1707418805,28
214,52,1,35.695762,139.761585,A2-01.神田駿河台下,2024-02-08T19:00:25.770000Z,1707418805,53
215,0,14,35.589573,139.735585,I1-51.京急鈴ヶ森駐車場,2024-02-08T19:00:25.771000Z,1707418805,14
216,4,6,35.75195,139.616028,T2-36.サントピア テニスパーク,2024-02-08T19:00:25.772000Z,1707418805,10
217,0,3,35.696492,139.791591,G4-13. Parking in 両国駅前第2,2024-02-08T19:00:26.553000Z,1707418805,3
218,6,0,35.560125,139.71569,K1-120.蒲田駅消費者生活センター横自転車駐車場 屋上部,2024-02-08T19:00:25.774000Z,1707418805,6
219,5,1,35.69942,139.673964,N3-18.藤和シティコープ新中野3,2024-02-08T19:00:25.775000Z,1707418805,6
220,6,7,35.58209,139.701362,K1-145.トヨタモビリティ東京馬込テクニカル研修センター,2024-02-08T19:00:25.776000Z,1707418805,13
221,5,0,35.589794,139.666955,K1-100.多摩川台公園,2024-02-08T19:00:25.777000Z,1707418805,5
222,11,1,35.664344,139.746662,C1-54.ニッセイ虎ノ門ビル,2024-02-08T19:00:25.777000Z,1707418805,12
223,7,3,35.607557,139.746866,I1-52.カスタリアタワー品川シーサイド,2024-02-08T19:00:25.778000Z,1707418805,10
224,3,1,35.620355,139.749339,I1-53.天王洲公園,2024-02-08T19:00:25.779000Z,1707418805,4
225,0,3,35.656769,139.743224,C2-18.ブランシェ東麻布,2024-02-08T19:00:25.780000Z,1707418805,3
226,12,6,35.691578,139.77138,A3-45.鍛冶町2丁目,2024-02-08T19:00:25.781000Z,1707418805,18
227,0,27,35.662514,139.803694,H1-87.パークアクシス木場キャナルウエスト,2024-02-08T19:00:25.782000Z,1707418805,27
228,5,10,35.693544,139.685806,D6-20.淀橋けやき橋公園,2024-02-08T19:00:25.782000Z,1707418805,15
229,0,1,35.695457,139.772972,A3-46.神田須田町2丁目,2024-02-08T19:00:25.783000Z,1707418805,1
230,11,0,35.664871,139.767188,B3-13.国立がん研究センター,2024-02-08T19:00:25.784000Z,1707418805,11
231,18,0,35.622954,139.750593,I1-35.シーフォートスクエア,2024-02-08T19:00:25.785000Z,1707418805,18
232,5,13,35.576275,139.713704,K1-55.カバヤビル,2024-02-08T19:00:25.786000Z,1707418805,18
233,0,7,35.668419,139.724676,C3-24.SHARE GREEN 南青山 西エントランス,2024-02-08T19:00:25.787000Z,1707418805,7
234,10,0,35.674468,139.741328,A5-06.APA HOTEL PRIDE〈国会議事堂前〉,2024-02-08T19:00:25.787000Z,1707418805,10
235,12,0,35.680431,139.738203,A6-17.東京ガーデンテラス紀尾井町（プリンス通り側）,2024-02-08T19:00:25.800000Z,1707418805,12
236,58,3,35.658135,139.776131,B4-07.勝どき駅地下駐輪場,2024-02-08T19:00:25.801000Z,1707418805,61
237,1,17,35.656449,139.771302,B4-08.東京ミッドベイ勝どき（西仲通り）,2024-02-08T19:00:25.802000Z,1707418805,18
238,17,0,35.664265,139.767426,B3-04.築地市場駅地下駐輪場,2024-02-08T19:00:25.803000Z,1707418805,17
239,11,3,35.649959,139.756068,C5-10.シーバンス,2024-02-08T19:00:25.804000Z,1707418805,14
240,47,5,35.67391,139.796165,H1-34.門前仲町駅,2024-02-08T19:00:25.805000Z,1707418805,52
241,1,5,35.670364,139.744684,C3-10.ファミリーマート特許庁前店,2024-02-08T19:00:25.813000Z,1707418805,6
242,6,0,35.693799,139.753281,A1-01.千代田区役所,2024-02-08T19:00:25.814000Z,1707418805,6
243,7,0,35.701073,139.747525,A1-03.東京区政会館（メトロA5出口）,2024-02-08T19:00:25.816000Z,1707418805,7
244,4,0,35.664457,139.767214,B3-06.朝日新聞東京本社,2024-02-08T19:00:25.817000Z,1707418805,4
245,7,0,35.701347,139.746951,A1-04.東京区政会館（西側駐輪場）,2024-02-08T19:00:25.828000Z,1707418805,7
246,5,0,35.760585,139.626284,T1-03.四季の香公園,2024-02-08T19:00:25.852000Z,1707418805,5
247,3,0,35.75731,139.624922,T1-04.春の風公園,2024-02-08T19:00:25.872000Z,1707418805,3
248,5,0,35.753964,139.629116,T1-05.夏の雲公園,2024-02-08T19:00:25.896000Z,1707418805,5
249,0,5,35.68268,139.8353,H1-194.セブン-イレブン江東北砂5丁目店,2024-02-08T19:00:25.902000Z,1707418805,5
250,5,7,35.697265,139.649397,O5-03.新高円寺地下自転車駐輪場,2024-02-08T19:00:25.920000Z,1707418805,12
251,3,1,35.714616,139.625116,O3-06.アミーズ荻窪,2024-02-08T19:00:25.951000Z,1707418805,4
252,7,1,35.752383,139.594855,T2-03.リヴィンオズ大泉店,2024-02-08T19:00:25.953000Z,1707418805,8
253,0,7,35.673055,139.611293,O6-06.上高井戸1丁目,2024-02-08T19:00:25.954000Z,1707418805,7
254,3,1,35.736076,139.599676,T2-05.石神井図書館,2024-02-08T19:00:25.955000Z,1707418805,4
255,2,1,35.748957,139.621385,T2-06.総合体育館,2024-02-08T19:00:25.956000Z,1707418805,3
256,4,2,35.705686,139.642587,O5-02.馬橋ハイツ,2024-02-08T19:00:25.957000Z,1707418805,6
257,1,6,35.733292,139.630369,N1-07.プランドール上鷺宮,2024-02-08T19:00:25.957000Z,1707418805,7
258,0,8,35.709261,139.746374,E1-18.アーバネックス小石川春日,2024-02-08T19:00:25.958000Z,1707418805,8
259,4,3,35.740378,139.667502,T3-03.新桜台駅自転車駐車場,2024-02-08T19:00:25.959000Z,1707418805,7
260,18,4,35.70389,139.6185,O3-05.Nちゃりパーク,2024-02-08T19:00:25.964000Z,1707418805,22
261,7,4,35.71038,139.64519,O5-01.朝霞ハイツ,2024-02-08T19:00:25.964000Z,1707418805,11
262,2,1,35.656849,139.594422,L1-11.アイムタウン上祖師谷,2024-02-08T19:00:25.965000Z,1707418805,3
263,12,2,35.646648,139.633038,L1-12.鈴木リースホーム駐車場,2024-02-08T19:00:25.966000Z,1707418805,14
264,1,3,35.647393,139.667085,L1-13.わびさびホステル,2024-02-08T19:00:25.968000Z,1707418805,4
265,5,1,35.715733,139.815451,G2-05.リアナスカイパーク押上,2024-02-08T19:00:25.974000Z,1707418805,6
266,8,3,35.756846,139.652154,T3-02.早宮第二自転車駐車場,2024-02-08T19:00:25.975000Z,1707418805,11
267,6,3,35.623466,139.734359,I1-37.ガーデンシティ品川御殿山,2024-02-08T19:00:25.975000Z,1707418805,9
268,7,3,35.726523,139.5905,T2-47.上石神井駅北第二自転車駐車場,2024-02-08T19:00:25.977000Z,1707418805,10
269,9,3,35.663843,139.757697,C1-51.環二新橋四丁目,2024-02-08T19:00:25.978000Z,1707418805,12
270,12,9,35.675436,139.670594,M6-07.笹塚東,2024-02-08T19:00:26.676000Z,1707418805,21
271,8,0,35.647757,139.712981,M3-10.ウノサワ東急ビル,2024-02-08T19:00:25.980000Z,1707418805,8
272,6,1,35.655367,139.738075,C2-26.一の橋公園,2024-02-08T19:00:27.431000Z,1707418805,7
273,5,1,35.658351,139.818229,H1-14.ホテルリブマックス東京潮見駅前,2024-02-08T19:00:25.984000Z,1707418805,6
274,0,12,35.705774,139.743366,D2-12.ヴィアイン飯田橋後楽園,2024-02-08T19:00:25.985000Z,1707418805,12
275,8,0,35.712952,139.701356,D3-08.ホテルリブマックス高田馬場駅前,2024-02-08T19:00:25.986000Z,1707418805,8
276,4,6,35.680948,139.796917,H1-103.清澄庭園,2024-02-08T19:00:25.986000Z,1707418805,10
277,0,19,35.676488,139.809616,H1-104.木場公園,2024-02-08T19:00:25.987000Z,1707418805,19
278,7,1,35.692277,139.817491,H1-105.猿江恩賜公園,2024-02-08T19:00:25.988000Z,1707418805,8
279,0,4,35.69955,139.803204,G4-07.ディアレイシャス両国,2024-02-08T19:00:25.989000Z,1707418805,4
280,0,9,35.766491,139.587232,T2-46.大泉郵便局バス停自転車駐車場,2024-02-08T19:00:25.991000Z,1707418805,9
281,4,3,35.61379,139.746617,I1-18.東品川公園,2024-02-08T19:00:25.992000Z,1707418805,7
282,5,1,35.650688,139.696696,J1-03.西郷山公園,2024-02-08T19:00:25.993000Z,1707418805,6
283,10,4,35.657718,139.681043,J1-02.駒場野公園,2024-02-08T19:00:25.999000Z,1707418805,14
284,0,16,35.704201,139.735815,D2-14.ローソン 神楽坂駅北店,2024-02-08T19:00:26.002000Z,1707418805,16
285,7,5,35.571711,139.685337,K1-65.下丸子3丁目,2024-02-08T19:00:26.004000Z,1707418805,12
286,8,0,35.7547,139.5871,T2-43.学園通り自転車駐車場,2024-02-08T19:00:26.005000Z,1707418805,8
287,0,5,35.608721,139.714158,I1-46.セブン-イレブン 品川東中延2丁目店,2024-02-08T19:00:26.012000Z,1707418805,5
288,12,1,35.743354,139.606592,T2-04.石神井公園駅南口,2024-02-08T19:00:26.817000Z,1707418805,13
289,34,11,35.642251,139.69692,J1-06.観音橋自転車置場,2024-02-08T19:00:26.020000Z,1707418805,45
290,0,13,35.64853,139.686309,J1-05.東山公園　北,2024-02-08T19:00:26.048000Z,1707418805,13
291,0,3,35.63767,139.7045,J1-45.プラウド中目黒,2024-02-08T19:00:26.080000Z,1707418805,3
292,11,2,35.68642,139.836151,H1-168.大島五丁目公園,2024-02-08T19:00:26.096000Z,1707418805,13
293,4,13,35.61847,139.70019,J1-47.本町みなみ街かど公園,2024-02-08T19:00:26.112000Z,1707418805,17
294,0,19,35.64372,139.68777,J1-48.グランドエクセル祐天寺,2024-02-08T19:00:26.153000Z,1707418805,19
295,0,5,35.599541,139.697962,K1-101.小池公園,2024-02-08T19:00:26.157000Z,1707418805,5
296,6,3,35.672877,139.842339,H1-171.LOGI’Q南砂町,2024-02-08T19:00:26.157000Z,1707418805,9
297,9,1,35.63851,139.823534,H1-153.三井リンクラボ新木場1,2024-02-08T19:00:26.158000Z,1707418805,10
298,20,0,35.631132,139.792726,H1-154.やぐら橋下,2024-02-08T19:00:26.159000Z,1707418805,20
299,0,9,35.514643,139.706285,Z21.コーナン川崎小田栄店,2024-02-08T19:00:26.160000Z,1707418805,9
300,4,5,35.699312,139.696468,D5-11.NTTコミュニケーションズ新宿ビル,2024-02-08T19:00:26.161000Z,1707418805,9
301,3,7,35.626267,139.771438,C5-31.ヒルトン東京お台場,2024-02-08T19:00:26.162000Z,1707418805,10
302,0,10,35.567562,139.766854,K1-78.城南鋳物団地協同組合,2024-02-08T19:00:26.163000Z,1707418805,10
303,0,8,35.513548,139.697176,Z05.ローソン川崎小田二丁目店,2024-02-08T19:00:26.164000Z,1707418805,8
304,0,9,35.600003,139.754288,I1-68.八潮公園第二,2024-02-08T19:00:26.166000Z,1707418805,9
305,0,11,35.601149,139.754284,I1-67.八潮公園第一,2024-02-08T19:00:26.172000Z,1707418805,11
306,19,2,35.634316,139.793199,H1-123.ダイワロイネットホテル東京有明,2024-02-08T19:00:26.173000Z,1707418805,21
307,4,1,35.612389,139.676238,J1-24.ボヌールREIWA,2024-02-08T19:00:26.175000Z,1707418805,5
308,16,2,35.674835,139.785656,B2-12.東京ダイヤビルディング（東側）,2024-02-08T19:00:26.177000Z,1707418805,18
309,14,2,35.614391,139.678396,J1-15.二の橋自転車置場2,2024-02-08T19:00:26.178000Z,1707418805,16
310,0,9,35.684641,139.844243,H1-77.ライフ東砂店,2024-02-08T19:00:26.180000Z,1707418805,9
311,0,3,35.691188,139.712079,D1-09.NTT四谷ビル,2024-02-08T19:00:26.182000Z,1707418805,3
312,0,14,35.727519,139.742815,E4-11.プライマル千石,2024-02-08T19:00:26.184000Z,1707418805,14
313,0,15,35.616114,139.74033,I1-23.東海橋防災船着場,2024-02-08T19:00:26.192000Z,1707418805,15
314,4,0,35.674274,139.759111,A4-12.東京ミッドタウン日比谷,2024-02-08T19:00:26.193000Z,1707418805,4
315,5,7,35.571478,139.702779,K1-46.池上駅前自転車駐車場,2024-02-08T19:00:26.194000Z,1707418805,12
316,2,12,35.593611,139.738056,I1-24.しながわ区民公園(中央口),2024-02-08T19:00:26.194000Z,1707418805,14
317,0,5,35.750414,139.600011,T2-13.セブン-イレブン 練馬石神井町8丁目店,2024-02-08T19:00:26.196000Z,1707418805,5
318,2,0,35.712,139.62816,O3-04.アヴァンセ阿佐ヶ谷,2024-02-08T19:00:26.197000Z,1707418805,2
319,3,9,35.656071,139.780068,B4-01.黎明橋公園（駐輪場）,2024-02-08T19:00:26.198000Z,1707418805,12
320,3,5,35.750761,139.594457,T2-32.セブン-イレブン 練馬東大泉NTTビル店,2024-02-08T19:00:27.737000Z,1707418805,8
321,9,1,35.604567,139.689096,K1-142.コーラル洗足池,2024-02-08T19:00:26.199000Z,1707418805,10
322,4,0,35.574886,139.685122,K1-28.鵜の木特別出張所,2024-02-08T19:00:26.200000Z,1707418805,4
323,12,0,35.755106,139.621675,T1-02.ホテルカデンツァ東京,2024-02-08T19:00:27.464000Z,1707418805,12
324,0,9,35.657264,139.743821,C2-16.ザ・ベルグレイヴィア麻布,2024-02-08T19:00:26.213000Z,1707418805,9
325,3,2,35.711501,139.672761,N3-11.上高田区民活動センター,2024-02-08T19:00:26.214000Z,1707418805,5
326,2,2,35.765979,139.64931,T3-30.北西大松公園,2024-02-08T19:00:27.477000Z,1707418805,4
327,5,1,35.690474,139.690219,D6-05.新宿中央公園（水の広場）,2024-02-08T19:00:26.219000Z,1707418805,6
328,3,6,35.696387,139.689924,D6-07.新宿フロントタワー,2024-02-08T19:00:26.220000Z,1707418805,9
329,2,2,35.734615,139.576214,T2-73.早実グラウンド記念公園,2024-02-08T19:00:26.232000Z,1707418805,4
330,2,9,35.67156,139.64609,O7-03.永福町西幸モータープール東,2024-02-08T19:00:26.233000Z,1707418805,11
331,0,5,35.684523,139.720519,D1-03.新左門児童遊園,2024-02-08T19:00:26.233000Z,1707418805,5
332,0,30,35.683448,139.728425,D1-04.四谷見附公園,2024-02-08T19:00:26.234000Z,1707418805,30
333,12,3,35.622356,139.749468,I1-54.天王洲オーシャンスクエア,2024-02-08T19:00:26.235000Z,1707418805,15
334,44,2,35.693602,139.703229,D6-01.新宿区役所本庁舎,2024-02-08T19:00:26.235000Z,1707418805,46
335,34,1,35.693976,139.706134,D6-02.新宿区役所第二分庁舎,2024-02-08T19:00:26.236000Z,1707418805,35
336,9,0,35.691559,139.690029,D6-03.新宿中央公園（ポケットパーク）,2024-02-08T19:00:26.242000Z,1707418805,9
337,8,2,35.686649,139.689821,D6-04.新宿中央公園（ちびっこ広場）,2024-02-08T19:00:26.243000Z,1707418805,10
338,2,2,35.684584,139.734442,A6-21.日本工営ビル,2024-02-08T19:00:26.244000Z,1707418805,4
339,0,19,35.612217,139.708164,I1-77.セブン-イレブン品川西中延1丁目店,2024-02-08T19:00:26.244000Z,1707418805,19
340,11,2,35.759164,139.629466,T1-01.光が丘駅前広場,2024-02-08T19:00:27.606000Z,1707418805,13
341,2,6,35.729615,139.59532,T2-37.上石神井2丁目,2024-02-08T19:00:26.253000Z,1707418805,8
342,0,6,35.603275,139.713428,I1-75.セブン-イレブン品川二葉4丁目店,2024-02-08T19:00:26.254000Z,1707418805,6
343,0,15,35.675049,139.68444,M5-13.セブン-イレブン初台店,2024-02-08T19:00:26.254000Z,1707418805,15
344,9,3,35.683102,139.688852,D6-24.ＮＴＴ東日本 本社ビル,2024-02-08T19:00:26.256000Z,1707418805,12
345,10,12,35.643141,139.777821,H1-134.豊洲ぐるり公園,2024-02-08T19:00:26.261000Z,1707418805,22
346,0,27,35.679001,139.825809,H1-133.北砂2丁目公園,2024-02-08T19:00:26.261000Z,1707418805,27
347,0,4,35.722833,139.734662,E3-08.サガラマンション,2024-02-08T19:00:26.263000Z,1707418805,4
348,1,2,35.700703,139.639985,O4-05.阿佐ヶ谷南1-30,2024-02-08T19:00:26.264000Z,1707418805,3
349,5,0,35.70273,139.65864,O5-06.EXAM高円寺南,2024-02-08T19:00:26.265000Z,1707418805,5
350,5,0,35.710323,139.815215,G2-03.押上１丁目２６-４,2024-02-08T19:00:26.276000Z,1707418805,5
351,15,0,35.587232,139.669519,K1-132.多摩川駅前自転車等駐車場,2024-02-08T19:00:26.277000Z,1707418805,15
352,23,2,35.62413,139.744831,C5-47.oak港南品川,2024-02-08T19:00:26.278000Z,1707418805,25
353,6,8,35.711324,139.711976,D3-15.カースルいずみ,2024-02-08T19:00:26.279000Z,1707418805,14
354,0,8,35.640215,139.755971,C5-15.セブン-イレブン 港区芝浦ふ頭店,2024-02-08T19:00:26.280000Z,1707418805,8
355,0,12,35.640481,139.753659,C5-14.セブン-イレブン 港区汐彩橋店,2024-02-08T19:00:26.281000Z,1707418805,12
356,0,8,35.705244,139.70841,D5-01.新宿コズミックセンター,2024-02-08T19:00:26.285000Z,1707418805,8
357,18,2,35.648596,139.824936,H1-45.夢の島競技場,2024-02-08T19:00:26.286000Z,1707418805,20
358,25,0,35.702746,139.752009,E1-01.後楽橋横,2024-02-08T19:00:26.292000Z,1707418805,25
359,0,11,35.682332,139.78722,B1-15.ロイヤルパークホテル,2024-02-08T19:00:26.293000Z,1707418805,11
360,5,10,35.638927,139.727083,C4-05.白金台駅自転車駐車場,2024-02-08T19:00:26.293000Z,1707418805,15
361,7,2,35.70311,139.754951,E1-02.東京ドーム（ミーツポート）,2024-02-08T19:00:26.294000Z,1707418805,9
362,6,1,35.647237,139.71512,M2-06.あいおいニッセイ同和損保恵比寿ビル,2024-02-08T19:00:26.295000Z,1707418805,7
363,3,1,35.605828,139.680265,J1-12.工大橋下流自転車置場,2024-02-08T19:00:26.296000Z,1707418805,4
364,37,0,35.639571,139.755551,C5-25.NEX-TEC芝浦,2024-02-08T19:00:26.302000Z,1707418805,37
365,0,2,35.689543,139.836394,H1-175.ダイアパレス大島駅前,2024-02-08T19:00:26.303000Z,1707418805,2
366,10,3,35.654757,139.761516,C1-65.東京ポートシティ竹芝,2024-02-08T19:00:26.309000Z,1707418805,13
367,4,1,35.709712,139.601846,O2-03.西荻北5-8-17,2024-02-08T19:00:26.312000Z,1707418805,5
368,4,0,35.67942,139.77004,B2-21.八重洲二丁目北地区広場,2024-02-08T19:00:26.313000Z,1707418805,4
369,25,0,35.60838,139.726587,I1-101.下神明駅前,2024-02-08T19:00:26.314000Z,1707418805,25
370,6,0,35.713018,139.656768,N2-04.野方2丁目,2024-02-08T19:00:26.318000Z,1707418805,6
371,0,12,35.717877,139.654732,N2-05.野方3丁目,2024-02-08T19:00:26.319000Z,1707418805,12
372,0,6,35.582756,139.6925,K1-88.大田久が原西郵便局,2024-02-08T19:00:26.320000Z,1707418805,6
373,0,12,35.634627,139.77663,C5-51.トミンタワー台場一番街,2024-02-08T19:00:27.822000Z,1707418805,12
374,10,0,35.642764,139.741174,C4-10.亀塚公園,2024-02-08T19:00:26.328000Z,1707418805,10
375,0,28,35.664845,139.796643,H1-190.福山通運 東京支店,2024-02-08T19:00:26.332000Z,1707418805,28
376,11,1,35.654289,139.75557,C1-80.浜松町262ビル,2024-02-08T19:00:27.843000Z,1707418805,12
377,0,10,35.670506,139.77854,B2-19.リエトコートアルクスタワー,2024-02-08T19:00:26.334000Z,1707418805,10
378,0,6,35.648765,139.753363,C1-79.髙松コンストラクショングループ 東京本社ビル,2024-02-08T19:00:26.335000Z,1707418805,6
379,7,2,35.644798,139.752697,C5-43.オアーゼ芝浦MJビル,2024-02-08T19:00:26.341000Z,1707418805,9
380,1,7,35.634441,139.687186,J1-44.五本木2丁目,2024-02-08T19:00:26.348000Z,1707418805,8
381,3,0,35.67518,139.77364,B2-17.アーバネックス八丁堀,2024-02-08T19:00:26.349000Z,1707418805,3
382,2,0,35.67464,139.67876,M6-16.パールマンション,2024-02-08T19:00:26.350000Z,1707418805,2
383,0,7,35.700453,139.798978,G4-06.ドムス・スタイル両国,2024-02-08T19:00:26.351000Z,1707418805,7
384,3,2,35.712157,139.815298,G2-04.ラ　ステュディオ押上,2024-02-08T19:00:26.356000Z,1707418805,5
385,6,0,35.768105,139.646049,T3-15.セブン-イレブン練馬北町8丁目店,2024-02-08T19:00:26.357000Z,1707418805,6
386,13,5,35.65513,139.749645,C1-77.芝公園,2024-02-08T19:00:26.358000Z,1707418805,18
387,3,1,35.620699,139.730904,I1-27.小関橋公園,2024-02-08T19:00:26.358000Z,1707418805,4
388,5,0,35.670855,139.772052,B3-01.中央区役所,2024-02-08T19:00:26.359000Z,1707418805,5
389,5,0,35.685489,139.734562,A6-08.二番町ガーデン,2024-02-08T19:00:26.360000Z,1707418805,5
390,0,10,35.691058,139.777915,B1-01.十思公園,2024-02-08T19:00:26.362000Z,1707418805,10
391,0,42,35.662197,139.782719,B4-02.月島特別出張所,2024-02-08T19:00:26.362000Z,1707418805,42
392,18,0,35.685938,139.764886,A4-05.大手町タワー,2024-02-08T19:00:26.366000Z,1707418805,18
393,29,41,35.6447,139.784512,H1-22.豊洲市場（7街区）,2024-02-08T19:00:26.372000Z,1707418805,70
394,0,2,35.685966,139.736328,A6-07.二番町センタービル,2024-02-08T19:00:26.376000Z,1707418805,2
395,10,0,35.694532,139.760695,A2-12.神保町三井ビルディング,2024-02-08T19:00:26.377000Z,1707418805,10
396,0,4,35.713991,139.725665,E2-06.oto no ha Cafe,2024-02-08T19:00:26.378000Z,1707418805,4
397,0,14,35.668795,139.784784,B4-10.リバーシティ,2024-02-08T19:00:26.378000Z,1707418805,14
398,7,3,35.688405,139.770068,B1-03.常盤公園（北側）,2024-02-08T19:00:26.379000Z,1707418805,10
399,6,1,35.645537,139.754899,C5-19.グランドメゾン田町,2024-02-08T19:00:26.380000Z,1707418805,7
400,0,3,35.558289,139.697403,K1-11.ファミリーマート かわだ多摩川２丁目店,2024-02-08T19:00:26.382000Z,1707418805,3
401,12,0,35.63237,139.712681,J1-43.アルコタワー・ホテル雅叙園東京,2024-02-08T19:00:26.384000Z,1707418805,12
402,7,2,35.721827,139.635949,N1-03.鷺宮南駐輪場,2024-02-08T19:00:26.392000Z,1707418805,9
403,1,5,35.72515,139.672614,N2-06.江古田1丁目B,2024-02-08T19:00:26.394000Z,1707418805,6
404,4,1,35.715538,139.701683,D7-12.プラウド高田馬場,2024-02-08T19:00:26.396000Z,1707418805,5
405,0,9,35.580741,139.687152,K1-118.久が原3丁目,2024-02-08T19:00:26.397000Z,1707418805,9
406,1,1,35.571866,139.703214,K1-125.池上駅南口第1,2024-02-08T19:00:26.398000Z,1707418805,2
407,5,15,35.581798,139.695222,K1-117.安詳寺,2024-02-08T19:00:26.400000Z,1707418805,20
408,8,2,35.634019,139.719749,I1-91.アクロス目黒タワー,2024-02-08T19:00:28.476000Z,1707418805,10
409,2,1,35.571815,139.702387,K1-126.池上駅南口第2,2024-02-08T19:00:26.402000Z,1707418805,3
410,12,0,35.633133,139.777315,C5-50.お台場レインボー公園,2024-02-08T19:00:26.403000Z,1707418805,12
411,0,8,35.73701,139.627244,T3-26.富士見ランド公園,2024-02-08T19:00:26.876000Z,1707418805,8
412,4,0,35.765144,139.636606,T1-15.つのの山緑地,2024-02-08T19:00:26.409000Z,1707418805,4
413,3,1,35.767582,139.636304,T1-16.ゆりの木通り南公園,2024-02-08T19:00:26.410000Z,1707418805,4
414,0,3,35.690038,139.833252,H1-185.UR大島六丁目団地(第二),2024-02-08T19:00:26.411000Z,1707418805,3
415,0,9,35.694804,139.831357,H1-186.セブン-イレブン亀戸昭和橋通り店,2024-02-08T19:00:26.412000Z,1707418805,9
416,9,5,35.586408,139.705425,K1-96.西馬込駅前自転車駐車場,2024-02-08T19:00:26.413000Z,1707418805,14
417,3,3,35.689913,139.833279,H1-184.UR大島六丁目団地(第一),2024-02-08T19:00:26.419000Z,1707418805,6
418,4,0,35.679192,139.74019,A6-25.麹町仮住宅,2024-02-08T19:00:26.420000Z,1707418805,4
419,0,11,35.662908,139.755014,C1-69.塩釜公園,2024-02-08T19:00:26.421000Z,1707418805,11
420,29,0,35.665214,139.757008,C1-68.桜田公園,2024-02-08T19:00:26.422000Z,1707418805,29
421,15,0,35.6927,139.759311,A2-14.興和一橋ビル,2024-02-08T19:00:26.422000Z,1707418805,15
422,4,2,35.639644,139.745532,C5-41.トヨタモビリティ東京 芝浦店,2024-02-08T19:00:26.423000Z,1707418805,6
423,4,1,35.731909,139.579685,T2-22.ファミリーマート 石神井台7丁目店,2024-02-08T19:00:26.424000Z,1707418805,5
424,6,0,35.68369,139.736936,A6-20.紀尾井町PREX,2024-02-08T19:00:26.425000Z,1707418805,6
425,1,13,35.647713,139.755534,C5-24.GLOBAL FRONT TOWER,2024-02-08T19:00:26.432000Z,1707418805,14
426,4,11,35.70861,139.75768,E5-09.文京区 男女平等センター,2024-02-08T19:00:26.433000Z,1707418805,15
427,17,4,35.563874,139.685011,K1-37.東京サーハウス前,2024-02-08T19:00:26.434000Z,1707418805,21
428,0,18,35.669188,139.785301,B4-15.リバーシティ　イーストタワーズ,2024-02-08T19:00:26.435000Z,1707418805,18
429,0,13,35.682453,139.677687,M6-08.Be Good 幡ヶ谷,2024-02-08T19:00:26.436000Z,1707418805,13
430,6,7,35.702277,139.701214,D5-09.ハウジングステージ新宿,2024-02-08T19:00:26.436000Z,1707418805,13
431,2,5,35.691613,139.711233,D6-21.新宿5丁目,2024-02-08T19:00:26.437000Z,1707418805,7
432,28,0,35.581752,139.748705,K1-39.東京モノレール 流通センター駅前,2024-02-08T19:00:26.438000Z,1707418805,28
433,8,0,35.558916,139.717253,K1-38.ネクストサイト蒲田ビル,2024-02-08T19:00:26.439000Z,1707418805,8
434,5,0,35.735585,139.652544,T3-17.練馬区役所東庁舎(第二),2024-02-08T19:00:26.440000Z,1707418805,5
435,0,27,35.692641,139.846346,H1-107.大島小松川公園,2024-02-08T19:00:26.442000Z,1707418805,27
436,18,29,35.684158,139.787649,B1-11.浜町川緑道,2024-02-08T19:00:26.443000Z,1707418805,47
437,12,0,35.685578,139.732078,A6-19.番町麹町ビルディング,2024-02-08T19:00:26.449000Z,1707418805,12
438,18,0,35.665254,139.769301,B3-12.築地場外市場,2024-02-08T19:00:26.449000Z,1707418805,18
439,26,0,35.622371,139.737457,I1-40.御殿山トラストタワー,2024-02-08T19:00:26.450000Z,1707418805,26
440,2,0,35.668091,139.680243,M5-08.古賀政男音楽博物館,2024-02-08T19:00:26.451000Z,1707418805,2
441,0,11,35.655102,139.805205,H1-90.富士倉庫運輸(株) FACE-1前,2024-02-08T19:00:26.452000Z,1707418805,11
442,4,0,35.695163,139.769566,A3-38.パークホームズ千代田淡路町,2024-02-08T19:00:26.453000Z,1707418805,4
443,2,4,35.702833,139.739,D2-11.神楽坂アインスタワー,2024-02-08T19:00:26.453000Z,1707418805,6
444,0,5,35.656991,139.740739,C2-04.飯倉いきいきプラザ,2024-02-08T19:00:26.466000Z,1707418805,5
445,18,0,35.686101,139.776089,B1-09.スマイルホテル日本橋三越前,2024-02-08T19:00:26.467000Z,1707418805,18
446,7,4,35.726499,139.759884,E5-15.文京千駄木の郷,2024-02-08T19:00:26.468000Z,1707418805,11
447,9,4,35.651046,139.727745,C2-05.ありすいきいきプラザ,2024-02-08T19:00:26.468000Z,1707418805,13
448,19,0,35.632303,139.742393,C5-06.品川シーズンテラス,2024-02-08T19:00:26.469000Z,1707418805,19
449,6,3,35.680833,139.784267,B1-10.箱崎川第二公園,2024-02-08T19:00:26.470000Z,1707418805,9
450,0,3,35.663222,139.587803,L1-15.ソフィア,2024-02-08T19:00:26.161000Z,1707418805,3
451,15,0,35.70111,139.772855,A3-12.秋葉原UDX北側駐輪場前,2024-02-08T19:00:26.480000Z,1707418805,15
452,6,3,35.700568,139.76013,A2-08.KDX御茶ノ水ビル,2024-02-08T19:00:26.482000Z,1707418805,9
453,5,1,35.696942,139.767302,A3-07.淡路公園,2024-02-08T19:00:26.483000Z,1707418805,6
454,11,0,35.699132,139.74462,A1-08.飯田橋サクラテラス（早稲田通り）,2024-02-08T19:00:25.770000Z,1707418805,11
455,4,14,35.700486,139.774254,A3-13.富士ソフトビル（駐車場入口横）,2024-02-08T19:00:26.484000Z,1707418805,18
456,8,0,35.6931,139.7599,A2-09.テラススクエア,2024-02-08T19:00:26.485000Z,1707418805,8
457,17,5,35.67962,139.7364,A6-11.東京ガーデンテラス紀尾井町,2024-02-08T19:00:26.495000Z,1707418805,22
458,1,5,35.564161,139.695187,K1-124.矢口2丁目,2024-02-08T19:00:26.497000Z,1707418805,6
459,1,2,35.71046,139.6855,N3-15.ライオンズマンション中野東,2024-02-08T19:00:26.498000Z,1707418805,3
460,8,2,35.65718,139.698687,M3-11.渋谷道玄坂東急ビル,2024-02-08T19:00:26.502000Z,1707418805,10
461,7,1,35.691954,139.836462,H1-180.シティコート大島,2024-02-08T19:00:26.503000Z,1707418805,8
462,24,4,35.68973,139.77598,B1-27.日本橋本町4丁目,2024-02-08T19:00:26.503000Z,1707418805,28
463,15,0,35.64514,139.71686,M3-22.森谷ビル,2024-02-08T19:00:26.504000Z,1707418805,15
464,10,0,35.70862,139.680679,N3-17.東中野3丁目,2024-02-08T19:00:26.505000Z,1707418805,10
465,2,3,35.733432,139.671241,N2-10.関根ビル,2024-02-08T19:00:26.506000Z,1707418805,5
466,5,0,35.762326,139.635226,T1-06.秋の陽公園,2024-02-08T19:00:26.512000Z,1707418805,5
467,0,14,35.721556,139.640397,N1-02.鷺宮東駐輪場,2024-02-08T19:00:26.513000Z,1707418805,14
468,14,0,35.586382,139.705116,K1-140.西馬込駅前自転車駐車場(奥),2024-02-08T19:00:26.514000Z,1707418805,14
469,13,1,35.695695,139.820507,H1-182.錦糸町プライムタワー,2024-02-08T19:00:26.515000Z,1707418805,14
470,0,9,35.728644,139.752183,E5-05.駒込地域活動センター,2024-02-08T19:00:26.516000Z,1707418805,9
471,6,0,35.657556,139.704129,M3-06.渋谷第一生命ビル,2024-02-08T19:00:26.517000Z,1707418805,6
472,2,3,35.74553,139.608939,T2-42.石神井公園駅北第二自転車駐車場,2024-02-08T19:00:26.517000Z,1707418805,5
473,10,0,35.559809,139.716993,K1-144.蒲田五丁目44番自転車駐車場,2024-02-08T19:00:26.523000Z,1707418805,10
474,10,0,35.65506,139.69384,M3-07.渋谷ファーストプレイス,2024-02-08T19:00:26.532000Z,1707418805,10
475,10,0,35.63848,139.832305,H1-74.タダノ教習センター,2024-02-08T19:00:26.537000Z,1707418805,10
476,3,0,35.532615,139.700332,Z22.みんちゅう京急川崎駅前駐輪場内ラックスペース,2024-02-08T19:00:26.538000Z,1707418805,3
477,0,9,35.701347,139.819973,H1-151.コスモリード錦糸町,2024-02-08T19:00:26.538000Z,1707418805,9
478,6,0,35.750185,139.579216,T2-23.セブン-イレブン 練馬南大泉5丁目店,2024-02-08T19:00:26.541000Z,1707418805,6
479,3,0,35.66616,139.70458,M4-13.J-cube,2024-02-08T19:00:26.542000Z,1707418805,3
480,0,5,35.734805,139.599906,T2-65.さくらの辻公園,2024-02-08T19:00:26.552000Z,1707418805,5
481,0,27,35.754586,139.606409,T2-24.セブン-イレブン 練馬インター店,2024-02-08T19:00:26.553000Z,1707418805,27
482,0,2,35.701454,139.650518,O5-05.モンテ・ベルテ,2024-02-08T19:00:26.554000Z,1707418805,2
483,5,4,35.618622,139.67596,J1-42.都立大学駅北口バス停前,2024-02-08T19:00:26.555000Z,1707418805,9
484,0,14,35.555561,139.704345,K1-97.トミンタワー多摩川二丁目,2024-02-08T19:00:26.557000Z,1707418805,14
485,0,7,35.68752,139.72818,D1-14.コモレ四谷,2024-02-08T19:00:26.558000Z,1707418805,7
486,0,9,35.599329,139.703343,K1-106.ファミリーマート上池台夫婦坂店,2024-02-08T19:00:26.558000Z,1707418805,9
487,0,11,35.655483,139.687325,J1-39.松見坂公園,2024-02-08T19:00:26.559000Z,1707418805,11
488,5,3,35.616541,139.697369,J1-40.西小山公園,2024-02-08T19:00:26.560000Z,1707418805,8
489,6,6,35.626355,139.700153,J1-38.林試の森公園 北,2024-02-08T19:00:26.560000Z,1707418805,12
490,0,3,35.613819,139.728418,I1-84.セブン-イレブン西品川2丁目店,2024-02-08T19:00:26.719000Z,1707418805,3
491,8,1,35.694951,139.708219,D6-26.セブン-イレブン新宿６丁目文化センター通り店,2024-02-08T19:00:26.562000Z,1707418805,9
492,0,5,35.746045,139.620087,T2-25.ファミリーマート 高野台二丁目店,2024-02-08T19:00:26.563000Z,1707418805,5
493,0,5,35.621081,139.741178,I1-85.GOODOFFICE品川,2024-02-08T19:00:26.566000Z,1707418805,5
494,3,4,35.587423,139.753871,K1-74.大田スタジアム,2024-02-08T19:00:26.567000Z,1707418805,7
495,3,2,35.669941,139.749261,C1-64.東京虎ノ門グローバルスクエア,2024-02-08T19:00:26.572000Z,1707418805,5
496,0,7,35.573358,139.723105,K1-72.ファミリーマート大森西四丁目店,2024-02-08T19:00:26.573000Z,1707418805,7
497,6,5,35.69839,139.825484,H1-118.ファミリーマート亀戸駅前店,2024-02-08T19:00:26.574000Z,1707418805,11
498,0,6,35.622277,139.745638,I1-62.天王洲Rim,2024-02-08T19:00:26.575000Z,1707418805,6
499,3,1,35.674076,139.795008,H1-40.深川東京モダン館,2024-02-08T19:00:26.576000Z,1707418805,4
500,8,3,35.671225,139.808561,H1-117.東京パークサイドビル,2024-02-08T19:00:26.577000Z,1707418805,11
501,8,1,35.640675,139.698088,J1-01.目黒区総合庁舎,2024-02-08T19:00:26.580000Z,1707418805,9
502,23,0,35.626704,139.742174,C5-16.品川インターシティ,2024-02-08T19:00:26.751000Z,1707418805,23
503,7,0,35.695515,139.750213,A1-12.北の丸スクエア,2024-02-08T19:00:26.583000Z,1707418805,7
504,0,27,35.659287,139.807358,H1-46.セブン-イレブン 江東枝川2丁目店,2024-02-08T19:00:26.592000Z,1707418805,27
505,11,2,35.698991,139.76091,A2-25.プラウド神田駿河台,2024-02-08T19:00:26.593000Z,1707418805,13
506,0,15,35.638912,139.747422,C5-49.プラウドタワー芝浦,2024-02-08T19:00:26.593000Z,1707418805,15
507,0,4,35.767627,139.65243,T3-25.北町みのり公園,2024-02-08T19:00:26.594000Z,1707418805,4
508,0,10,35.684247,139.815638,H1-75.ジオ深川住吉,2024-02-08T19:00:26.595000Z,1707418805,10
509,3,2,35.765704,139.625178,T1-09.ローソン練馬旭町一丁目店,2024-02-08T19:00:26.597000Z,1707418805,5
510,0,8,35.767388,139.587625,T2-26.ファミリーマート 大泉学園町四丁目店,2024-02-08T19:00:26.598000Z,1707418805,8
511,2,3,35.773841,139.591456,T2-27.ファミリーマート 大泉長久保通り店,2024-02-08T19:00:26.599000Z,1707418805,5
512,3,1,35.678179,139.720809,C3-19.明治記念館西,2024-02-08T19:00:26.600000Z,1707418805,4
513,11,3,35.603984,139.744504,I1-11.鮫洲入江広場,2024-02-08T19:00:26.601000Z,1707418805,14
514,15,3,35.607717,139.749478,I1-10.品川シーサイド公園第1,2024-02-08T19:00:26.609000Z,1707418805,18
515,0,15,35.616633,139.748945,I1-09.東品川海上公園第1,2024-02-08T19:00:26.609000Z,1707418805,15
516,0,7,35.713872,139.698301,D3-06.セブン-イレブン高田馬場3丁目中央店,2024-02-08T19:00:26.610000Z,1707418805,7
517,0,16,35.579649,139.720263,K1-40.大田文化の森,2024-02-08T19:00:26.611000Z,1707418805,16
518,6,3,35.658709,139.757036,C1-41.港区立エコプラザ,2024-02-08T19:00:26.612000Z,1707418805,9
519,0,12,35.613421,139.75375,I1-13.八潮北公園,2024-02-08T19:00:26.613000Z,1707418805,12
520,2,2,35.596091,139.740884,I1-12.しながわ区民公園（北側）,2024-02-08T19:00:26.614000Z,1707418805,4
521,3,7,35.763741,139.588847,T2-09.こぐれの森緑地,2024-02-08T19:00:26.615000Z,1707418805,10
522,4,4,35.74097,139.63836,T3-31.パークサイド関口,2024-02-08T19:00:26.615000Z,1707418805,8
523,4,0,35.643958,139.838358,H1-183.MFLP新木場1,2024-02-08T19:00:26.616000Z,1707418805,4
524,2,4,35.74642,139.581204,T2-33.ウインドヒルズ189,2024-02-08T19:00:26.620000Z,1707418805,6
525,0,7,35.761211,139.603316,T2-67.陽和病院,2024-02-08T19:00:26.621000Z,1707418805,7
526,0,21,35.683514,139.827081,H1-82.セブンｰイレブン 北砂3丁目明治通り店,2024-02-08T19:00:26.622000Z,1707418805,21
527,9,0,35.724747,139.565817,T2-60.武蔵関公園（第一）,2024-02-08T19:00:26.623000Z,1707418805,9
528,5,4,35.632191,139.725002,I1-48.NTT 東日本 関東病院(北側),2024-02-08T19:00:26.561000Z,1707418805,9
529,3,2,35.716776,139.577975,T2-58.立野公園,2024-02-08T19:00:26.632000Z,1707418805,5
530,3,4,35.610444,139.712333,I1-100.東急荏原中延駅駐輪場,2024-02-08T19:00:26.633000Z,1707418805,7
531,2,2,35.77228,139.58325,T2-56.大泉公園（第一）,2024-02-08T19:00:26.633000Z,1707418805,4
532,0,3,35.767296,139.602321,T2-55.大泉町もみじやま公園,2024-02-08T19:00:26.634000Z,1707418805,3
533,0,9,35.760939,139.609264,T2-54.土支田農業公園,2024-02-08T19:00:26.635000Z,1707418805,9
534,6,0,35.604606,139.734483,I1-44.大井三ツ又商店街入口,2024-02-08T19:00:26.636000Z,1707418805,6
535,6,4,35.746681,139.57754,T2-62.大泉井頭公園,2024-02-08T19:00:26.637000Z,1707418805,10
536,4,0,35.727826,139.570056,T2-61.武蔵関公園（第二）,2024-02-08T19:00:26.637000Z,1707418805,4
537,4,1,35.730428,139.648704,T3-09.学田公園,2024-02-08T19:00:26.638000Z,1707418805,5
538,0,8,35.555702,139.740802,K1-105.東糀谷二丁目児童公園,2024-02-08T19:00:26.639000Z,1707418805,8
539,2,4,35.513644,139.712594,Z02.NTT渡田ビル,2024-02-08T19:00:26.640000Z,1707418805,6
540,8,4,35.759827,139.659121,T3-04.サンパレス平和台,2024-02-08T19:00:26.641000Z,1707418805,12
541,1,5,35.543573,139.714393,K1-104.六郷BASE,2024-02-08T19:00:26.648000Z,1707418805,6
542,2,1,35.668673,139.702816,M4-16.神宮前6丁目,2024-02-08T19:00:26.649000Z,1707418805,3
543,0,7,35.585747,139.735242,K1-69.京急平和島第2Bバイク駐輪場,2024-02-08T19:00:26.650000Z,1707418805,7
544,13,7,35.645726,139.784496,H1-155.メブクス豊洲,2024-02-08T19:00:26.651000Z,1707418805,20
545,7,46,35.654726,139.737491,C2-11.一の橋,2024-02-08T19:00:26.652000Z,1707418805,53
546,0,14,35.64816,139.737991,C4-11.ザ・パークハウス 三田ガーデン,2024-02-08T19:00:26.653000Z,1707418805,14
547,4,2,35.684003,139.794983,H1-161.昭文社制作本部ビル,2024-02-08T19:00:26.654000Z,1707418805,6
548,2,3,35.714292,139.663327,N2-07.新井区民活動センター,2024-02-08T19:00:26.655000Z,1707418805,5
549,2,8,35.547061,139.756277,K1-87.羽田イノベーションシティ,2024-02-08T19:00:26.655000Z,1707418805,10
550,5,0,35.699743,139.664608,N3-16.COURT 5,2024-02-08T19:00:26.656000Z,1707418805,5
551,1,10,35.641833,139.734519,C4-01.高輪地区総合支所(5F),2024-02-08T19:00:26.662000Z,1707418805,11
552,0,8,35.636808,139.752517,C5-48.セブンイレブン港区海岸三丁目店,2024-02-08T19:00:27.515000Z,1707418805,8
553,0,29,35.683961,139.821559,H1-42.江東区スポーツ会館,2024-02-08T19:00:26.664000Z,1707418805,29
554,0,12,35.675702,139.785229,B2-10.東京ダイヤビルディング（北側）,2024-02-08T19:00:26.665000Z,1707418805,12
555,0,18,35.675639,139.815255,H1-43.東京イースト21,2024-02-08T19:00:26.666000Z,1707418805,18
556,6,0,35.670106,139.768041,B3-20.歌舞伎座タワー駐輪場2F,2024-02-08T19:00:26.667000Z,1707418805,6
557,11,0,35.6701,139.76801,B3-21.歌舞伎座タワー駐輪場3F,2024-02-08T19:00:26.668000Z,1707418805,11
558,5,8,35.537434,139.744509,Z06.ローソン川崎殿町店,2024-02-08T19:00:26.673000Z,1707418805,13
559,8,2,35.548104,139.748889,K1-139.プラットホステル京急 羽田ホーム,2024-02-08T19:00:26.674000Z,1707418805,10
560,3,2,35.629011,139.69716,J1-58.目黒女子会館前,2024-02-08T19:00:26.675000Z,1707418805,5
561,2,2,35.745505,139.580878,T2-18.ファミリーマート練馬西税務署前店,2024-02-08T19:00:26.340000Z,1707418805,4
562,14,15,35.669916,139.725701,C3-23.LIFORK 南青山 北エントランス,2024-02-08T19:00:26.680000Z,1707418805,29
563,14,2,35.665124,139.754054,C1-46.新虎通りCORE,2024-02-08T19:00:26.681000Z,1707418805,16
564,17,2,35.656324,139.755927,C1-45.浜松町クレアタワー,2024-02-08T19:00:26.681000Z,1707418805,19
565,15,5,35.589309,139.678587,K1-53.セブン-イレブン 田園調布郵便局前店,2024-02-08T19:00:26.683000Z,1707418805,20
566,7,0,35.564152,139.727422,K1-52.大田区総合体育館,2024-02-08T19:00:26.684000Z,1707418805,7
567,3,1,35.756873,139.616612,T1-12.ファミリーマート 高松六丁目店,2024-02-08T19:00:26.692000Z,1707418805,4
568,0,5,35.725171,139.675897,D7-07.ローソン 新宿西落合三丁目店,2024-02-08T19:00:26.693000Z,1707418805,5
569,3,2,35.688351,139.744321,A6-16.一番町第二TGビル,2024-02-08T19:00:26.694000Z,1707418805,5
570,12,0,35.667462,139.716058,C3-33.PASONA SQUARE,2024-02-08T19:00:26.695000Z,1707418805,12
571,0,10,35.69441,139.777715,A3-24.岩本町ほほえみプラザ,2024-02-08T19:00:26.696000Z,1707418805,10
572,7,0,35.652376,139.797724,H1-35.ヒューリック豊洲プライムスクエア,2024-02-08T19:00:26.697000Z,1707418805,7
573,0,57,35.631729,139.749767,C5-11.フェイバリッチタワー品川,2024-02-08T19:00:26.698000Z,1707418805,57
574,0,4,35.70781,139.732227,E2-13.デルックス文京神楽坂,2024-02-08T19:00:26.698000Z,1707418805,4
575,47,0,35.629697,139.742167,C5-01.こうなん星の公園,2024-02-08T19:00:26.699000Z,1707418805,47
576,0,79,35.628955,139.750731,C5-02.港南緑水公園,2024-02-08T19:00:26.700000Z,1707418805,79
577,1,7,35.693234,139.779702,A3-22.龍閑児童公園,2024-02-08T19:00:26.701000Z,1707418805,8
578,7,5,35.695176,139.772832,A3-21.神田ふれあい通り第３,2024-02-08T19:00:26.712000Z,1707418805,12
579,9,3,35.67338,139.8164,H1-30.江東区役所（北側）,2024-02-08T19:00:26.713000Z,1707418805,12
580,4,0,35.657866,139.751068,C1-17.港区役所,2024-02-08T19:00:26.714000Z,1707418805,4
581,17,0,35.67214,139.8166,H1-31.江東区役所（南側）,2024-02-08T19:00:26.714000Z,1707418805,17
582,9,0,35.662051,139.748132,C1-09.愛宕グリーンヒルズ,2024-02-08T19:00:26.715000Z,1707418805,9
583,16,1,35.687435,139.714169,D1-02.四谷特別出張所（新宿御苑大木戸門前）,2024-02-08T19:00:27.984000Z,1707418805,17
584,5,0,35.690612,139.711631,D1-01.花園西公園,2024-02-08T19:00:26.717000Z,1707418805,5
585,12,2,35.666527,139.748804,C1-04.虎ノ門ヒルズ,2024-02-08T19:00:26.718000Z,1707418805,14
586,14,0,35.665593,139.752617,C1-05.西新橋2丁目（新虎通り）,2024-02-08T19:00:26.718000Z,1707418805,14
587,14,0,35.669871,139.753147,C1-73.日比谷フォートタワー,2024-02-08T19:00:26.721000Z,1707418805,14
588,0,7,35.595119,139.6996,K1-102.上池台四丁目公園,2024-02-08T19:00:26.728000Z,1707418805,7
589,0,15,35.64524,139.71946,M2-01.恵比寿保健相談所（恵比寿社会教育館）,2024-02-08T19:00:26.729000Z,1707418805,15
590,0,6,35.60411,139.709784,I1-98.コーポ荏原,2024-02-08T19:00:26.732000Z,1707418805,6
591,0,18,35.670308,139.743242,C3-17.セブン-イレブン 港区溜池山王店,2024-02-08T19:00:26.733000Z,1707418805,18
592,2,1,35.739471,139.595578,T2-11.石神井松の風文化公園,2024-02-08T19:00:26.740000Z,1707418805,3
593,15,0,35.646581,139.710613,M2-03.サイカパーク恵比寿,2024-02-08T19:00:26.741000Z,1707418805,15
594,8,0,35.643606,139.713099,M2-02.アメリカ橋公園,2024-02-08T19:00:26.742000Z,1707418805,8
595,8,1,35.72305,139.579555,T2-50.North Ridge 吉祥寺,2024-02-08T19:00:26.742000Z,1707418805,9
596,5,1,35.634574,139.710332,J1-35.目黒川田道街かど公園,2024-02-08T19:00:26.743000Z,1707418805,6
597,0,2,35.682712,139.823961,H1-174.ジュネス(エントランス側),2024-02-08T19:00:27.443000Z,1707418805,2
598,1,6,35.672922,139.668729,M6-17.笹塚一丁目駐輪場,2024-02-08T19:00:26.752000Z,1707418805,7
599,3,7,35.643711,139.724753,C4-14.神応ほっとプラザ,2024-02-08T19:00:26.753000Z,1707418805,10
600,5,5,35.596854,139.712139,K1-107.馬込駅A2出口,2024-02-08T19:00:26.757000Z,1707418805,10
601,1,2,35.740321,139.631256,T3-11.ガラクタ公園,2024-02-08T19:00:26.758000Z,1707418805,3
602,2,3,35.756825,139.590528,T2-80.みその緑地,2024-02-08T19:00:26.762000Z,1707418805,5
603,5,2,35.743962,139.670315,T3-24.AZEST新桜台,2024-02-08T19:00:26.763000Z,1707418805,7
604,0,9,35.698512,139.716482,D4-07.新宿余丁町ビル,2024-02-08T19:00:26.766000Z,1707418805,9
605,4,0,35.524976,139.697495,Z23.NA川崎南町,2024-02-08T19:00:26.772000Z,1707418805,4
606,7,0,35.751438,139.641265,T3-01.練馬春日町駅自転車駐車場,2024-02-08T19:00:26.773000Z,1707418805,7
607,7,7,35.637041,139.781088,H1-89.BUDDY スポーツアリーナ,2024-02-08T19:00:26.773000Z,1707418805,14
608,5,8,35.707313,139.771857,E5-14.上野広小路駅（湯島側）,2024-02-08T19:00:26.781000Z,1707418805,13
609,0,46,35.648008,139.803487,H1-109.Brillia ist 東雲キャナルコート東側,2024-02-08T19:00:25.547000Z,1707418805,46
610,0,21,35.648431,139.803125,H1-108.Brillia ist 東雲キャナルコート北側,2024-02-08T19:00:25.549000Z,1707418805,21
611,4,0,35.661149,139.754612,C1-53.ホテルリブマックス新橋,2024-02-08T19:00:26.783000Z,1707418805,4
612,1,5,35.715211,139.689788,D7-10.染の里 おちあい,2024-02-08T19:00:26.789000Z,1707418805,6
613,0,6,35.697167,139.745629,A1-15.富士見みらい館,2024-02-08T19:00:26.790000Z,1707418805,6
614,2,3,35.729153,139.741368,E4-15.千石4丁目,2024-02-08T19:00:26.791000Z,1707418805,5
615,0,9,35.66688,139.80779,H1-111.ファミリーマート木場六丁目店,2024-02-08T19:00:26.792000Z,1707418805,9
616,3,0,35.62974,139.778178,C5-36.お台場海浜公園駅,2024-02-08T19:00:26.804000Z,1707418805,3
617,15,0,35.625029,139.777344,H1-10.出会い橋,2024-02-08T19:00:26.805000Z,1707418805,15
618,6,15,35.61813,139.778698,H1-11.テレコムセンター駅,2024-02-08T19:00:26.807000Z,1707418805,21
619,0,37,35.672481,139.835877,H1-47.トピレックプラザ,2024-02-08T19:00:26.809000Z,1707418805,37
620,19,0,35.654067,139.792376,H1-13.アーバンドック ららぽーと豊洲,2024-02-08T19:00:26.812000Z,1707418805,19
621,0,4,35.778605,139.588883,T2-66.大泉学園町希望ヶ丘公園,2024-02-08T19:00:25.815000Z,1707418805,4
622,0,24,35.626388,139.772453,C5-37.台場駅,2024-02-08T19:00:26.819000Z,1707418805,24
623,19,0,35.657477,139.796629,H1-16.豊洲三丁目公園,2024-02-08T19:00:26.821000Z,1707418805,19
624,0,69,35.64704,139.80469,H1-17.東雲水辺公園,2024-02-08T19:00:26.823000Z,1707418805,69
625,10,1,35.646307,139.746428,C1-72.新田町ビル,2024-02-08T19:00:26.837000Z,1707418805,11
626,2,5,35.577433,139.680752,K1-98.鵜の木松山公園,2024-02-08T19:00:26.838000Z,1707418805,7
627,0,7,35.65583,139.759896,C1-71.芝商業高校前交差点,2024-02-08T19:00:26.840000Z,1707418805,7
628,0,11,35.679167,139.839746,H1-122.東砂スポーツセンター,2024-02-08T19:00:26.842000Z,1707418805,11
629,0,5,35.687531,139.60439,O6-05.コージーコート久我山,2024-02-08T19:00:26.845000Z,1707418805,5
630,7,1,35.758929,139.597548,T2-39.ローソン 練馬大泉町五丁目店,2024-02-08T19:00:26.847000Z,1707418805,8
631,2,2,35.609958,139.684087,J1-50.大岡山公園,2024-02-08T19:00:26.852000Z,1707418805,4
632,0,5,35.650627,139.687228,J1-51.池尻大橋駅東口駐輪場,2024-02-08T19:00:26.853000Z,1707418805,5
633,7,1,35.584086,139.67898,K1-99.東原くすのき公園,2024-02-08T19:00:26.855000Z,1707418805,8
634,3,0,35.702414,139.667327,N3-12.桃園区民活動センター,2024-02-08T19:00:26.859000Z,1707418805,3
635,14,0,35.644863,139.831107,H1-191.三井リンクラボ新木場2,2024-02-08T19:00:26.992000Z,1707418805,14
636,5,0,35.66865,139.679251,M5-09.代々木上原駅前,2024-02-08T19:00:26.882000Z,1707418805,5
637,4,3,35.714151,139.61693,O3-09.NTT井草ビル第3ポート,2024-02-08T19:00:26.882000Z,1707418805,7
638,2,8,35.765913,139.619285,T1-07.土支田一丁目（笹目通り）,2024-02-08T19:00:26.883000Z,1707418805,10
639,2,3,35.562324,139.690486,K1-22.矢口特別出張所,2024-02-08T19:00:26.884000Z,1707418805,5
640,2,5,35.728268,139.649188,T3-08.中新井川児童遊園,2024-02-08T19:00:26.885000Z,1707418805,7
641,14,0,35.645604,139.834941,H1-78.ローソン新木場一丁目店,2024-02-08T19:00:26.897000Z,1707418805,14
642,5,1,35.689131,139.733071,A6-13.番町会館,2024-02-08T19:00:26.897000Z,1707418805,6
643,0,4,35.670906,139.819386,H1-71.セブン-イレブン 江東東陽4丁目,2024-02-08T19:00:26.898000Z,1707418805,4
644,3,0,35.700993,139.736355,D2-09.セブン-イレブン 新宿岩戸町店,2024-02-08T19:00:26.899000Z,1707418805,3
645,27,4,35.622294,139.751644,I1-08.天王洲アイル第一水辺広場,2024-02-08T19:00:26.900000Z,1707418805,31
646,0,16,35.590641,139.736354,I1-07.しながわ水族館,2024-02-08T19:00:26.901000Z,1707418805,16
647,2,2,35.712545,139.713319,D3-09.西早稲田3丁目,2024-02-08T19:00:26.903000Z,1707418805,4
648,0,21,35.714338,139.746346,E1-16.小石川3丁目緑地,2024-02-08T19:00:26.903000Z,1707418805,21
649,6,1,35.643683,139.7506,C5-28.芝浦ルネサイトタワー,2024-02-08T19:00:26.904000Z,1707418805,7
650,14,7,35.612357,139.721484,I1-59.文庫の森第一,2024-02-08T19:00:26.905000Z,1707418805,21
651,0,5,35.611368,139.720424,I1-60.文庫の森第二,2024-02-08T19:00:26.912000Z,1707418805,5
652,2,3,35.66495,139.750459,C1-38.KDX西新橋ビル（西側）,2024-02-08T19:00:26.913000Z,1707418805,5
653,3,2,35.665218,139.750827,C1-37.KDX西新橋ビル（北側）,2024-02-08T19:00:26.914000Z,1707418805,5
654,0,6,35.747807,139.593599,T2-14.NPC24H東大泉第6パーキング,2024-02-08T19:00:26.998000Z,1707418805,6
655,1,7,35.676732,139.733905,C3-12.赤坂センタービルディング前（青山通り）,2024-02-08T19:00:26.917000Z,1707418805,8
656,0,23,35.66605,139.806699,H1-36.フジゴルフセンター,2024-02-08T19:00:26.918000Z,1707418805,23
657,14,0,35.668547,139.747175,C1-27.虎ノ門2丁目タワー,2024-02-08T19:00:26.919000Z,1707418805,14
658,5,3,35.633742,139.748281,C5-12.第2東運ビル,2024-02-08T19:00:26.919000Z,1707418805,8
659,6,1,35.697158,139.707887,D6-08.新宿イーストサイドスクエア,2024-02-08T19:00:26.922000Z,1707418805,7
660,24,0,35.684349,139.766958,A4-08.永代通り（大手町駅B2c出口前）,2024-02-08T19:00:26.928000Z,1707418805,24
661,32,3,35.640618,139.802455,H1-37.東雲駅（東京湾岸道路）,2024-02-08T19:00:26.930000Z,1707418805,35
662,1,0,35.676566,139.737083,C3-11.赤坂見附南,2024-02-08T19:00:26.931000Z,1707418805,1
663,0,20,35.687126,139.680702,M6-04.本町東べんてん橋公園,2024-02-08T19:00:26.933000Z,1707418805,20
664,11,4,35.621904,139.741429,I1-79.品川浦第二,2024-02-08T19:00:26.940000Z,1707418805,15
665,10,3,35.549568,139.731093,K1-81.コーナン本羽田萩中店,2024-02-08T19:00:26.941000Z,1707418805,13
666,29,4,35.689755,139.701323,D6-25.新宿駅東南口自転車駐輪場,2024-02-08T19:00:26.942000Z,1707418805,33
667,2,8,35.601431,139.718659,I1-78.セブン-イレブン西大井店,2024-02-08T19:00:26.943000Z,1707418805,10
668,0,17,35.683542,139.839763,H1-136.東砂一丁目公園,2024-02-08T19:00:26.944000Z,1707418805,17
669,0,14,35.689466,139.745316,A6-23.セブン-イレブン 千代田三番町店,2024-02-08T19:00:26.944000Z,1707418805,14
670,0,13,35.636644,139.751798,C5-34.五色橋ビル,2024-02-08T19:00:26.946000Z,1707418805,13
671,0,11,35.588644,139.710413,K1-41.郷土博物館,2024-02-08T19:00:26.947000Z,1707418805,11
672,0,5,35.71408,139.810588,G2-06.ディアレイシャス押上スカイヴィレッジ,2024-02-08T19:00:26.948000Z,1707418805,5
673,7,1,35.707877,139.618926,O3-11.ハイリビング関根,2024-02-08T19:00:26.952000Z,1707418805,8
674,6,0,35.67121,139.64145,O7-02.永福中央公園,2024-02-08T19:00:26.953000Z,1707418805,6
675,3,6,35.55017,139.728146,K1-29.萩中文化センター,2024-02-08T19:00:26.954000Z,1707418805,9
676,2,2,35.567922,139.746181,K1-30.テクノFRONT森ケ崎,2024-02-08T19:00:26.955000Z,1707418805,4
677,15,3,35.578728,139.735238,K1-130.COCOONひろば平和島,2024-02-08T19:00:26.956000Z,1707418805,18
678,21,0,35.659829,139.793243,H1-81.豊洲IHIビル（北側）,2024-02-08T19:00:26.957000Z,1707418805,21
679,25,8,35.73166,139.748625,E4-03.昭和小学校北側（不忍通り）,2024-02-08T19:00:26.958000Z,1707418805,33
680,15,0,35.66249,139.741397,C2-12.六本木ファーストビル,2024-02-08T19:00:26.958000Z,1707418805,15
681,4,11,35.708734,139.730509,D3-16.セジョリ江戸川橋,2024-02-08T19:00:26.959000Z,1707418805,15
682,6,2,35.671514,139.753952,A5-04.日比谷パークフロント前　日比谷公園南面向い歩道上,2024-02-08T19:00:26.964000Z,1707418805,8
683,8,0,35.674929,139.736053,C3-22.OMO3東京赤坂 by 星野リゾート,2024-02-08T19:00:26.965000Z,1707418805,8
684,0,19,35.688301,139.768958,B1-20.竜閑さくら橋際街角広場,2024-02-08T19:00:26.966000Z,1707418805,19
685,0,15,35.642165,139.800439,H1-83.ローソン江東東雲店,2024-02-08T19:00:26.967000Z,1707418805,15
686,0,20,35.647091,139.817333,H1-84.NTT東日本辰巳ビル,2024-02-08T19:00:26.970000Z,1707418805,20
687,10,4,35.644155,139.756216,C5-26.ピアシティ芝浦ビル,2024-02-08T19:00:26.971000Z,1707418805,14
688,0,3,35.755137,139.661208,T3-28.ほしぞら緑地,2024-02-08T19:00:26.405000Z,1707418805,3
689,1,1,35.58768,139.734515,I1-88.セブン-イレブン品川南大井3丁目店,2024-02-08T19:00:26.977000Z,1707418805,2
690,0,8,35.599774,139.723467,I1-87.セブン-イレブン西大井滝王子通り店,2024-02-08T19:00:26.978000Z,1707418805,8
691,0,10,35.540589,139.752918,Z20.川崎キングスカイフロント 東急 REI ホテル,2024-02-08T19:00:26.979000Z,1707418805,10
692,19,2,35.703972,139.797327,G4-11.ホテルマイステイズ浅草,2024-02-08T19:00:26.988000Z,1707418805,21
693,0,11,35.647872,139.75391,C5-30.フェイム芝浦インターウェーブ,2024-02-08T19:00:26.993000Z,1707418805,11
694,9,3,35.673409,139.675203,M6-13.JICA東京,2024-02-08T19:00:26.994000Z,1707418805,12
695,5,0,35.68557,139.766929,A4-13.アーバンネット大手町ビル,2024-02-08T19:00:26.995000Z,1707418805,5
696,11,7,35.670491,139.784447,B4-27.リバーシティ西ブロック,2024-02-08T19:00:26.996000Z,1707418805,18
697,59,1,35.584914,139.730504,K1-143.大森北1丁目,2024-02-08T19:00:26.996000Z,1707418805,60
698,3,2,35.712445,139.758157,E5-24.本郷6丁目,2024-02-08T19:00:27.004000Z,1707418805,5
699,10,0,35.690657,139.73255,D2-17.genten市ヶ谷店,2024-02-08T19:00:27.005000Z,1707418805,10
700,8,0,35.675739,139.763712,A4-14.東京国際フォーラム（有楽町駅ガード側）,2024-02-08T19:00:27.006000Z,1707418805,8
701,6,0,35.690958,139.759876,A2-27.丸紅ビル,2024-02-08T19:00:27.007000Z,1707418805,6
702,4,2,35.608633,139.693653,K1-135.北千束2丁目,2024-02-08T19:00:27.007000Z,1707418805,6
703,4,0,35.694065,139.751801,A1-19.九段会館テラス,2024-02-08T19:00:27.008000Z,1707418805,4
704,0,9,35.585489,139.740194,K1-136.BIG FUN 平和島,2024-02-08T19:00:27.017000Z,1707418805,9
705,0,14,35.571578,139.770532,K1-137.京浜島つばさ公園,2024-02-08T19:00:27.018000Z,1707418805,14
706,6,3,35.690155,139.713377,D1-16.ルネ新宿御苑タワー,2024-02-08T19:00:27.022000Z,1707418805,9
707,1,6,35.692547,139.799231,G6-01.オーキッドレジデンス森下,2024-02-08T19:00:27.023000Z,1707418805,7
708,1,6,35.751471,139.599835,T2-63.三原台公園,2024-02-08T19:00:27.024000Z,1707418805,7
709,1,1,35.70328,139.62981,O4-01.阿佐ヶ谷南公園,2024-02-08T19:00:27.025000Z,1707418805,2
710,0,17,35.656565,139.775073,B4-11.ダンスキューブ勝どき,2024-02-08T19:00:27.028000Z,1707418805,17
711,10,0,35.681754,139.715256,D1-06.四谷第六小学校北,2024-02-08T19:00:27.030000Z,1707418805,10
712,1,2,35.746768,139.613885,T2-64.高野台中央公園,2024-02-08T19:00:25.675000Z,1707418805,3
713,0,10,35.697157,139.839835,H1-169.セブンイレブン江東亀戸7丁目東店,2024-02-08T19:00:27.036000Z,1707418805,10
714,0,31,35.695937,139.838017,H1-170.セブンイレブン江東亀戸7丁目南店,2024-02-08T19:00:27.037000Z,1707418805,31
715,5,0,35.67684,139.77876,B2-16.ホテルサードニクス東京,2024-02-08T19:00:27.043000Z,1707418805,5
716,4,1,35.595498,139.750654,I1-93.中央海浜公園前交差点（南側）,2024-02-08T19:00:27.044000Z,1707418805,5
717,10,0,35.595873,139.75134,I1-92.中央海浜公園前交差点（北側）,2024-02-08T19:00:27.045000Z,1707418805,10
718,3,3,35.68802,139.78112,B1-26.Dash Living Nihonbashi,2024-02-08T19:00:27.062000Z,1707418805,6
719,11,1,35.621845,139.776833,H1-158.東京国際交流館,2024-02-08T19:00:27.063000Z,1707418805,12
720,7,0,35.606793,139.678372,J1-32.緑が丘駅前高架下,2024-02-08T19:00:27.068000Z,1707418805,7
721,1,5,35.5873,139.701644,K1-90.ファミリーマート大田仲池上一丁目店,2024-02-08T19:00:27.069000Z,1707418805,6
722,4,6,35.550027,139.74973,K1-91.穴守稲荷神社,2024-02-08T19:00:27.070000Z,1707418805,10
723,16,5,35.669228,139.751668,C1-67.京阪神 虎ノ門ビル,2024-02-08T19:00:27.071000Z,1707418805,21
724,3,2,35.572086,139.68708,K1-89.ファミリーマート大田千鳥三丁目店,2024-02-08T19:00:27.072000Z,1707418805,5
725,14,5,35.613387,139.749307,I1-97.トミンハイム東品川三丁目第二,2024-02-08T19:00:27.076000Z,1707418805,19
726,10,0,35.743772,139.603317,T2-51.練馬区役所石神井庁舎,2024-02-08T19:00:27.077000Z,1707418805,10
727,3,0,35.734684,139.593628,T2-75.石神井台二丁目緑地,2024-02-08T19:00:26.304000Z,1707418805,3
728,1,6,35.728333,139.757629,E5-19.千駄木公園,2024-02-08T19:00:27.079000Z,1707418805,7
729,1,10,35.724921,139.75903,E5-18.団子坂上広場,2024-02-08T19:00:27.080000Z,1707418805,11
730,3,3,35.670452,139.75557,A5-07.富国生命ビル,2024-02-08T19:00:27.084000Z,1707418805,6
731,0,9,35.630791,139.787396,H1-156.つどい橋下,2024-02-08T19:00:27.085000Z,1707418805,9
732,16,0,35.627599,139.782953,H1-159.夢の大橋西,2024-02-08T19:00:27.086000Z,1707418805,16
733,8,2,35.624619,139.776006,H1-143.ダイバーシティ東京 プラザ,2024-02-08T19:00:27.087000Z,1707418805,10
734,74,0,35.589972,139.729368,I1-57.大井水神公園,2024-02-08T19:00:27.092000Z,1707418805,74
735,6,0,35.68168,139.77825,B2-15.KABUTO ONE,2024-02-08T19:00:27.093000Z,1707418805,6
736,0,17,35.545459,139.719489,K1-64.多摩川グリーンスクエア,2024-02-08T19:00:27.094000Z,1707418805,17
737,0,4,35.519137,139.705791,Z07.ローソン川崎渡田三丁目店,2024-02-08T19:00:27.095000Z,1707418805,4
738,5,1,35.771708,139.583551,T2-57.大泉公園（第二）,2024-02-08T19:00:27.096000Z,1707418805,6
739,10,0,35.686037,139.764472,A4-06.大手町ファーストスクエア,2024-02-08T19:00:27.096000Z,1707418805,10
740,11,3,35.666075,139.748008,C1-50.NTT虎ノ門ビル,2024-02-08T19:00:27.097000Z,1707418805,14
741,8,1,35.648637,139.749834,C1-23.三田いきいきプラザ,2024-02-08T19:00:27.109000Z,1707418805,9
742,0,74,35.647618,139.792152,H1-29.スカイズタワー＆ガーデン,2024-02-08T19:00:27.110000Z,1707418805,74
743,5,5,35.657363,139.75918,C1-21.汐留ビルディング,2024-02-08T19:00:27.111000Z,1707418805,10
744,2,4,35.691069,139.775376,A3-16.地蔵橋東児童遊園,2024-02-08T19:00:27.111000Z,1707418805,6
745,0,10,35.526238,139.72907,Z08.ファミリーマート観音二丁目店,2024-02-08T19:00:27.112000Z,1707418805,10
746,0,11,35.69703,139.779928,A3-18.美倉橋北児童遊園,2024-02-08T19:00:27.113000Z,1707418805,11
747,12,0,35.680514,139.764002,A4-01.丸ビル（南側駐輪場）,2024-02-08T19:00:27.114000Z,1707418805,12
748,0,8,35.703735,139.770629,A3-11.練成公園,2024-02-08T19:00:27.115000Z,1707418805,8
749,0,9,35.701978,139.7698,A3-10.芳林公園（北側）,2024-02-08T19:00:27.116000Z,1707418805,9
750,4,4,35.687031,139.739327,A6-02.いきいきプラザ一番町（西側駐輪場）,2024-02-08T19:00:27.121000Z,1707418805,8
751,3,2,35.689879,139.740178,A6-01.東郷元帥記念公園（南側）,2024-02-08T19:00:27.122000Z,1707418805,5
752,10,6,35.677763,139.74271,A5-03.参議院第二別館（永田町駅2番出口）,2024-02-08T19:00:27.123000Z,1707418805,16
753,8,0,35.675843,139.763329,A4-03.東京国際フォーラム（メトロD5出口）,2024-02-08T19:00:27.128000Z,1707418805,8
754,3,0,35.56694,139.716331,K1-15.セブン‐イレブン 大田区西蒲田店,2024-02-08T19:00:27.130000Z,1707418805,3
755,0,10,35.586585,139.698552,K1-49.ローソン仲池上一丁目店,2024-02-08T19:00:27.131000Z,1707418805,10
756,7,0,35.69919,139.75701,A2-06.東光電気工事 別館（屋内駐輪場）,2024-02-08T19:00:27.131000Z,1707418805,7
757,5,1,35.68714,139.702775,M4-01.新宿タカシマヤ,2024-02-08T19:00:27.132000Z,1707418805,6
758,8,2,35.684451,139.702884,M4-03.NTTドコモ代々木ビル,2024-02-08T19:00:27.137000Z,1707418805,10
759,6,2,35.649823,139.700139,M3-03.代官山 T-SITE,2024-02-08T19:00:27.137000Z,1707418805,8
760,5,3,35.578239,139.723262,K1-14.大森地域庁舎,2024-02-08T19:00:27.138000Z,1707418805,8
761,0,21,35.630961,139.746875,C5-46.ウエリスアーバン品川タワー,2024-02-08T19:00:27.160000Z,1707418805,21
762,0,16,35.637765,139.739128,C4-13.コシダコネクトビル,2024-02-08T19:00:27.177000Z,1707418805,16
763,5,0,35.559286,139.722611,K1-127.第二石井ビル,2024-02-08T19:00:27.178000Z,1707418805,5
764,6,2,35.645155,139.744543,C1-74.札の辻スクエア,2024-02-08T19:00:27.185000Z,1707418805,8
765,0,19,35.68546,139.80244,H1-164.森下三丁目第三児童遊園,2024-02-08T19:00:27.186000Z,1707418805,19
766,7,2,35.66646,139.752138,C1-78.CIRCLES新橋,2024-02-08T19:00:27.187000Z,1707418805,9
767,5,1,35.668622,139.715957,C3-34.3rd MINAMI AOYAMA,2024-02-08T19:00:27.187000Z,1707418805,6
768,3,2,35.699328,139.636343,O4-06.杉並区役所本庁舎,2024-02-08T19:00:27.188000Z,1707418805,5
769,5,1,35.712413,139.70168,D3-14.コーシャハイム高田馬場,2024-02-08T19:00:27.189000Z,1707418805,6
770,2,4,35.716359,139.704377,D7-11.新宿清掃事務所,2024-02-08T19:00:27.190000Z,1707418805,6
771,0,9,35.704597,139.708397,D5-08.ウエリス新宿早稲田の森,2024-02-08T19:00:28.314000Z,1707418805,9
772,0,29,35.709147,139.739183,E2-12.水道2丁目,2024-02-08T19:00:28.326000Z,1707418805,29
773,0,11,35.6772,139.678117,M6-10.京王コインパーク幡ヶ谷,2024-02-08T19:00:27.211000Z,1707418805,11
774,49,11,35.721045,139.735687,E3-05.文京スポーツセンター,2024-02-08T19:00:27.213000Z,1707418805,60
775,0,7,35.629067,139.711779,J1-36.WJ Haus,2024-02-08T19:00:27.214000Z,1707418805,7
776,11,0,35.555808,139.722791,K1-51.テクノポートカマタ 第2,2024-02-08T19:00:27.222000Z,1707418805,11
777,0,23,35.688945,139.706536,D1-13.新宿御苑新宿門【西側】,2024-02-08T19:00:27.223000Z,1707418805,23
778,3,3,35.608193,139.719139,I1-31.セブン-イレブン 品川戸越5丁目店,2024-02-08T19:00:27.225000Z,1707418805,6
779,1,3,35.738427,139.632251,T3-27.貫井川緑地,2024-02-08T19:00:27.231000Z,1707418805,4
780,8,9,35.68744,139.827075,H1-147.大島四丁目団地,2024-02-08T19:00:27.241000Z,1707418805,17
781,2,0,35.69638,139.63482,O4-02.成宗さくら公園,2024-02-08T19:00:25.967000Z,1707418805,2
782,3,1,35.72077,139.6045,O1-01.上瀬戸公園,2024-02-08T19:00:26.796000Z,1707418805,4
783,10,0,35.748611,139.584251,T2-15.NPC24H大泉学園南口パーキング,2024-02-08T19:00:27.259000Z,1707418805,10
784,6,1,35.71013,139.61194,O3-03.桃井1丁目5番地,2024-02-08T19:00:27.265000Z,1707418805,7
785,17,28,35.627087,139.779779,H1-08.東京テレポート駅,2024-02-08T19:00:27.284000Z,1707418805,45
786,13,1,35.632148,139.79017,H1-05.相鉄グランドフレッサ 東京ベイ有明,2024-02-08T19:00:27.292000Z,1707418805,14
787,2,13,35.630185,139.786618,H1-06.武蔵野大学,2024-02-08T19:00:27.302000Z,1707418805,15
788,9,0,35.686389,139.769237,A4-15.TOKIWAブリッジ,2024-02-08T19:00:27.307000Z,1707418805,9
789,8,9,35.633908,139.793322,H1-160.花の広場,2024-02-08T19:00:27.317000Z,1707418805,17
790,9,1,35.658911,139.792531,H1-01.豊洲ＩＨＩビル前（晴海通り）,2024-02-08T19:00:27.321000Z,1707418805,10
791,16,0,35.654196,139.79626,H1-02.豊洲駅,2024-02-08T19:00:27.322000Z,1707418805,16
792,3,1,35.615098,139.675954,J1-19.NTT東日本自由が丘ビル,2024-02-08T19:00:27.323000Z,1707418805,4
793,4,0,35.650732,139.72256,C2-19.広尾駅,2024-02-08T19:00:27.329000Z,1707418805,4
794,5,10,35.651987,139.830691,H1-114.東京夢の島マリーナ,2024-02-08T19:00:27.330000Z,1707418805,15
795,0,19,35.562769,139.74327,K1-71.ファミリーマート大田大森南店,2024-02-08T19:00:27.331000Z,1707418805,19
796,2,7,35.617773,139.685351,J1-20.すずめのお宿緑地公園,2024-02-08T19:00:27.332000Z,1707418805,9
797,2,12,35.650235,139.835993,H1-115.東京夢の島マリーナ 第4駐車場,2024-02-08T19:00:27.345000Z,1707418805,14
798,14,3,35.665961,139.686491,M5-10.富ヶ谷2丁目,2024-02-08T19:00:27.350000Z,1707418805,17
799,0,9,35.630694,139.690482,J1-21.中央緑地公園,2024-02-08T19:00:27.360000Z,1707418805,9
800,27,22,35.625037,139.777646,H1-116.出会い橋高架下,2024-02-08T19:00:27.361000Z,1707418805,49
801,6,0,35.656228,139.706284,M3-12.渋谷南東急ビル,2024-02-08T19:00:27.362000Z,1707418805,6
802,3,2,35.749918,139.58618,T2-01.大泉学園駅北口,2024-02-08T19:00:27.385000Z,1707418805,5
803,5,0,35.585269,139.726279,K1-06.大森駅入新井自転車駐車場,2024-02-08T19:00:27.389000Z,1707418805,5
804,0,15,35.691199,139.687966,D6-06.新宿中央公園（エコギャラリー下）,2024-02-08T19:00:27.405000Z,1707418805,15
805,13,1,35.689529,139.695995,D6-14.新宿ファーストウエスト,2024-02-08T19:00:27.413000Z,1707418805,14
806,10,1,35.69465,139.695911,D6-15.住友不動産西新宿ビル,2024-02-08T19:00:27.422000Z,1707418805,11
807,0,30,35.672361,139.829825,H1-56.南砂三丁目緑地公園西,2024-02-08T19:00:27.424000Z,1707418805,30
808,2,3,35.731791,139.588844,T2-74.扇橋公園,2024-02-08T19:00:27.425000Z,1707418805,5
809,3,1,35.675398,139.779962,B2-20.SHビル,2024-02-08T19:00:27.427000Z,1707418805,4
810,0,18,35.616364,139.749171,I1-17.東品川海上公園第2,2024-02-08T19:00:27.428000Z,1707418805,18
811,13,1,35.6214,139.741958,I1-16.品川浦,2024-02-08T19:00:27.429000Z,1707418805,14
812,5,0,35.680753,139.762069,A4-11.二重橋前駅(メトロ4番出口),2024-02-08T19:00:27.433000Z,1707418805,5
813,0,19,35.638571,139.78829,H1-76.有明物流センター,2024-02-08T19:00:27.434000Z,1707418805,19
814,0,14,35.600707,139.703216,K1-43.北馬込わくわく公園,2024-02-08T19:00:27.437000Z,1707418805,14
815,11,3,35.58849,139.70376,K1-42.馬込西公園,2024-02-08T19:00:27.442000Z,1707418805,14
816,4,0,35.756506,139.620347,T1-08.セブン-イレブン 練馬高松6丁目店,2024-02-08T19:00:27.263000Z,1707418805,4
817,0,6,35.74755,139.597968,T2-17.ファミリーマート 練馬石神井町八丁目店,2024-02-08T19:00:27.444000Z,1707418805,6
818,0,12,35.546252,139.731708,K1-31.テクノWING,2024-02-08T19:00:27.445000Z,1707418805,12
819,5,0,35.601958,139.682876,K1-32.石川町文化センター,2024-02-08T19:00:27.446000Z,1707418805,5
820,9,11,35.59632,139.751279,I1-20.しおじ公園,2024-02-08T19:00:27.451000Z,1707418805,20
821,7,0,35.607571,139.749108,I1-19.品川シーサイド公園第2,2024-02-08T19:00:27.452000Z,1707418805,7
822,2,3,35.626121,139.688576,J1-29.カスタリア目黒鷹番,2024-02-08T19:00:27.453000Z,1707418805,5
823,0,38,35.669291,139.795364,H1-127.古石場川親水公園,2024-02-08T19:00:27.454000Z,1707418805,38
824,0,14,35.700732,139.711472,D4-05.カスタリア新宿7丁目,2024-02-08T19:00:27.455000Z,1707418805,14
825,0,4,35.596483,139.7355,I1-71.セブン-イレブン南大井浜川店,2024-02-08T19:00:27.456000Z,1707418805,4
826,0,22,35.600081,139.728193,I1-72.セブン-イレブン大井店,2024-02-08T19:00:27.457000Z,1707418805,22
827,4,1,35.747038,139.667965,T3-21.くまのやま緑地,2024-02-08T19:00:27.458000Z,1707418805,5
828,9,5,35.550479,139.739538,K1-110.萩中集会所裏,2024-02-08T19:00:27.459000Z,1707418805,14
829,30,0,35.708265,139.612703,O2-02.シエール荻窪,2024-02-08T19:00:27.460000Z,1707418805,30
830,30,4,35.645162,139.785386,H1-128.豊洲市場（5街区）,2024-02-08T19:00:27.465000Z,1707418805,34
831,1,4,35.716184,139.643905,N1-09.若宮レジデンス,2024-02-08T19:00:27.466000Z,1707418805,5
832,0,15,35.683156,139.67338,M6-12.LIVART SEASON 幡ヶ谷,2024-02-08T19:00:27.467000Z,1707418805,15
833,0,18,35.660632,139.817294,H1-142.東京ベイ潮見プリンスホテル,2024-02-08T19:00:27.468000Z,1707418805,18
834,1,8,35.732291,139.82012,G1-01.鐘ヶ淵駅南自転車駐車場,2024-02-08T19:00:27.469000Z,1707418805,9
835,8,0,35.66362,139.69801,M1-01.渋谷区役所,2024-02-08T19:00:27.470000Z,1707418805,8
836,0,25,35.600161,139.749902,I1-83.かもめ歩道橋,2024-02-08T19:00:27.470000Z,1707418805,25
837,3,2,35.693815,139.668571,N4-05.セブン-イレブン中野鍋横店,2024-02-08T19:00:28.045000Z,1707418805,5
838,7,0,35.694927,139.731328,D4-02.JICA市ヶ谷ビル（地球ひろば／研究所）,2024-02-08T19:00:27.478000Z,1707418805,7
839,1,4,35.749388,139.651824,T3-19.なかみや児童遊園,2024-02-08T19:00:27.481000Z,1707418805,5
840,2,5,35.729056,139.627864,N1-08.上鷺自転車保管場所,2024-02-08T19:00:27.481000Z,1707418805,7
841,2,11,35.686015,139.642784,O7-06.松木1丁目,2024-02-08T19:00:27.482000Z,1707418805,13
842,1,6,35.723723,139.740143,E4-16.ビレッジワン,2024-02-08T19:00:27.483000Z,1707418805,7
843,3,6,35.68768,139.71937,D1-15.フロンティア四谷,2024-02-08T19:00:27.484000Z,1707418805,9
844,1,14,35.571975,139.732137,K1-128.大森西3丁目,2024-02-08T19:00:27.488000Z,1707418805,15
845,0,5,35.713562,139.649075,N1-06.大和区民活動センター,2024-02-08T19:00:27.489000Z,1707418805,5
846,1,6,35.69566,139.79214,G4-01.両国ビューホテル1,2024-02-08T19:00:27.490000Z,1707418805,7
847,0,8,35.69562,139.79206,G4-02.両国ビューホテル2,2024-02-08T19:00:27.491000Z,1707418805,8
848,18,2,35.698588,139.792946,G4-05.両国駅西口臨時自転車駐車場,2024-02-08T19:00:27.492000Z,1707418805,20
849,11,3,35.702525,139.796632,G4-03.本所1-6-5,2024-02-08T19:00:27.493000Z,1707418805,14
850,15,2,35.693059,139.813417,G5-01.牡丹橋自転車駐車場,2024-02-08T19:00:27.494000Z,1707418805,17
851,17,20,35.70378,139.814298,G5-02.横川3-7-10,2024-02-08T19:00:27.500000Z,1707418805,37
852,14,7,35.697898,139.795345,G4-04.NTTドコモ墨田ビル,2024-02-08T19:00:27.501000Z,1707418805,21
853,1,6,35.710111,139.81488,G2-02.押上1-23-8,2024-02-08T19:00:27.502000Z,1707418805,7
854,9,30,35.638245,139.749754,C5-13.区立芝浦西運河沿緑地,2024-02-08T19:00:27.503000Z,1707418805,39
855,0,3,35.69342,139.710568,D6-12.東京ビジネスホテル,2024-02-08T19:00:27.504000Z,1707418805,3
856,0,6,35.693029,139.711327,D6-11.ホテルリステル新宿,2024-02-08T19:00:27.505000Z,1707418805,6
857,3,0,35.694201,139.707047,D6-10.ホテルサンライト新宿,2024-02-08T19:00:27.506000Z,1707418805,3
858,22,3,35.645823,139.812178,H1-39.辰巳駅東口自転車駐車場,2024-02-08T19:00:27.507000Z,1707418805,25
859,89,0,35.646857,139.808912,H1-38.辰巳駅西口自転車駐車場,2024-02-08T19:00:27.508000Z,1707418805,89
860,0,7,35.655865,139.730566,C2-10.元麻布三丁目,2024-02-08T19:00:27.509000Z,1707418805,7
861,2,0,35.660614,139.734771,C2-09.麻布地区総合支所,2024-02-08T19:00:27.512000Z,1707418805,2
862,8,0,35.65494,139.70534,M3-20.東急ステイ渋谷新南口,2024-02-08T19:00:27.513000Z,1707418805,8
863,3,0,35.601694,139.719778,I1-86.ファミリーマート二葉三丁目店,2024-02-08T19:00:27.514000Z,1707418805,3
864,7,0,35.696126,139.763297,A2-23.axle御茶ノ水,2024-02-08T19:00:27.515000Z,1707418805,7
865,5,0,35.63756,139.724981,C4-02.白金台いきいきプラザ,2024-02-08T19:00:26.663000Z,1707418805,5
866,0,13,35.707883,139.683284,N3-04.東中野駅地下駐輪場,2024-02-08T19:00:27.524000Z,1707418805,13
867,0,6,35.698068,139.682781,N3-05.中野坂上駅地下駐輪場,2024-02-08T19:00:27.525000Z,1707418805,6
868,0,15,35.697024,139.677846,N3-03.青桐公園,2024-02-08T19:00:27.526000Z,1707418805,15
869,6,4,35.708487,139.662135,N3-01.中野四季の森公園,2024-02-08T19:00:27.527000Z,1707418805,10
870,1,9,35.69693,139.672721,N4-01.本四公園,2024-02-08T19:00:27.528000Z,1707418805,10
871,0,11,35.686474,139.671383,N4-02.栄町公園,2024-02-08T19:00:27.529000Z,1707418805,11
872,5,1,35.579585,139.705377,K1-57.池上本門寺,2024-02-08T19:00:27.529000Z,1707418805,6
873,15,0,35.666213,139.760907,C1-49.汐留シティセンター,2024-02-08T19:00:27.531000Z,1707418805,15
874,0,13,35.642771,139.733046,C4-15.クロスレジデンス白金高輪,2024-02-08T19:00:27.531000Z,1707418805,13
875,0,9,35.588106,139.718852,K1-56.NTT馬込ビル,2024-02-08T19:00:27.536000Z,1707418805,9
876,0,9,35.631319,139.70237,J1-41.CASSIA目黒,2024-02-08T19:00:27.540000Z,1707418805,9
877,6,0,35.696147,139.753709,A2-22.専修大学,2024-02-08T19:00:27.541000Z,1707418805,6
878,2,2,35.75312,139.65661,T3-20.はやいち公園,2024-02-08T19:00:27.542000Z,1707418805,4
879,9,0,35.67363,139.77623,B3-19.本の森ちゅうおう,2024-02-08T19:00:27.544000Z,1707418805,9
880,22,0,35.556267,139.727246,K1-86.IMPREST STAY TOKYO 蒲田,2024-02-08T19:00:27.544000Z,1707418805,22
881,3,1,35.756575,139.669689,T3-23.氷川台二丁目緑地,2024-02-08T19:00:27.545000Z,1707418805,4
882,1,2,35.750547,139.66707,T3-22.氷川台三丁目ちびっこ公園,2024-02-08T19:00:27.551000Z,1707418805,3
883,3,4,35.679616,139.784341,B1-23.NANAEI日本橋,2024-02-08T19:00:27.552000Z,1707418805,7
884,12,0,35.677576,139.769822,B2-11.京橋エドグラン,2024-02-08T19:00:27.553000Z,1707418805,12
885,2,3,35.7266,139.62948,N1-05.大野ハイツ,2024-02-08T19:00:27.554000Z,1707418805,5
886,10,0,35.680203,139.778679,B2-09.茅場町一丁目平和ビル,2024-02-08T19:00:27.555000Z,1707418805,10
887,9,0,35.681012,139.778569,B2-08.共同ビル（茅場町交差点前）,2024-02-08T19:00:27.560000Z,1707418805,9
888,1,0,35.680864,139.779331,B2-07.東京証券会館（北側）,2024-02-08T19:00:27.561000Z,1707418805,1
889,0,3,35.696567,139.610517,O3-12.大宮前体育館,2024-02-08T19:00:27.562000Z,1707418805,3
890,0,19,35.688038,139.786561,B1-08.明治座,2024-02-08T19:00:27.563000Z,1707418805,19
891,0,28,35.654165,139.781568,B4-05.ドコモ・バイクシェア晴海ポート,2024-02-08T19:00:27.564000Z,1707418805,28
892,0,0,35.65443,139.77843,B4-04.ＫＤＸ晴海ビル,2024-02-08T19:00:27.565000Z,1707418805,0
893,3,13,35.658665,139.782553,B4-03.桜の散歩道（晴海トリトンスクエア前）,2024-02-08T19:00:27.566000Z,1707418805,16
894,2,3,35.727778,139.756296,E5-08.セブン-イレブン 文京動坂上店,2024-02-08T19:00:27.568000Z,1707418805,5
895,6,9,35.669507,139.825553,H1-65.ローソン南砂日曹橋店,2024-02-08T19:00:27.571000Z,1707418805,15
896,0,8,35.687732,139.846383,H1-66.中川船番所資料館,2024-02-08T19:00:27.572000Z,1707418805,8
897,1,6,35.594658,139.700133,K1-113.ファミリーマート大田上池台四丁目店,2024-02-08T19:00:27.573000Z,1707418805,7
898,9,1,35.640228,139.804267,H1-64.ローソン東雲駅前店,2024-02-08T19:00:27.574000Z,1707418805,10
899,12,3,35.703914,139.747061,E1-11.小石川運動場前,2024-02-08T19:00:27.575000Z,1707418805,15
900,2,2,35.720318,139.570762,T2-70.三ツ塚けやき緑地,2024-02-08T19:00:27.576000Z,1707418805,4
901,21,0,35.638985,139.793653,H1-137.住友不動産ショッピングシティ有明ガーデン,2024-02-08T19:00:27.581000Z,1707418805,21
902,3,1,35.64096,139.75754,C5-40.芝浦ふ頭駅前暫定自転車駐車場,2024-02-08T19:00:27.582000Z,1707418805,4
903,12,0,35.65618,139.69612,M3-21.渋谷ソラスタ,2024-02-08T19:00:27.583000Z,1707418805,12
904,20,11,35.715645,139.687486,D7-03.中井駅北,2024-02-08T19:00:27.584000Z,1707418805,31
905,3,1,35.58223,139.72763,K1-119.シーンズ大森パークサイド,2024-02-08T19:00:27.585000Z,1707418805,4
906,0,2,35.67741,139.67383,M6-15.cova Hatagaya,2024-02-08T19:00:27.586000Z,1707418805,2
907,32,10,35.661783,139.737242,C2-25.アパホテル＆リゾート＜六本木駅東＞,2024-02-08T19:00:27.587000Z,1707418805,42
908,1,5,35.696585,139.713081,D4-10.東新宿ポート(余丁町6番),2024-02-08T19:00:27.588000Z,1707418805,6
909,7,7,35.72424,139.61431,O1-02.井荻南地下自転車駐車場,2024-02-08T19:00:27.589000Z,1707418805,14
910,0,4,35.72489,139.62383,O1-03.LUCKY HOUSE,2024-02-08T19:00:27.590000Z,1707418805,4
911,6,1,35.6897,139.694823,D6-30.京王プラザホテル,2024-02-08T19:00:27.596000Z,1707418805,7
912,13,0,35.688735,139.692249,D6-29.都庁第二本庁舎前,2024-02-08T19:00:27.598000Z,1707418805,13
913,6,2,35.71355,139.6199,O3-02.アートメゾン荻窪,2024-02-08T19:00:27.599000Z,1707418805,8
914,5,0,35.606667,139.667324,J1-57.トレインチ自由が丘,2024-02-08T19:00:27.600000Z,1707418805,5
915,10,1,35.70535,139.61497,O2-01.サカエフラット荻窪,2024-02-08T19:00:27.602000Z,1707418805,11
916,1,6,35.69575,139.62065,O3-01.西田公園,2024-02-08T19:00:27.603000Z,1707418805,7
917,7,4,35.598601,139.684747,K1-47.NTT雪ヶ谷ビル,2024-02-08T19:00:27.604000Z,1707418805,11
918,9,0,35.529519,139.704845,Z17.NTT川崎ビル,2024-02-08T19:00:27.704000Z,1707418805,9
919,7,1,35.67161,139.64527,O7-04.永福町西幸モータープール西,2024-02-08T19:00:27.607000Z,1707418805,8
920,0,25,35.590934,139.696915,K1-48.ファミリーマート大田上池台三丁目店,2024-02-08T19:00:27.613000Z,1707418805,25
921,4,3,35.546499,139.736761,K1-111.本羽田公園,2024-02-08T19:00:27.614000Z,1707418805,7
922,3,7,35.655937,139.763251,C1-58.ウォーターズ竹芝,2024-02-08T19:00:27.615000Z,1707418805,10
923,8,0,35.549323,139.737091,K1-109.萩中公園プール駐輪場,2024-02-08T19:00:27.617000Z,1707418805,8
924,2,2,35.557999,139.732564,K1-108.仲江名公園,2024-02-08T19:00:27.618000Z,1707418805,4
925,1,9,35.713913,139.745416,E1-17.小石川パークスクエア,2024-02-08T19:00:27.619000Z,1707418805,10
926,0,0,35.697535,139.703633,D6-23.アパホテル 東新宿 歌舞伎町西,2024-02-08T19:00:27.621000Z,1707418805,0
927,0,35,35.668705,139.810549,H1-98.洲崎川緑道公園,2024-02-08T19:00:27.628000Z,1707418805,35
928,18,6,35.669695,139.831874,H1-99.南砂三丁目公園,2024-02-08T19:00:27.629000Z,1707418805,24
929,0,19,35.668757,139.790156,H1-96.越中島公園,2024-02-08T19:00:27.631000Z,1707418805,19
930,0,17,35.661852,139.802224,H1-97.浜園公園,2024-02-08T19:00:27.632000Z,1707418805,17
931,8,1,35.64423,139.835823,H1-94.新木場一丁目緑地公園,2024-02-08T19:00:27.633000Z,1707418805,9
932,7,17,35.619451,139.834429,H1-95.若洲公園,2024-02-08T19:00:27.635000Z,1707418805,24
933,2,3,35.629252,139.712716,J1-09.ファミリーマート佐野久下目黒店,2024-02-08T19:00:27.636000Z,1707418805,5
934,7,0,35.64143,139.835455,H1-93.新木場一丁目公園,2024-02-08T19:00:27.637000Z,1707418805,7
935,0,21,35.593559,139.734704,I1-55.鈴ヶ森公園,2024-02-08T19:00:27.639000Z,1707418805,21
936,0,5,35.67834,139.62711,O6-04.柏の宮公園,2024-02-08T19:00:27.640000Z,1707418805,5
937,0,21,35.660526,139.776816,B4-14.Brillia ist Tower 勝どき,2024-02-08T19:00:27.645000Z,1707418805,21
938,3,10,35.71115,139.68232,D7-08.上落合3丁目,2024-02-08T19:00:27.646000Z,1707418805,13
939,0,91,35.646041,139.804495,H1-21.UR東雲キャナルコート,2024-02-08T19:00:27.647000Z,1707418805,91
940,23,7,35.619377,139.777582,H1-20.日本科学未来館,2024-02-08T19:00:27.648000Z,1707418805,30
941,12,9,35.653603,139.80144,H1-19.UR豊洲四丁目団地,2024-02-08T19:00:27.650000Z,1707418805,21
942,0,7,35.771068,139.586798,T2-45.風致地区バス停第三自転車駐車場,2024-02-08T19:00:27.651000Z,1707418805,7
943,0,27,35.66789,139.803,H1-33.深川ギャザリア（ウエストスクエア）,2024-02-08T19:00:27.652000Z,1707418805,27
944,0,24,35.664591,139.813954,H1-32.区営塩浜住宅前,2024-02-08T19:00:27.653000Z,1707418805,24
945,10,4,35.648085,139.798986,H1-23.KDX豊洲グランスクエア,2024-02-08T19:00:27.661000Z,1707418805,14
946,9,1,35.655649,139.74427,C2-22.飯倉公園,2024-02-08T19:00:27.662000Z,1707418805,10
947,5,0,35.608402,139.726118,I1-89.下神明駅自転車駐車場,2024-02-08T19:00:27.663000Z,1707418805,5
948,11,2,35.631021,139.778109,C5-39.お台場海浜公園東,2024-02-08T19:00:27.664000Z,1707418805,13
949,0,15,35.628743,139.773915,C5-38.お台場海浜公園乗船場,2024-02-08T19:00:27.666000Z,1707418805,15
950,0,5,35.703203,139.62804,O4-08.ローソン阿佐ヶ谷青梅街道店,2024-02-08T19:00:27.667000Z,1707418805,5
951,5,1,35.733132,139.570311,T2-72.高塚南緑地,2024-02-08T19:00:26.533000Z,1707418805,6
952,6,4,35.68073,139.62803,O6-03.みなみ荘,2024-02-08T19:00:28.369000Z,1707418805,10
953,0,8,35.557427,139.739126,K1-129.ローソン東糀谷一丁目店,2024-02-08T19:00:27.672000Z,1707418805,8
954,8,0,35.70319,139.751888,E1-03.東京ドーム（黄色いビル横）,2024-02-08T19:00:27.681000Z,1707418805,8
955,7,0,35.561183,139.716339,K1-23.大田区役所本庁舎前,2024-02-08T19:00:27.682000Z,1707418805,7
956,1,2,35.761474,139.592735,T2-78.北大泉くれはし公園,2024-02-08T19:00:27.684000Z,1707418805,3
957,3,2,35.612833,139.675047,J1-53.ボヌールAllamanda,2024-02-08T19:00:27.685000Z,1707418805,5
958,0,4,35.694834,139.780333,A3-39.トーシン東神田ビル,2024-02-08T19:00:27.686000Z,1707418805,4
959,4,5,35.67912,139.61074,O6-01.高井戸みどり公園,2024-02-08T19:00:28.388000Z,1707418805,9
960,4,2,35.774457,139.596182,T2-79.大泉学園町八丁目緑地,2024-02-08T19:00:27.687000Z,1707418805,6
961,17,3,35.70104,139.65839,O5-04.リヴィエール,2024-02-08T19:00:27.689000Z,1707418805,20
962,6,0,35.707968,139.663519,N3-08.中野区役所(西側),2024-02-08T19:00:27.691000Z,1707418805,6
963,3,3,35.61663,139.74192,I1-99.北品川２丁目,2024-02-08T19:00:27.693000Z,1707418805,6
964,7,0,35.728846,139.718577,P1-01.サンシャインシティ,2024-02-08T19:00:27.694000Z,1707418805,7
965,0,6,35.713227,139.680966,N3-14.ヴィラソンサ落合,2024-02-08T19:00:27.695000Z,1707418805,6
966,0,20,35.667892,139.8311,H1-49.セブン-イレブン 江東新砂３丁目店,2024-02-08T19:00:27.701000Z,1707418805,20
967,9,0,35.593489,139.72967,I1-06.大森貝塚遺跡庭園,2024-02-08T19:00:27.702000Z,1707418805,9
968,8,1,35.650541,139.713361,M2-12.恵比寿プライムスクエアタワー北,2024-02-08T19:00:27.705000Z,1707418805,9
969,0,32,35.680474,139.812316,H1-69.ファミリーマート 江東石島店,2024-02-08T19:00:27.706000Z,1707418805,32
970,0,15,35.66523,139.776313,B3-09.築地永谷コーポラス,2024-02-08T19:00:27.708000Z,1707418805,15
971,2,9,35.720349,139.746924,E4-10.白山四丁目第二児童遊園横,2024-02-08T19:00:27.709000Z,1707418805,11
972,7,0,35.605617,139.73472,I1-03.大井町駅中央口（西側）,2024-02-08T19:00:27.716000Z,1707418805,7
973,5,0,35.605146,139.734694,I1-04.大井町歩道橋,2024-02-08T19:00:27.718000Z,1707418805,5
974,10,0,35.609052,139.729825,I1-01.品川区役所 本庁舎前,2024-02-08T19:00:27.719000Z,1707418805,10
975,9,0,35.608161,139.730048,I1-02.品川区役所 第三庁舎前,2024-02-08T19:00:27.720000Z,1707418805,9
976,0,6,35.691677,139.793857,G4-08.ブオンサンヴァレンティーノ,2024-02-08T19:00:27.722000Z,1707418805,6
977,13,4,35.61061,139.693443,J1-13.洗足二丁目駐輪場,2024-02-08T19:00:27.723000Z,1707418805,17
978,2,4,35.617353,139.672256,J1-16.八雲橋自転車置場,2024-02-08T19:00:27.724000Z,1707418805,6
979,0,35,35.634453,139.824,H1-189.MFLP新木場2,2024-02-08T19:00:27.725000Z,1707418805,35
980,0,9,35.683756,139.684965,M6-09.ファミリーマート渋谷本町店,2024-02-08T19:00:27.727000Z,1707418805,9
981,0,36,35.646366,139.801492,H1-113.123+N東雲店,2024-02-08T19:00:27.732000Z,1707418805,36
982,0,6,35.613902,139.691476,J1-17.ファミリーマート原町二丁目店,2024-02-08T19:00:27.733000Z,1707418805,6
983,1,10,35.73176,139.756669,E5-21.動坂公園,2024-02-08T19:00:27.735000Z,1707418805,11
984,0,8,35.704391,139.758575,E5-20.本郷2丁目,2024-02-08T19:00:27.736000Z,1707418805,8
985,1,3,35.726064,139.578015,T2-48.武蔵関駅南第二自転車駐車場,2024-02-08T19:00:26.833000Z,1707418805,4
986,6,3,35.683378,139.743189,A6-26.相互半蔵門ビル,2024-02-08T19:00:27.740000Z,1707418805,9
987,13,7,35.634194,139.688833,J1-31.守屋図書館,2024-02-08T19:00:26.176000Z,1707418805,20
988,20,1,35.662146,139.702793,M3-19.渋谷キャスト,2024-02-08T19:00:27.752000Z,1707418805,21
989,0,10,35.721679,139.645265,N1-04.都立家政南駐輪場,2024-02-08T19:00:27.753000Z,1707418805,10
990,0,11,35.529781,139.727511,Z09.ファミリーマート川崎川中島二丁目店,2024-02-08T19:00:27.756000Z,1707418805,11
991,0,3,35.724988,139.672511,N2-02.江古田1丁目A,2024-02-08T19:00:27.765000Z,1707418805,3
992,3,2,35.654873,139.762103,C1-56.鈴与竹芝ビル,2024-02-08T19:00:27.766000Z,1707418805,5
993,6,1,35.71429,139.70507,D3-07.戸塚特別出張所,2024-02-08T19:00:27.767000Z,1707418805,7
994,0,7,35.70103,139.803341,G4-12.プレミアムキューブ両国,2024-02-08T19:00:27.769000Z,1707418805,7
995,7,0,35.694578,139.754434,A2-21.神田神保町3丁目,2024-02-08T19:00:27.770000Z,1707418805,7
996,0,26,35.668044,139.785801,B4-19.コーシャタワー佃,2024-02-08T19:00:27.772000Z,1707418805,26
997,16,4,35.608127,139.717865,I1-81.戸越6丁目,2024-02-08T19:00:27.789000Z,1707418805,20
998,0,15,35.682218,139.743292,A6-24.国立劇場,2024-02-08T19:00:27.797000Z,1707418805,15
999,0,6,35.722353,139.760966,E5-23.ビレッジ千駄木,2024-02-08T19:00:27.803000Z,1707418805,6
1000,0,6,35.638319,139.834741,H1-119.榎戸材木店,2024-02-08T19:00:27.804000Z,1707418805,6
1001,7,1,35.651672,139.760549,C5-29.Hi-NODE(ハイノード),2024-02-08T19:00:27.806000Z,1707418805,8
1002,0,4,35.627373,139.692044,J1-22.NTTコミュニケーションズ唐ヶ崎ビル,2024-02-08T19:00:27.807000Z,1707418805,4
1003,5,1,35.698654,139.759762,A2-18.猿楽町SSビル東,2024-02-08T19:00:27.809000Z,1707418805,6
1004,2,0,35.698641,139.759306,A2-19.猿楽町SSビル西,2024-02-08T19:00:27.817000Z,1707418805,2
1005,19,1,35.669267,139.756018,C1-55.アーバンネット内幸町ビル,2024-02-08T19:00:27.821000Z,1707418805,20
1006,0,12,35.697143,139.718739,D4-06.グリーンフォート河田,2024-02-08T19:00:26.401000Z,1707418805,12
1007,3,7,35.588363,139.69042,K1-134.東調布公園,2024-02-08T19:00:27.823000Z,1707418805,10
1008,21,0,35.533627,139.700527,Z12.京急川崎西口駐輪場B,2024-02-08T19:00:27.825000Z,1707418805,21
1009,0,5,35.679182,139.68596,M5-18.Luxe初台,2024-02-08T19:00:27.826000Z,1707418805,5
1010,3,2,35.721064,139.677128,D7-06.エムアイセミナーハウス,2024-02-08T19:00:27.827000Z,1707418805,5
1011,0,24,35.695737,139.78162,A3-37.ポータル秋葉原,2024-02-08T19:00:27.829000Z,1707418805,24
1012,9,0,35.688154,139.698975,M5-11.あおい通り,2024-02-08T19:00:27.830000Z,1707418805,9
1013,0,5,35.727046,139.760439,E5-04.保健サービスセンター本郷支所,2024-02-08T19:00:27.831000Z,1707418805,5
1014,0,5,35.725538,139.76116,E5-03.汐見地域活動センター（本郷図書館）,2024-02-08T19:00:27.840000Z,1707418805,5
1015,31,0,35.708121,139.763583,E5-01.文京総合体育館,2024-02-08T19:00:27.913000Z,1707418805,31
1016,5,20,35.72707,139.746112,E4-01.千石南自転車駐車場,2024-02-08T19:00:27.846000Z,1707418805,25
1017,5,16,35.724286,139.730954,E3-03.大塚公園,2024-02-08T19:00:27.848000Z,1707418805,21
1018,5,12,35.719345,139.736198,E3-02.教育の森公園,2024-02-08T19:00:27.850000Z,1707418805,17
1019,0,3,35.607084,139.705007,I1-25.セブン-イレブン 品川旗の台2丁目店,2024-02-08T19:00:27.851000Z,1707418805,3
1020,9,1,35.680861,139.774493,B1-21.日本橋二丁目街角広場,2024-02-08T19:00:27.853000Z,1707418805,10
1021,9,0,35.672652,139.738908,C3-30.東京赤坂NKビル (ヴィアインプライム赤坂),2024-02-08T19:00:27.854000Z,1707418805,9
1022,0,5,35.694943,139.782718,A3-36.クロックカフェ東神田,2024-02-08T19:00:27.860000Z,1707418805,5
1023,0,9,35.711147,139.747386,E1-14.いきいき礫川,2024-02-08T19:00:27.862000Z,1707418805,9
1024,0,15,35.69617,139.722021,D4-09.トミンハイム仲之町,2024-02-08T19:00:27.868000Z,1707418805,15
1025,0,6,35.63534,139.601602,L1-08.NTT砧ビル,2024-02-08T19:00:27.869000Z,1707418805,6
1026,1,3,35.632689,139.654804,L1-09.コージーK・駒沢,2024-02-08T19:00:27.870000Z,1707418805,4
1027,0,6,35.652913,139.644825,L1-10.宮坂2-4-10,2024-02-08T19:00:27.873000Z,1707418805,6
1028,2,3,35.596579,139.745009,I1-22.ウィラ大井 (ショッピングモール),2024-02-08T19:00:27.876000Z,1707418805,5
1029,9,0,35.585178,139.726339,K1-76.グリーンベルト,2024-02-08T19:00:27.880000Z,1707418805,9
1030,0,42,35.676603,139.829736,H1-121.南砂5丁目,2024-02-08T19:00:27.881000Z,1707418805,42
1031,5,0,35.65558,139.69966,M3-02.文化総合センター大和田,2024-02-08T19:00:27.883000Z,1707418805,5
1032,0,6,35.700033,139.71983,D4-04.ジェノヴィア新宿早稲田グリーンヴェール,2024-02-08T19:00:27.884000Z,1707418805,6
1033,1,1,35.695005,139.772747,A3-20.神田ふれあい通り第２,2024-02-08T19:00:27.889000Z,1707418805,2
1034,17,1,35.650948,139.799711,H1-120.豊洲5丁目,2024-02-08T19:00:27.892000Z,1707418805,18
1035,1,7,35.644241,139.753834,C5-42.DHC芝浦2丁目ビル,2024-02-08T19:00:27.897000Z,1707418805,8
1036,7,0,35.605996,139.743037,I1-65.セブン-イレブン品川東大井1丁目店,2024-02-08T19:00:27.897000Z,1707418805,7
1037,5,1,35.653382,139.721059,M2-04.広尾東公園,2024-02-08T19:00:27.898000Z,1707418805,6
1038,18,1,35.657682,139.703307,M3-13.渋谷駅東口地下駐輪場,2024-02-08T19:00:27.899000Z,1707418805,19
1039,0,6,35.694904,139.772712,A3-19.神田ふれあい通り第１,2024-02-08T19:00:27.900000Z,1707418805,6
1040,1,4,35.689639,139.613516,O6-07.ローソン杉並宮前一丁目店,2024-02-08T19:00:27.905000Z,1707418805,5
1041,0,3,35.736378,139.632485,T3-10.貫井一丁目緑地,2024-02-08T19:00:27.905000Z,1707418805,3
1042,1,9,35.65519,139.718559,M2-05.日本赤十字医療センター,2024-02-08T19:00:27.906000Z,1707418805,10
1043,0,13,35.741769,139.591103,T2-20.パークサイド石神井,2024-02-08T19:00:27.907000Z,1707418805,13
1044,0,7,35.695819,139.674326,N4-06.ローソン中野本町新橋通り店,2024-02-08T19:00:26.252000Z,1707418805,7
1045,3,1,35.726728,139.65874,T3-07.徳殿公園,2024-02-08T19:00:27.921000Z,1707418805,4
1046,0,13,35.549778,139.707362,K1-35.セブン-イレブン 大田区西六郷2丁目店,2024-02-08T19:00:27.921000Z,1707418805,13
1047,7,3,35.698986,139.774099,A3-27.秋葉原駅中央口（ヨドバシカメラ前）,2024-02-08T19:00:27.922000Z,1707418805,10
1048,5,0,35.699173,139.772629,A3-28.秋葉原駅電気街口(西側交通広場),2024-02-08T19:00:27.923000Z,1707418805,5
1049,10,55,35.64508,139.826456,H1-57.新木場駅,2024-02-08T19:00:27.924000Z,1707418805,65
1050,0,26,35.658703,139.817251,H1-58.潮見駅,2024-02-08T19:00:27.925000Z,1707418805,26
1051,0,15,35.722202,139.691712,D7-02.セブン-イレブン 新宿中落合3丁目店,2024-02-08T19:00:27.928000Z,1707418805,15
1052,13,1,35.70057,139.74301,D2-06.飯田濠,2024-02-08T19:00:27.944000Z,1707418805,14
1053,5,4,35.651103,139.759092,C5-17.鈴与浜松町ビル,2024-02-08T19:00:27.945000Z,1707418805,9
1054,0,24,35.681316,139.792176,H1-59.LYURO 東京清澄,2024-02-08T19:00:27.946000Z,1707418805,24
1055,0,30,35.679678,139.844892,H1-60.荒川・砂町庭球場西,2024-02-08T19:00:27.947000Z,1707418805,30
1056,0,7,35.594795,139.704951,K1-44.中馬込貝塚公園,2024-02-08T19:00:27.952000Z,1707418805,7
1057,0,5,35.674337,139.668801,M6-11.京王サイクルパーク笹塚,2024-02-08T19:00:27.968000Z,1707418805,5
1058,1,3,35.638864,139.696568,J1-49.伊勢脇公園,2024-02-08T19:00:27.969000Z,1707418805,4
1059,1,7,35.592801,139.715472,K1-45.たぬき山公園,2024-02-08T19:00:27.970000Z,1707418805,8
1060,12,6,35.702286,139.741093,D2-01.あずさセンタービル,2024-02-08T19:00:27.970000Z,1707418805,18
1061,4,1,35.668791,139.753582,C1-02.西新橋1丁目（外堀通り）,2024-02-08T19:00:26.716000Z,1707418805,5
1062,2,1,35.714044,139.61688,O3-07.NTT井草ビル第1ポート,2024-02-08T19:00:27.996000Z,1707418805,3
1063,0,4,35.74248,139.58715,T2-41.ローソン 練馬東大泉五丁目店,2024-02-08T19:00:27.997000Z,1707418805,4
1064,0,17,35.674199,139.822018,H1-144.南砂住宅,2024-02-08T19:00:27.999000Z,1707418805,17
1065,11,0,35.672477,139.739743,C3-28.ヒューリックＪＰ赤坂ビル,2024-02-08T19:00:28.001000Z,1707418805,11
1066,0,16,35.643131,139.797784,H1-145.東雲都橋住宅,2024-02-08T19:00:28.010000Z,1707418805,16
1067,18,0,35.609664,139.730006,I1-58.品川区役所　第二庁舎前,2024-02-08T19:00:28.013000Z,1707418805,18
1068,25,0,35.561101,139.715173,K1-92.蒲田駅西口自転車駐車場,2024-02-08T19:00:28.016000Z,1707418805,25
1069,6,0,35.702271,139.752619,A2-24.水道橋駅西口前,2024-02-08T19:00:28.017000Z,1707418805,6
1070,0,25,35.572188,139.749613,K1-94.昭和島駅前,2024-02-08T19:00:28.019000Z,1707418805,25
1071,18,2,35.686567,139.699355,M5-15.新宿マインズタワー,2024-02-08T19:00:28.024000Z,1707418805,20
1072,11,4,35.71936,139.679083,D7-13.日本光電本社南側,2024-02-08T19:00:28.025000Z,1707418805,15
1073,5,0,35.708259,139.663829,N3-09.中野区役所(北側),2024-02-08T19:00:28.029000Z,1707418805,5
1074,2,3,35.68663,139.799529,H1-163.森下公園,2024-02-08T19:00:28.037000Z,1707418805,5
1075,0,15,35.653771,139.769295,B4-23.交通広場（豊海町）,2024-02-08T19:00:28.038000Z,1707418805,15
1076,5,1,35.689689,139.698231,D6-18.ヨドバシカメラ 新宿西口本店前,2024-02-08T19:00:28.038000Z,1707418805,6
1077,7,0,35.630151,139.725215,I1-47.NTT 東日本 関東病院(南側),2024-02-08T19:00:28.039000Z,1707418805,7
1078,0,21,35.66305,139.8087,H1-112.ファミリーマート江東塩浜二丁目店,2024-02-08T19:00:28.042000Z,1707418805,21
1079,0,7,35.594515,139.691219,K1-103.雪谷特別出張所,2024-02-08T19:00:28.043000Z,1707418805,7
1080,0,5,35.720896,139.76422,E5-17.Village藍染,2024-02-08T19:00:28.048000Z,1707418805,5
1081,7,1,35.527562,139.737102,Z04.ローソン川崎四谷上町店,2024-02-08T19:00:28.050000Z,1707418805,8
1082,0,3,35.523754,139.746356,Z03.ローソン川崎塩浜三丁目店,2024-02-08T19:00:28.053000Z,1707418805,3
1083,6,0,35.603815,139.741362,I1-49.京急鮫洲バイク駐輪場,2024-02-08T19:00:28.055000Z,1707418805,6
1084,0,12,35.599196,139.739158,I1-50.京急立会川第2バイク駐輪場,2024-02-08T19:00:28.056000Z,1707418805,12
1085,0,17,35.726188,139.741375,E4-14.NTT東日本大塚ビル,2024-02-08T19:00:28.057000Z,1707418805,17
1086,7,0,35.6471,139.712818,M2-07.ファミリーマート恵比寿駅東店,2024-02-08T19:00:28.058000Z,1707418805,7
1087,1,3,35.68082,139.71188,M4-07.千駄ヶ谷駅前,2024-02-08T19:00:28.068000Z,1707418805,4
1088,12,8,35.698169,139.655665,O5-07.バーンホーフ キクチ,2024-02-08T19:00:28.076000Z,1707418805,20
1089,0,6,35.649023,139.696086,J1-11.コンフォリア目黒青葉台,2024-02-08T19:00:28.096000Z,1707418805,6
1090,1,12,35.664335,139.590114,L1-14.給田3丁目,2024-02-08T19:00:28.099000Z,1707418805,13
1091,1,17,35.66291,139.782564,B4-06.月島駅地下駐輪場,2024-02-08T19:00:28.100000Z,1707418805,18
1092,20,1,35.643202,139.746244,C5-09.グランパーク,2024-02-08T19:00:28.102000Z,1707418805,21
1093,5,6,35.637366,139.74844,C5-08.AQUACITY芝浦,2024-02-08T19:00:28.104000Z,1707418805,11
1094,5,0,35.671792,139.733668,C3-08.赤坂パークビルヂング,2024-02-08T19:00:28.106000Z,1707418805,5
1095,17,1,35.672659,139.725644,C3-07.新青山ビル,2024-02-08T19:00:28.112000Z,1707418805,18
1096,0,12,35.67064,139.728166,C3-06.ホテルアジア会館,2024-02-08T19:00:28.121000Z,1707418805,12
1097,3,7,35.653159,139.744673,C1-24.三田国際ビル,2024-02-08T19:00:28.122000Z,1707418805,10
1098,0,36,35.632842,139.7495,C5-07.港区立港南図書館,2024-02-08T19:00:28.132000Z,1707418805,36
1099,3,14,35.697642,139.774867,A3-04.秋葉原公園,2024-02-08T19:00:28.133000Z,1707418805,17
1100,4,2,35.698817,139.778898,A3-05.和泉公園（西側入口）,2024-02-08T19:00:28.134000Z,1707418805,6
1101,8,0,35.689575,139.767848,A3-02.絶滅メディア博物館（楓ビル）,2024-02-08T19:00:28.135000Z,1707418805,8
1102,3,5,35.716265,139.618954,O3-10.メゾンパークス,2024-02-08T19:00:28.136000Z,1707418805,8
1103,1,0,35.689665,139.764091,A2-05.神田橋公園,2024-02-08T19:00:28.145000Z,1707418805,1
1104,4,2,35.692983,139.76773,A3-01.神田児童公園（西側交番横）,2024-02-08T19:00:28.145000Z,1707418805,6
1105,5,0,35.698338,139.754876,A2-03.西神田公園（西側）,2024-02-08T19:00:28.147000Z,1707418805,5
1106,0,8,35.675198,139.663587,M6-03.十三号通り公園,2024-02-08T19:00:28.157000Z,1707418805,8
1107,0,11,35.673444,139.666553,M6-02.サイカパーク笹塚,2024-02-08T19:00:28.163000Z,1707418805,11
1108,0,10,35.701318,139.825916,H1-165.亀戸梅屋敷,2024-02-08T19:00:28.164000Z,1707418805,10
1109,18,1,35.696574,139.82972,H1-166.亀戸クロック,2024-02-08T19:00:28.166000Z,1707418805,19
1110,1,3,35.684423,139.692262,M5-02.あいおいニッセイ同和損保新宿ビル,2024-02-08T19:00:28.168000Z,1707418805,4
1111,23,12,35.677175,139.676769,M6-01.幡ヶ谷駅高架下第一,2024-02-08T19:00:28.174000Z,1707418805,35
1112,4,1,35.673555,139.741293,A5-02.山王パークタワー,2024-02-08T19:00:28.176000Z,1707418805,5
1113,5,7,35.567176,139.742345,K1-116.旧呑川緑地（大森東五丁目）,2024-02-08T19:00:28.178000Z,1707418805,12
1114,0,7,35.565685,139.736195,K1-115.旧呑川緑地（大森中三丁目）,2024-02-08T19:00:28.180000Z,1707418805,7
1115,6,2,35.568722,139.680736,K1-114.下丸子公園,2024-02-08T19:00:28.183000Z,1707418805,8
1116,0,10,35.767129,139.664365,T3-05.東武練馬駅南,2024-02-08T19:00:28.185000Z,1707418805,10
1117,4,0,35.761038,139.623148,T1-14.ファミリーマート 練馬高松五丁目北店,2024-02-08T19:00:28.192000Z,1707418805,4
1118,5,2,35.674094,139.728895,C3-29.高橋是清翁記念公園,2024-02-08T19:00:28.194000Z,1707418805,7
1119,5,0,35.561291,139.715076,K1-141.蒲田駅西口歩道,2024-02-08T19:00:28.196000Z,1707418805,5
1120,17,0,35.667069,139.713423,C3-35.ワールド北青山ビル,2024-02-08T19:00:28.200000Z,1707418805,17
1121,9,7,35.671282,139.675307,M5-03.代々木大山公園,2024-02-08T19:00:28.210000Z,1707418805,16
1122,4,2,35.715592,139.76192,E5-13.弥生二丁目,2024-02-08T19:00:28.216000Z,1707418805,6
1123,0,6,35.704475,139.763041,E5-12.NK本郷ビル,2024-02-08T19:00:28.224000Z,1707418805,6
1124,10,0,35.668395,139.769849,B3-18.銀座松竹スクエア,2024-02-08T19:00:28.233000Z,1707418805,10
1125,5,1,35.64115,139.741471,C1-44.三田Avanti,2024-02-08T19:00:28.252000Z,1707418805,6
1126,0,9,35.739488,139.590273,T2-31.ファミリーマート 石神井台二丁目店,2024-02-08T19:00:28.280000Z,1707418805,9
1127,8,1,35.636978,139.791858,H1-150.ホテルヴィラフォンテーヌ南側,2024-02-08T19:00:28.304000Z,1707418805,9
1128,7,1,35.639132,139.793047,H1-149.有明ガーデン 公園口,2024-02-08T19:00:28.305000Z,1707418805,8
1129,0,17,35.694104,139.840278,H1-148.大島七丁目団地,2024-02-08T19:00:28.306000Z,1707418805,17
1130,0,14,35.654371,139.779545,B4-26.東武ストア晴海三丁目店,2024-02-08T19:00:28.307000Z,1707418805,14
1131,3,4,35.623459,139.687128,J1-26.田向公園,2024-02-08T19:00:28.313000Z,1707418805,7
1132,3,5,35.625081,139.682632,J1-25.碑文谷公園,2024-02-08T19:00:28.324000Z,1707418805,8
1133,6,13,35.65238,139.815613,H1-195.東京アクアティクスセンター,2024-02-08T19:00:28.325000Z,1707418805,19
1134,0,14,35.761613,139.61349,T1-13.ファミリーマート 練馬土支田二丁目店,2024-02-08T19:00:28.327000Z,1707418805,14
1135,0,5,35.73969,139.62125,T2-34.ファミリーマート 練馬富士見台店,2024-02-08T19:00:28.332000Z,1707418805,5
1136,0,6,35.738607,139.585331,T2-35.ファミリーマート 石神井台六丁目店,2024-02-08T19:00:28.333000Z,1707418805,6
1137,20,0,35.646534,139.748913,C1-81.田町タワー,2024-02-08T19:00:28.352000Z,1707418805,20
1138,14,1,35.641992,139.701588,J1-07.目黒川船入場,2024-02-08T19:00:28.353000Z,1707418805,15
1139,15,3,35.634533,139.708868,J1-08.目黒区民センター公園,2024-02-08T19:00:28.354000Z,1707418805,18
1140,2,4,35.695102,139.723345,D4-01.市谷仲之町,2024-02-08T19:00:28.355000Z,1707418805,6
1141,14,2,35.652151,139.698426,M2-11.鉢山町,2024-02-08T19:00:28.356000Z,1707418805,16
1142,1,8,35.720546,139.756685,E4-08.ドコモ・バイクシェア向丘ポート,2024-02-08T19:00:28.356000Z,1707418805,9
1143,0,10,35.695636,139.727882,D4-03.市谷加賀町2丁目,2024-02-08T19:00:28.357000Z,1707418805,10
1144,4,6,35.506142,139.701005,Z10.ローソン川崎浅田三丁目店,2024-02-08T19:00:26.174000Z,1707418805,10
1145,0,10,35.719717,139.64785,N1-01.BeGood野方,2024-02-08T19:00:28.361000Z,1707418805,10
1146,10,1,35.666357,139.73923,C2-03.アークヒルズサウスタワー,2024-02-08T19:00:28.363000Z,1707418805,11
1147,7,4,35.667107,139.739565,C2-01.アークヒルズ（アーク森ビル）,2024-02-08T19:00:28.367000Z,1707418805,11
1148,26,0,35.661158,139.728533,C2-02.六本木ヒルズ,2024-02-08T19:00:28.368000Z,1707418805,26
1149,7,19,35.624966,139.746657,C5-03.港南公園C,2024-02-08T19:00:28.369000Z,1707418805,26
1150,10,1,35.646801,139.751208,C5-04.みなとパーク芝浦,2024-02-08T19:00:28.374000Z,1707418805,11
1151,6,0,35.659442,139.745549,C1-16.機械振興会館,2024-02-08T19:00:28.374000Z,1707418805,6
1152,0,7,35.664461,139.756082,C1-14.新橋プラザビル,2024-02-08T19:00:28.377000Z,1707418805,7
1153,0,9,35.67386,139.79976,H1-73.イシマビル,2024-02-08T19:00:28.378000Z,1707418805,9
1154,4,1,35.67753,139.63667,O7-01.西永福公園,2024-02-08T19:00:28.379000Z,1707418805,5
1155,6,2,35.68296,139.60861,O6-02.富士見ヶ丘南自転車駐車場,2024-02-08T19:00:28.380000Z,1707418805,8
1156,6,0,35.556199,139.721476,K1-50.テクノポートカマタ 第1,2024-02-08T19:00:28.387000Z,1707418805,6
1157,39,0,35.614856,139.678208,J1-14.二の橋自転車置場1,2024-02-08T19:00:28.390000Z,1707418805,39
1158,0,3,35.714077,139.61694,O3-08.NTT井草ビル第２ポート,2024-02-08T19:00:28.405000Z,1707418805,3
1159,1,12,35.680636,139.817977,H1-124.セブン-イレブン 江東海辺店,2024-02-08T19:00:28.406000Z,1707418805,13
1160,5,0,35.679807,139.715931,D1-11.三井ガーデンホテル神宮外苑の杜プレミア,2024-02-08T19:00:28.407000Z,1707418805,5
1161,1,7,35.678913,139.639944,O7-07.ハレ永福,2024-02-08T19:00:28.409000Z,1707418805,8
1162,4,1,35.627891,139.776896,C5-32.トレードピアお台場,2024-02-08T19:00:28.410000Z,1707418805,5
1163,0,5,35.653531,139.769431,B4-18.豊海センタービル,2024-02-08T19:00:28.416000Z,1707418805,5
1164,2,5,35.707388,139.700204,D5-04.西戸山公園野球場,2024-02-08T19:00:28.418000Z,1707418805,7
1165,0,14,35.702288,139.68862,D5-03.北新宿公園,2024-02-08T19:00:28.419000Z,1707418805,14
1166,0,23,35.706182,139.723394,D3-04.鶴巻南公園,2024-02-08T19:00:28.424000Z,1707418805,23
1167,0,15,35.712431,139.715418,D3-03.甘泉園公園,2024-02-08T19:00:28.425000Z,1707418805,15
1168,0,7,35.576593,139.706597,K1-03.池上会館,2024-02-08T19:00:28.426000Z,1707418805,7
1169,11,4,35.579049,139.739878,K1-02.平和の森公園,2024-02-08T19:00:28.427000Z,1707418805,15
1170,0,12,35.57685,139.742496,K1-01.大森海苔のふるさと館,2024-02-08T19:00:28.427000Z,1707418805,12
1171,7,2,35.687652,139.689254,D6-13.新宿中央公園（ジャブジャブ池下）,2024-02-08T19:00:28.434000Z,1707418805,9
1172,3,2,35.752217,139.571095,T2-28.ファミリーマート 南大泉六丁目店,2024-02-08T19:00:28.435000Z,1707418805,5
1173,13,4,35.581832,139.741581,K1-05.平和島公園プール,2024-02-08T19:00:28.436000Z,1707418805,17
1174,21,0,35.559483,139.724273,K1-04.京急蒲田駅東口,2024-02-08T19:00:28.444000Z,1707418805,21
1175,13,2,35.716586,139.727705,E2-10.音羽パークロード（北入口）,2024-02-08T19:00:28.445000Z,1707418805,15
1176,13,7,35.715382,139.728533,E2-11.音羽パークロード（キャッチボール場横）,2024-02-08T19:00:28.446000Z,1707418805,20
1177,10,0,35.593887,139.741204,I1-21.大井競馬場(正門前),2024-02-08T19:00:28.446000Z,1707418805,10
1178,1,0,35.623215,139.668472,J1-27.衾町公園,2024-02-08T19:00:28.448000Z,1707418805,1
1179,5,2,35.75372,139.584332,T2-44.中島橋自転車駐車場,2024-02-08T19:00:28.449000Z,1707418805,7
1180,8,0,35.668845,139.765144,B3-15.ACホテル・バイ・マリオット東京銀座,2024-02-08T19:00:28.449000Z,1707418805,8
1181,2,4,35.699252,139.697606,D5-07.百人町1丁目,2024-02-08T19:00:28.452000Z,1707418805,6
1182,0,10,35.632128,139.732097,C4-04.ショパン高輪,2024-02-08T19:00:28.453000Z,1707418805,10
1183,2,1,35.681352,139.781436,B1-18.セブン-イレブン 日本橋小網町店,2024-02-08T19:00:28.457000Z,1707418805,3
1184,4,3,35.7211,139.574669,T2-71.わかば児童公園,2024-02-08T19:00:28.458000Z,1707418805,7
1185,6,0,35.647076,139.703964,M3-15.co-ba ebisu,2024-02-08T19:00:28.464000Z,1707418805,6
1186,4,0,35.66206,139.735501,C2-20.三井ガーデンホテル六本木プレミア,2024-02-08T19:00:28.465000Z,1707418805,4
1187,4,4,35.624566,139.72448,I1-70.五反田リバーステーション,2024-02-08T19:00:28.466000Z,1707418805,8
1188,7,4,35.711875,139.759306,E5-25.ジェノヴィア東大前グリーンヴェール,2024-02-08T19:00:28.467000Z,1707418805,11
1189,1,6,35.689017,139.714755,D1-12.ジェノヴィア新宿御苑グリーンヴェール,2024-02-08T19:00:28.472000Z,1707418805,7
1190,37,1,35.645682,139.748768,C5-33.msb Tamachi,2024-02-08T19:00:28.473000Z,1707418805,38
1191,1,0,35.690348,139.796133,G4-09.SYFORME MORISHITA Ⅱ 1,2024-02-08T19:00:28.474000Z,1707418805,1
1192,0,5,35.690307,139.796128,G4-10.SYFORME MORISHITA Ⅱ 2,2024-02-08T19:00:28.475000Z,1707418805,5
1193,0,16,35.715878,139.673669,N3-19.上高田パーキング,2024-02-08T19:00:27.249000Z,1707418805,16
1194,10,0,35.528361,139.696499,Z13.京急川崎日進町駐輪場,2024-02-08T19:00:28.480000Z,1707418805,10
1195,1,3,35.707305,139.773657,F6-01.松坂屋上野店,2024-02-08T19:00:26.556000Z,1707418805,4
1196,0,4,35.718832,139.791133,F4-01.SYFORME ASAKUSA,2024-02-08T19:00:25.553000Z,1707418805,4
1197,0,3,35.716062,139.799552,F2-02.アップルパーク浅草6丁目第3,2024-02-08T19:00:26.781000Z,1707418805,3
1198,0,20,35.71283,139.787754,F2-01.松が谷2丁目2,2024-02-08T19:00:26.782000Z,1707418805,20
1199,2,5,35.706023,139.783751,F1-02.台東デザイナーズビレッジ,2024-02-08T19:00:26.802000Z,1707418805,7
1200,0,6,35.717497,139.790055,F2-03.台東区生涯学習センター,2024-02-08T19:00:27.243000Z,1707418805,6
1201,0,3,35.582743,139.710561,K1-146.南馬込6丁目25-11,2024-02-08T19:00:27.233000Z,1707418805,3
1202,0,17,35.724944,139.801684,F3-01.清川1丁目18-11,2024-02-08T19:00:26.788000Z,1707418805,17
1203,4,12,35.706793,139.782985,F1-03.新御徒町駅自転車駐車場,2024-02-08T19:00:26.797000Z,1707418805,16
1204,0,7,35.717571,139.804216,F3-02.台東区リバーサイドスポーツセンター,2024-02-08T19:00:26.536000Z,1707418805,7
1205,4,1,35.62541,139.718135,I1-45.セブン-イレブン品川西五反田3丁目店,2024-02-08T19:00:26.624000Z,1707418805,5
1206,0,35,35.684218,139.832843,H1-135.北砂5丁目団地,2024-02-08T19:00:26.945000Z,1707418805,35
1207,0,11,35.6738,139.731525,C3-16.赤坂ガーデンシティ,2024-02-08T19:00:27.029000Z,1707418805,11
1208,7,3,35.636269,139.709073,J1-34.田道広場公園,2024-02-08T19:00:26.555000Z,1707418805,10
1209,1,2,35.69714,139.65432,O5-08.セシオン杉並,2024-02-08T19:00:26.183000Z,1707418805,3
1210,10,0,35.691456,139.762228,A2-04.ちよだプラットフォームスクウェア,2024-02-08T19:00:28.148000Z,1707418805,10
1211,2,5,35.598244,139.722447,I1-102.J.GRAN Court 品川西大井 EAST,2024-02-08T19:00:25.669000Z,1707418805,7
1212,6,0,35.665288,139.824294,H1-196.フットサルクラブ東京東陽町,2024-02-08T19:00:25.673000Z,1707418805,6
1213,0,3,35.717241,139.801674,F2-04.コンフォラス浅草マンション,2024-02-08T19:00:25.667000Z,1707418805,3
1214,3,2,35.693492,139.81506,G5-03.京成リッチモンドホテル東京錦糸町,2024-02-08T19:00:25.668000Z,1707418805,5
1215,1,3,35.544715,139.707623,K1-27.六郷文化センター,2024-02-08T19:00:27.039000Z,1707418805,4
1216,2,0,35.552741,139.718404,K1-147.トヨタモビリティ東京GRGarage東京蒲田店,2024-02-08T19:00:26.219000Z,1707418805,2
1217,6,0,35.552068,139.71747,K1-148.トヨタモビリティ東京 蒲田仲六郷店,2024-02-08T19:00:26.218000Z,1707418805,6
1218,1,4,35.568019,139.696379,K1-150.トヨタモビリティ東京 池上第二京浜店,2024-02-08T19:00:26.208000Z,1707418805,5
1219,1,5,35.59336,139.715879,K1-149.トヨタモビリティ東京 大田店,2024-02-08T19:00:26.201000Z,1707418805,6
1220,0,5,35.647831,139.739048,C1-82.トヨタモビリティ東京 港三田店,2024-02-08T19:00:26.212000Z,1707418805,5
1221,2,0,35.699835,139.70808,D4-11.トヨタモビリティ東京 新宿明治通り南店,2024-02-08T19:00:26.209000Z,1707418805,2
1222,12,5,35.670239,139.744285,C3-31.赤坂一丁目,2024-02-08T19:00:25.751000Z,1707418805,17
1223,34,7,35.707853,139.751518,E1-04.礫川公園,2024-02-08T19:00:25.465000Z,1707418805,41
1224,2,7,35.658229,139.694885,M3-23.円山町7-1,2024-02-08T19:00:26.749000Z,1707418805,9
1225,3,16,35.66026,139.69684,M3-24.渋谷道玄坂２丁目駐輪場,2024-02-08T19:00:28.198000Z,1707418805,19
1226,1,4,35.764452,139.666299,T3-32.練馬北町1丁目,2024-02-08T19:00:26.843000Z,1707418805,5
1227,0,4,35.675361,139.825034,H1-197.セブン-イレブン江東南砂葛西橋通り店,2024-02-08T19:00:26.335000Z,1707418805,4
1228,0,3,35.748395,139.605958,T2-84.石神井町二丁目緑地,2024-02-08T19:00:26.989000Z,1707418805,3
1229,0,5,35.737899,139.576584,T2-82.梅の木児童遊園,2024-02-08T19:00:25.745000Z,1707418805,5
1230,4,4,35.760442,139.573145,T2-83.西大泉さくら緑地,2024-02-08T19:00:27.972000Z,1707418805,8
1231,7,1,35.725818,139.678976,D7-05.西落合図書館,2024-02-08T19:00:25.729000Z,1707418805,8
1232,3,0,35.690899,139.706348,D6-28.東急ステイ新宿,2024-02-08T19:00:26.857000Z,1707418805,3
1233,3,1,35.7547,139.601497,T2-85.泉新公園,2024-02-08T19:00:25.990000Z,1707418805,4
1234,2,1,35.746956,139.600798,T2-86.石神井町八丁目緑地,2024-02-08T19:00:26.803000Z,1707418805,3
1235,0,4,35.745607,139.573947,T2-87.南大泉四丁目児童遊園,2024-02-08T19:00:27.078000Z,1707418805,4
1236,0,4,35.739633,139.570457,T2-88.南大泉かたまち緑地,2024-02-08T19:00:25.976000Z,1707418805,4
1237,0,3,35.742755,139.568335,T2-89.南大泉三丁目児童遊園,2024-02-08T19:00:27.882000Z,1707418805,3
1238,21,1,35.719421,139.725584,E2-05.護国寺駅西自転車駐車場,2024-02-08T19:00:25.444000Z,1707418805,22
1239,4,0,35.647704,139.693671,J1-59.第44興和ビル,2024-02-08T19:00:28.173000Z,1707418805,4
1240,11,5,35.65928,139.744767,C1-15.東京タワー,2024-02-08T19:00:28.373000Z,1707418805,16
1241,3,1,35.645254,139.754765,C5-20.ローソン芝浦二丁目店,2024-02-08T19:00:27.038000Z,1707418805,4
1242,17,0,35.651382,139.724392,C2-27.有栖川宮記念公園第一,2024-02-08T19:00:27.261000Z,1707418805,17
1243,4,4,35.651129,139.726003,C2-28.有栖川宮記念公園第二,2024-02-08T19:00:27.244000Z,1707418805,8
1244,4,1,35.658204,139.738935,C2-29.狸穴公園,2024-02-08T19:00:27.246000Z,1707418805,5
1245,2,2,35.733195,139.612327,T2-90.南田中四丁目緑地,2024-02-08T19:00:27.248000Z,1707418805,4
1246,5,0,35.745272,139.604579,T2-91.石神井町四丁目緑地,2024-02-08T19:00:26.756000Z,1707418805,5
1247,4,1,35.698917,139.771856,A3-41.秋葉原ダイビル,2024-02-08T19:00:28.389000Z,1707418805,5
1248,5,0,35.638904,139.712518,J1-54.田道住区センター三田分室,2024-02-08T19:00:25.435000Z,1707418805,5
1249,12,4,35.689896,139.815116,H1-140.キャナルパレス住吉,2024-02-08T19:00:26.990000Z,1707418805,16
1250,7,0,35.667259,139.745643,C1-57.虎ノ門ツインビルディング,2024-02-08T19:00:26.175000Z,1707418805,7
1251,0,16,35.579435,139.698552,K1-54.ファミリーマート大田久が原五丁目店,2024-02-08T19:00:26.682000Z,1707418805,16
1252,1,7,35.685504,139.790817,B1-29.ASTILE日本橋浜町,2024-02-08T19:00:28.362000Z,1707418805,8
1253,2,3,35.701157,139.679617,N3-20.SYFORME NAKANO-SAKAUE,2024-02-08T19:00:27.946000Z,1707418805,5
1254,3,7,35.696207,139.700521,D6-31.東急歌舞伎町タワー駐輪場,2024-02-08T19:00:28.208000Z,1707418805,10
1255,6,1,35.603327,139.729006,I1-30.ローソン 大井三丁目店,2024-02-08T19:00:28.408000Z,1707418805,7
1256,10,0,35.549465,139.711157,K1-151.PATH仲六郷,2024-02-08T19:00:27.258000Z,1707418805,10
1257,2,5,35.63464,139.783445,H1-198.Br Tower 有明 MID CROSS,2024-02-08T19:00:28.360000Z,1707418805,7
1258,41,20,35.63363,139.79082,H1-04.石と光の広場（国際展示場駅）,2024-02-08T19:00:27.998000Z,1707418805,61
1259,4,3,35.66288,139.78329,B4-24.ミュプレ月島,2024-02-08T19:00:27.322000Z,1707418805,7
1260,1,9,35.664244,139.814506,H1-199.ラ・ヴェール東陽町,2024-02-08T19:00:26.914000Z,1707418805,10
1261,0,12,35.662414,139.813333,H1-200.ヴェッセル木場南,2024-02-08T19:00:26.915000Z,1707418805,12
1262,0,5,35.703465,139.780325,F1-04.台東2丁目21,2024-02-08T19:00:26.916000Z,1707418805,5
1263,0,5,35.728704,139.801867,F3-03.ヴェルステージ南千住,2024-02-08T19:00:26.404000Z,1707418805,5
1264,0,6,35.632735,139.683899,J1-46.五本木西みどり街かど公園,2024-02-08T19:00:26.124000Z,1707418805,6
1265,0,10,35.525854,139.717848,Z24.総合川崎臨港病院,2024-02-08T19:00:27.234000Z,1707418805,10
1266,11,4,35.567146,139.693344,K1-131.東急武蔵新田駅駐輪場,2024-02-08T19:00:26.262000Z,1707418805,15
1267,0,8,35.543327,139.703223,K1-152.アットホームスクエア前,2024-02-08T19:00:26.835000Z,1707418805,8
1268,12,3,35.676119,139.772895,B2-04.清水建設本社（都営地下鉄宝町駅 Ａ８出口）,2024-02-08T19:00:25.523000Z,1707418805,15
1269,7,5,35.648107,139.813572,H1-202.辰巳の森海浜公園,2024-02-08T19:00:27.749000Z,1707418805,12
1270,1,5,35.678099,139.791831,H1-201.ウエリスアーバン水天宮前2,2024-02-08T19:00:27.744000Z,1707418805,6
1271,3,0,35.622389,139.721552,I1-103.五反田ＪＰビルディング,2024-02-08T19:00:28.408000Z,1707418805,3
1272,13,1,35.65838,139.59231,L1-16.上祖師谷7丁目,2024-02-08T19:00:27.739000Z,1707418805,14
1273,1,1,35.700772,139.66063,O5-09.AppCruise中野,2024-02-08T19:00:27.751000Z,1707418805,2
1274,0,11,35.67517,139.804087,H1-203.セブン-イレブン江東木場３丁目店,2024-02-08T19:00:25.676000Z,1707418805,11
1275,25,0,35.648726,139.790877,H1-44.テプコ豊洲ビル,2024-02-08T19:00:26.284000Z,1707418805,25
1276,3,4,35.659787,139.636696,L1-17.赤堤3丁目,2024-02-08T19:00:25.650000Z,1707418805,7
1277,20,10,35.662796,139.626795,L1-18.上北沢1丁目,2024-02-08T19:00:25.683000Z,1707418805,30
1278,0,8,35.666001,139.778102,B3-16.明石町区民館,2024-02-08T19:00:26.566000Z,1707418805,8
1279,4,1,35.603521,139.712345,I1-104.源氏前ビル,2024-02-08T19:00:26.540000Z,1707418805,5
1280,0,8,35.617699,139.664826,J1-28.宮前公園,2024-02-08T19:00:28.447000Z,1707418805,8
1281,0,3,35.686521,139.685017,M6-18.セブン-イレブン渋谷本町3丁目店,2024-02-08T19:00:26.539000Z,1707418805,3
1282,0,4,35.67187,139.65474,O7-08.杉並区和泉2-3-17,2024-02-08T19:00:26.520000Z,1707418805,4
1283,6,1,35.75987,139.640474,T1-17.セブン-イレブン練馬田柄通店,2024-02-08T19:00:26.198000Z,1707418805,7
1284,7,9,35.631192,139.79401,H1-18.東京ビッグサイト,2024-02-08T19:00:26.825000Z,1707418805,16
1285,11,2,35.657726,139.697802,M3-01.渋谷マークシティ,2024-02-08T19:00:27.129000Z,1707418805,13
1286,13,4,35.63403,139.784319,H1-70.有明スポーツセンター,2024-02-08T19:00:26.195000Z,1707418805,17
1287,2,11,35.676475,139.804741,H1-41.深川北スポーツセンター,2024-02-08T19:00:26.663000Z,1707418805,13
1288,3,5,35.681089,139.800777,H1-55.深川江戸資料館,2024-02-08T19:00:27.400000Z,1707418805,8
1289,3,4,35.622588,139.716159,I1-61.五反田文化センター,2024-02-08T19:00:26.902000Z,1707418805,7
1290,3,2,35.700052,139.673715,N3-13.中部すこやか福祉センター,2024-02-08T19:00:25.627000Z,1707418805,5
1291,10,0,35.686847,139.765151,A4-02.東京サンケイビル,2024-02-08T19:00:25.758000Z,1707418805,10
1292,10,9,35.661475,139.699296,M3-09.ティップ.クロス TOKYO 渋谷,2024-02-08T19:00:27.690000Z,1707418805,19
1293,2,4,35.670336,139.771911,B3-02.サンクンガーデン,2024-02-08T19:00:25.543000Z,1707418805,6
1294,5,0,35.748153,139.58765,T2-10.勤労福祉会館,2024-02-08T19:00:28.034000Z,1707418805,5
1295,13,0,35.584217,139.759232,K1-133.東京港野鳥公園,2024-02-08T19:00:26.750000Z,1707418805,13
1296,0,8,35.55079,139.716517,K1-21.六郷特別出張所,2024-02-08T19:00:26.886000Z,1707418805,8
1297,3,17,35.680052,139.831874,H1-54.砂町文化センター,2024-02-08T19:00:27.391000Z,1707418805,20
1298,3,1,35.689984,139.725261,D1-08.新宿歴史博物館,2024-02-08T19:00:25.981000Z,1707418805,4
1299,23,3,35.708291,139.753335,E1-05.春日地下自転車駐車場,2024-02-08T19:00:25.466000Z,1707418805,26
1300,0,6,35.71724,139.74289,E1-15.播磨坂事業所,2024-02-08T19:00:26.967000Z,1707418805,6
1301,0,12,35.719356,139.764308,E5-02.不忍通りふれあい館,2024-02-08T19:00:27.841000Z,1707418805,12
1302,8,5,35.717357,139.757817,E4-02.向丘地域活動センター,2024-02-08T19:00:27.844000Z,1707418805,13
1303,4,1,35.678509,139.721207,C3-18.明治記念館,2024-02-08T19:00:26.600000Z,1707418805,5
1304,13,2,35.705018,139.706841,D5-05.中央図書館,2024-02-08T19:00:27.390000Z,1707418805,15
1305,10,3,35.713223,139.721699,E2-07.肥後細川庭園,2024-02-08T19:00:26.596000Z,1707418805,13
1306,0,4,35.699187,139.746348,A1-05.富士見出張所,2024-02-08T19:00:25.818000Z,1707418805,4
1307,4,4,35.707296,139.769393,E5-07.湯島三丁目児童遊園,2024-02-08T19:00:27.567000Z,1707418805,8
1308,1,6,35.705154,139.697562,D5-10.桜美林大学 新宿キャンパス,2024-02-08T19:00:26.579000Z,1707418805,7
1309,11,2,35.702029,139.768245,A3-08.神田明神（神田神社）,2024-02-08T19:00:27.120000Z,1707418805,13
1310,5,0,35.713145,139.723342,E2-14.永青文庫 ミュージアム,2024-02-08T19:00:26.221000Z,1707418805,5
1311,8,1,35.6866,139.70014,M5-17.小田急サザンタワー,2024-02-08T19:00:25.563000Z,1707418805,9
1312,3,3,35.563092,139.693548,K1-16.ファミリーマート 矢口二丁目店,2024-02-08T19:00:27.032000Z,1707418805,6
1313,0,9,35.683866,139.831809,H1-206.北砂5丁目団地2,2024-02-08T19:00:27.671000Z,1707418805,9
1314,4,10,35.727495,139.828499,G1-02.八広駅高架下,2024-02-08T19:00:27.670000Z,1707418805,14
1315,0,4,35.717963,139.791025,F4-02.Risingplace浅草四番館,2024-02-08T19:00:27.668000Z,1707418805,4
1316,3,5,35.68832,139.828829,H1-204.大島四丁目団地2,2024-02-08T19:00:25.626000Z,1707418805,8
1317,5,5,35.688236,139.827711,H1-205.大島四丁目団地3,2024-02-08T19:00:25.626000Z,1707418805,10
1318,12,7,35.699874,139.834263,H1-106.亀戸中央公園,2024-02-08T19:00:25.562000Z,1707418805,19
1319,0,12,35.705148,139.769314,E5-30.湯島3丁目15,2024-02-08T19:00:27.031000Z,1707418805,12
1320,0,24,35.650347,139.771785,B4-38.HARUMI FLAG SUN VILLAGE,2024-02-08T19:00:25.754000Z,1707418805,24
1321,0,10,35.648731,139.774995,B4-32.HARUMI FLAG SEA VILLAGE,2024-02-08T19:00:25.762000Z,1707418805,10
1322,0,19,35.650604,139.77724,B4-31.HARUMI FLAG PORT VILLAGE,2024-02-08T19:00:25.766000Z,1707418805,19
1323,0,15,35.649552,139.776369,B4-33.HARUMI FLAG SEA VILLAGE,2024-02-08T19:00:25.773000Z,1707418805,15
1324,2,10,35.650742,139.778097,B4-36.HARUMI FLAG SEA VILLAGE,2024-02-08T19:00:26.471000Z,1707418805,12
1325,1,11,35.650573,139.777908,B4-35.HARUMI FLAG SEA VILLAGE,2024-02-08T19:00:26.472000Z,1707418805,12
1326,0,17,35.649419,139.771447,B4-37.HARUMI FLAG SUN VILLAGE,2024-02-08T19:00:26.481000Z,1707418805,17
1327,2,10,35.649932,139.776958,B4-34.HARUMI FLAG SEA VILLAGE,2024-02-08T19:00:26.483000Z,1707418805,12
1328,0,18,35.650863,139.772549,B4-39.HARUMI FLAG SUN VILLAGE,2024-02-08T19:00:26.496000Z,1707418805,18
1329,0,15,35.651305,139.773379,B4-40.HARUMI FLAG SUN VILLAGE,2024-02-08T19:00:26.518000Z,1707418805,15
1330,0,17,35.649854,139.77334,B4-41.HARUMI FLAG SUN VILLAGE,2024-02-08T19:00:26.534000Z,1707418805,17
1331,0,13,35.649329,139.772656,B4-42.HARUMI FLAG SUN VILLAGE,2024-02-08T19:00:26.535000Z,1707418805,13
1332,4,7,35.651183,139.776119,B4-28.HARUMI FLAG PORT VILLAGE,2024-02-08T19:00:27.191000Z,1707418805,11
1333,2,7,35.648295,139.773973,B4-50.HARUMI FLAG PARK VILLAGE,2024-02-08T19:00:27.192000Z,1707418805,9
1334,4,12,35.648636,139.774251,B4-49.HARUMI FLAG PARK VILLAGE,2024-02-08T19:00:27.196000Z,1707418805,16
1335,0,5,35.649513,139.775287,B4-48.HARUMI FLAG PARK VILLAGE,2024-02-08T19:00:27.198000Z,1707418805,5
1336,2,4,35.649119,139.775138,B4-47.HARUMI FLAG PARK VILLAGE,2024-02-08T19:00:27.199000Z,1707418805,6
1337,0,26,35.649642,139.773859,B4-46.HARUMI FLAG PARK VILLAGE,2024-02-08T19:00:27.199000Z,1707418805,26
1338,0,25,35.649002,139.772764,B4-45.HARUMI FLAG PARK VILLAGE,2024-02-08T19:00:27.202000Z,1707418805,25
1339,3,10,35.648221,139.772666,B4-44.HARUMI FLAG PARK VILLAGE,2024-02-08T19:00:27.209000Z,1707418805,13
1340,1,10,35.651136,139.778218,B4-30.HARUMI FLAG PORT VILLAGE,2024-02-08T19:00:27.227000Z,1707418805,11
1341,0,17,35.651907,139.777391,B4-29.HARUMI FLAG PORT VILLAGE,2024-02-08T19:00:27.229000Z,1707418805,17
1342,1,3,35.639302,139.674744,L1-19.三軒茶屋1丁目駐輪場,2024-02-08T19:00:26.015000Z,1707418805,4
1343,8,9,35.678921,139.658289,O7-09.方南月極パーキング,2024-02-08T19:00:26.014000Z,1707418805,17
1344,0,4,35.68942,139.662118,O5-10.ローソン ツルハドラッグ杉並和田店,2024-02-08T19:00:26.019000Z,1707418805,4
1345,2,3,35.708082,139.607543,O2-04.西荻北1丁目,2024-02-08T19:00:26.522000Z,1707418805,5
1346,6,4,35.556231,139.751408,K1-75.三井不動産インダストリアルパーク羽田,2024-02-08T19:00:26.672000Z,1707418805,10
1347,0,2,35.703024,139.78052,F1-05.ホウエイコート秋葉原,2024-02-08T19:00:27.268000Z,1707418805,2
1348,2,2,35.666349,139.741781,C3-36.第35興和ビル,2024-02-08T19:00:27.266000Z,1707418805,4
1349,24,82,35.651627,139.773103,B4-53.晴海五丁目ターミナル,2024-02-08T19:00:27.272000Z,1707418805,106
1350,9,0,35.643105,139.753039,C5-44.ブランズタワー芝浦,2024-02-08T19:00:25.451000Z,1707418805,9
1351,13,0,35.690602,139.766916,A3-47.ホテルヴィラフォンテーヌ東京大手町,2024-02-08T19:00:26.333000Z,1707418805,13
1352,4,1,35.693021,139.740317,A1-20.菱和パレス九段,2024-02-08T19:00:26.322000Z,1707418805,5
