,name,empty_slots,free_bikes,total_slots,latitude,longitude,timestamp
0,E5-26.本郷4丁目,0,5,5,35.708596,139.758269,2024-02-08 13:54:04
1,A3-42.内神田3丁目,32,3,35,35.692599,139.770109,2024-02-08 13:54:04
2,T2-76.東中前の森緑地,3,2,5,35.748736,139.574839,2024-02-08 13:54:04
3,A2-20.神田スクエア,19,0,19,35.693408,139.762809,2024-02-08 13:54:04
4,K1-79.Tマークシティホテル東京大森,3,4,7,35.586993,139.736491,2024-02-08 13:54:04
5,K1-80.大森北6丁目,1,3,4,35.579849,139.731241,2024-02-08 13:54:04
6,H1-130.トヨタモビリティ東京 深川店,3,7,10,35.676643,139.816054,2024-02-08 13:54:04
7,H1-131.セブン-イレブン 江東佐賀2丁目店,0,17,17,35.679029,139.793535,2024-02-08 13:54:04
8,H1-132.セブン-イレブン 江東三好4丁目店,0,35,35,35.681418,139.809287,2024-02-08 13:54:04
9,A6-22.半蔵門PREX South,12,3,15,35.683433,139.740756,2024-02-08 13:54:04
10,I1-74.セブン-イレブン西五反田6丁目店,3,2,5,35.622403,139.71771,2024-02-08 13:54:04
11,G2-01.東京ソラマチ,5,2,7,35.709777,139.810189,2024-02-08 13:54:04
12,T2-59.平成公園,2,0,2,35.722917,139.587864,2024-02-08 13:54:04
13,I1-26.大崎西口公園,0,8,8,35.617475,139.729221,2024-02-08 13:54:04
14,I1-96.西五反田２丁目,10,0,10,35.627599,139.720463,2024-02-08 13:54:04
15,H1-172.サンヨーパシフィックマンション,0,10,10,35.668856,139.794069,2024-02-08 13:54:04
16,J1-56.青葉台四丁目街かど公園,3,1,4,35.654009,139.692727,2024-02-08 13:54:04
17,H1-173.森下駅前,8,31,39,35.687837,139.79654,2024-02-08 13:54:04
18,E3-01.大塚地域活動センター跡地,5,5,10,35.718656,139.734556,2024-02-08 13:54:04
19,E2-03.目白台運動公園,27,14,41,35.715556,139.721988,2024-02-08 13:54:04
20,T2-77.大泉なかよし緑地,3,1,4,35.759861,139.581682,2024-02-08 13:54:04
21,E2-01.江戸川橋Ｂ自転車駐車場,42,39,81,35.710381,139.732137,2024-02-08 13:54:04
22,E2-02.江戸川公園,9,10,19,35.710958,139.731165,2024-02-08 13:54:04
23,D7-14.大栄パーク西落合１丁目,3,3,6,35.720028,139.678936,2024-02-08 13:54:04
24,E1-07.礫川地域活動センター,0,8,8,35.712015,139.750284,2024-02-08 13:54:04
25,M6-05.七号通り公園,0,14,14,35.67917,139.67493,2024-02-08 13:54:04
26,H1-138.HW.HILLS新大橋,1,10,11,35.687416,139.795588,2024-02-08 13:54:04
27,B4-21.月島駅前第一駐輪場,14,18,32,35.663681,139.785651,2024-02-08 13:54:04
28,N2-03.野方1丁目,5,2,7,35.712179,139.65603,2024-02-08 13:54:04
29,C5-52.港南四丁目第3アパート駐車場,7,4,11,35.630109,139.747094,2024-02-08 13:54:04
30,E5-27.真正館駐車場,0,4,4,35.714875,139.76394,2024-02-08 13:54:04
31,C5-35.品川駅港南口,6,0,6,35.62822,139.741135,2024-02-08 13:54:04
32,N2-01.NTT野方ビル,3,2,5,35.710285,139.66173,2024-02-08 13:54:04
33,D6-27.新宿三井ビルディング二号館,8,1,9,35.686334,139.692881,2024-02-08 13:54:04
34,D1-10.曙橋駐輪場,2,14,16,35.691888,139.724365,2024-02-08 13:54:04
35,I1-39.MID POINT 目黒不動前,3,1,4,35.628116,139.713149,2024-02-08 13:54:04
36,E3-07.小日向1丁目,0,20,20,35.713388,139.737009,2024-02-08 13:54:04
37,C1-47.パークプレイス三田,8,1,9,35.641791,139.740734,2024-02-08 13:54:04
38,I1-38.ローソン 八潮三丁目店,24,21,45,35.594544,139.760423,2024-02-08 13:54:04
39,C2-24.Dash Living HigashiAzabu,6,0,6,35.655135,139.744449,2024-02-08 13:54:04
40,J1-04.菅刈公園,7,1,8,35.650351,139.692853,2024-02-08 13:54:04
41,O4-09.ローソン杉並本天沼一丁目店,0,3,3,35.712496,139.632778,2024-02-08 13:54:04
42,T3-29.平和台もものき緑地,1,2,3,35.755773,139.661913,2024-02-08 13:54:04
43,D2-10.市谷砂土原町3丁目,3,9,12,35.696242,139.735776,2024-02-08 13:54:04
44,C1-48.竹芝客船ターミナル,10,5,15,35.655139,139.762812,2024-02-08 13:54:04
45,B1-06.伊場仙ビル,3,2,5,35.687624,139.777125,2024-02-08 13:54:04
46,B2-01.鉄砲洲児童公園（西側）,0,21,21,35.67224,139.779348,2024-02-08 13:54:04
47,B1-04.産業会館,1,4,5,35.694164,139.787057,2024-02-08 13:54:04
48,B1-05.日本橋保健センター,0,11,11,35.687419,139.779053,2024-02-08 13:54:04
49,B2-05.ＮＴＴ東日本築地ビル,0,10,10,35.670674,139.775993,2024-02-08 13:54:04
50,B2-02.柳通り（東京スクエアガーデン前）,11,0,11,35.676393,139.768319,2024-02-08 13:54:04
51,B2-03.男女平等センター（ブーケ21）,8,3,11,35.673923,139.778671,2024-02-08 13:54:04
52,C2-13.麻布運動場,8,0,8,35.651718,139.728165,2024-02-08 13:54:04
53,D2-08.旧市ヶ谷商業高校,0,16,16,35.70074,139.731363,2024-02-08 13:54:04
54,C1-35.セブン-イレブン 三田駅北店,4,0,4,35.649032,139.750147,2024-02-08 13:54:04
55,B4-12.THE TOKYO TOWERS,0,104,104,35.655497,139.774556,2024-02-08 13:54:04
56,C5-21.セブン-イレブン 芝浦3丁目店,5,1,6,35.642399,139.746992,2024-02-08 13:54:04
57,H1-67.セブン-イレブン 江東亀戸9丁目店,1,14,15,35.69766,139.843408,2024-02-08 13:54:04
58,C2-15.住友不動産六本木グランドタワー,0,13,13,35.664367,139.737185,2024-02-08 13:54:04
59,C2-14.元麻布ヒルズ,1,9,10,35.653608,139.73138,2024-02-08 13:54:04
60,M6-14.ドコモショップ笹塚店,0,5,5,35.67323,139.66393,2024-02-08 13:54:04
61,N4-07.南台2丁目,2,10,12,35.68509,139.671102,2024-02-08 13:54:04
62,K1-68.ART FACTORY 城南島,6,2,8,35.580511,139.775957,2024-02-08 13:54:04
63,H1-178.北砂7丁目団地(第二),0,4,4,35.678031,139.837193,2024-02-08 13:54:04
64,H1-179.北砂7丁目団地(第三),0,11,11,35.678246,139.8366,2024-02-08 13:54:04
65,A1-17.雉子橋集積所,6,0,6,35.692605,139.755761,2024-02-08 13:54:04
66,H1-177.北砂7丁目団地(第一),0,12,12,35.678537,139.837391,2024-02-08 13:54:04
67,K1-95.城南島海浜公園,11,5,16,35.578259,139.783505,2024-02-08 13:54:04
68,B3-17.銀座6丁目-SQUARE,7,0,7,35.66711,139.76643,2024-02-08 13:54:04
69,J1-33.芳窪街かど公園,12,1,13,35.629861,139.666293,2024-02-08 13:54:04
70,N3-07.なかのZERO,2,3,5,35.70442,139.67141,2024-02-08 13:54:04
71,N4-04.弥生町5丁目,3,9,12,35.690897,139.668345,2024-02-08 13:54:04
72,A3-44.THE WAVES AKIHABARA,0,5,5,35.694679,139.779504,2024-02-08 13:54:04
73,K1-138.羽田エアポートガーデン,5,4,9,35.544534,139.763244,2024-02-08 13:54:04
74,C3-26.ホテルリブマックス赤坂,2,3,5,35.67011,139.733375,2024-02-08 13:54:04
75,C1-52.NTT三田ビル,4,2,6,35.652549,139.747789,2024-02-08 13:54:04
76,D1-07.Dash Living Shinjuku,4,0,4,35.689757,139.710091,2024-02-08 13:54:04
77,O4-07.ローソン成田西三丁目店,0,5,5,35.690311,139.62178,2024-02-08 13:54:04
78,H1-152.コンポジット亀戸ウエスト,0,10,10,35.699187,139.82429,2024-02-08 13:54:04
79,E1-13.エルアージュ小石川,0,40,40,35.71399,139.75137,2024-02-08 13:54:04
80,B4-22.リビオレゾン勝どきNEX,0,45,45,35.65554,139.77102,2024-02-08 13:54:04
81,H1-176.JMFビル東陽町02,2,4,6,35.667677,139.823552,2024-02-08 13:54:04
82,H1-102.ファミリーマート東砂七丁目店,0,16,16,35.672714,139.837914,2024-02-08 13:54:04
83,H1-101.ファミリーマート新木場一丁目店,5,1,6,35.642571,139.836766,2024-02-08 13:54:04
84,K1-67.京浜島防災広場,0,15,15,35.570508,139.764013,2024-02-08 13:54:04
85,K1-66.昭和島二丁目公園,0,12,12,35.575097,139.751446,2024-02-08 13:54:04
86,I1-80.リバーサイド品川港南ビル,5,4,9,35.622714,139.74471,2024-02-08 13:54:04
87,J1-10.NTTデータ駒場研修センター,6,5,11,35.655779,139.680948,2024-02-08 13:54:04
88,A2-17.竹橋ビル,8,0,8,35.692396,139.75639,2024-02-08 13:54:04
89,H1-91.亀戸駅北口第三自転車駐車場,13,5,18,35.696913,139.823911,2024-02-08 13:54:04
90,H1-92.亀戸駅東口第二自転車駐車場,7,7,14,35.69788,139.830559,2024-02-08 13:54:04
91,K1-59.京急梅屋敷第1駐車場,5,2,7,35.565768,139.727396,2024-02-08 13:54:04
92,K1-60.京急平和島第1駐車場,1,5,6,35.576336,139.733691,2024-02-08 13:54:04
93,I1-42.京急青横駐車場,3,0,3,35.611582,139.742528,2024-02-08 13:54:04
94,I1-43.京急南大井駐車場,2,7,9,35.594722,139.737101,2024-02-08 13:54:04
95,O7-05.ジーベック方南町,0,1,1,35.680849,139.65626,2024-02-08 13:54:04
96,H1-100.URアーバンライフ亀戸,21,8,29,35.697935,139.821855,2024-02-08 13:54:04
97,A6-10.紀尾井町ビル（西側）,9,3,12,35.682516,139.736494,2024-02-08 13:54:04
98,C3-02.赤坂地区総合支所,0,7,7,35.674788,139.731423,2024-02-08 13:54:04
99,C2-08.ファミリーマート西麻布霞町店,0,8,8,35.661673,139.721118,2024-02-08 13:54:04
100,A6-09.紀尾井町ビル（北側）,6,0,6,35.682902,139.736494,2024-02-08 13:54:04
101,H1-28.有明客船ターミナル,10,1,11,35.630063,139.792209,2024-02-08 13:54:04
102,B1-12.ファミリーマート堀留町二丁目店,0,7,7,35.687786,139.78205,2024-02-08 13:54:04
103,H1-26.青海客船ターミナル,15,0,15,35.619234,139.774485,2024-02-08 13:54:04
104,H1-27.パレットタウン乗船場,10,0,10,35.624467,139.781305,2024-02-08 13:54:04
105,O1-04.井草1-34,7,8,15,35.72758,139.62432,2024-02-08 13:54:04
106,C1-76.浜松町駅北口交通広場(ハマサイト前),15,0,15,35.656647,139.758301,2024-02-08 13:54:04
107,J1-52.駒沢一丁目公園前,7,2,9,35.629807,139.662398,2024-02-08 13:54:04
108,C1-75.虎ノ門PFビル,6,1,7,35.665466,139.748014,2024-02-08 13:54:04
109,B2-18.旭ビルディング,11,0,11,35.678291,139.78157,2024-02-08 13:54:04
110,N2-09.松山駐車場No.1,2,4,6,35.722991,139.673048,2024-02-08 13:54:04
111,I1-82.トミンハイム西五反田四丁目,2,4,6,35.627386,139.711182,2024-02-08 13:54:04
112,O4-03.ザ・ハウス,0,12,12,35.707035,139.633066,2024-02-08 13:54:04
113,O4-04.阿佐谷南3-43,15,1,16,35.704147,139.631955,2024-02-08 13:54:04
114,K1-83.北千束北児童公園,6,0,6,35.611085,139.68599,2024-02-08 13:54:04
115,I1-95.東京レールゲート EAST,9,1,10,35.584998,139.761055,2024-02-08 13:54:04
116,M5-19.グランリヴィエール代々木,2,2,4,35.68285,139.698528,2024-02-08 13:54:04
117,H1-192.ウエリスアーバン水天宮前,3,1,4,35.678296,139.791949,2024-02-08 13:54:04
118,N2-08.江古田区民活動センター,1,3,4,35.728893,139.670119,2024-02-08 13:54:04
119,D7-04.セブン-イレブン 新宿下落合3丁目店,2,0,2,35.722645,139.701982,2024-02-08 13:54:04
120,K1-82.西蒲田公園,7,0,7,35.561499,139.71123,2024-02-08 13:54:04
121,H1-68.芝浦工業大学附属中学高等学校,0,33,33,35.649274,139.792213,2024-02-08 13:54:04
122,K1-24.東糀谷防災公園,1,15,16,35.557074,139.74575,2024-02-08 13:54:04
123,H1-03.東雲駅,12,3,15,35.640736,139.804331,2024-02-08 13:54:04
124,K1-26.大森諏訪公園,0,16,16,35.574785,139.730762,2024-02-08 13:54:04
125,K1-25.鶴渡公園,1,2,3,35.56892,139.725082,2024-02-08 13:54:04
126,N3-10.エーエスホームズⅡ駐車場,5,1,6,35.702659,139.662563,2024-02-08 13:54:04
127,J1-37.中目黒公園,12,6,18,35.640398,139.704069,2024-02-08 13:54:04
128,A1-10.ヒューリック九段ビル,6,0,6,35.696449,139.750784,2024-02-08 13:54:04
129,K1-93.六間堀仲羽公園,3,1,4,35.548864,139.74484,2024-02-08 13:54:04
130,T2-53.上練馬公園,2,2,4,35.772863,139.626969,2024-02-08 13:54:04
131,M5-01.初台駅南口,0,12,12,35.680154,139.685937,2024-02-08 13:54:04
132,C1-60.専売ビル,12,1,13,35.647659,139.745055,2024-02-08 13:54:04
133,K1-85.大田区青少年交流センター ゆいっつ,2,2,4,35.583555,139.743381,2024-02-08 13:54:04
134,I1-64.株式会社ユアス ゆうパック取扱所：ポストのうしろ,8,2,10,35.622965,139.731014,2024-02-08 13:54:04
135,C4-09.ケーヨーデイツー三田店,1,5,6,35.646375,139.740061,2024-02-08 13:54:04
136,C1-61.環三浜松町駅南,22,16,38,35.653096,139.75739,2024-02-08 13:54:04
137,K1-84.佐伯山緑地,0,13,13,35.581698,139.71491,2024-02-08 13:54:04
138,C1-59.セレスティン芝三井ビルディング,4,9,13,35.650845,139.748346,2024-02-08 13:54:04
139,G2-07.レオーネ押上cube,3,1,4,35.706167,139.815955,2024-02-08 13:54:04
140,E1-06.文京シビックセンター,11,7,18,35.708265,139.751983,2024-02-08 13:54:04
141,D2-13.THE CENTER TOKYO,0,24,24,35.695646,139.725722,2024-02-08 13:54:04
142,E5-22.千駄木2丁目,1,5,6,35.724828,139.762583,2024-02-08 13:54:04
143,C4-07.品川プリンスホテル,8,2,10,35.628266,139.734171,2024-02-08 13:54:04
144,A3-43.unito CHIYODA,0,4,4,35.69474,139.77929,2024-02-08 13:54:04
145,C4-06.白金プラチナレジデンス,0,23,23,35.644134,139.723432,2024-02-08 13:54:04
146,I1-63.セブン-イレブン西五反田店,3,0,3,35.62765,139.719212,2024-02-08 13:54:04
147,H1-53.豊洲シビックセンター,13,4,17,35.653991,139.795513,2024-02-08 13:54:04
148,T3-16.練馬区役所東庁舎(第一),10,0,10,35.735428,139.652379,2024-02-08 13:54:04
149,T2-68.さくら原っぱ緑地,2,3,5,35.731372,139.619164,2024-02-08 13:54:04
150,T2-69.久保新田さくら公園,0,4,4,35.76525,139.575978,2024-02-08 13:54:04
151,H1-187.森下文化センター,0,5,5,35.685344,139.80234,2024-02-08 13:54:04
152,E4-04.セブン-イレブン 文京本駒込１丁目店,1,4,5,35.724707,139.750469,2024-02-08 13:54:04
153,M2-13.恵比寿プライムスクエアタワー南,8,0,8,35.649257,139.713272,2024-02-08 13:54:04
154,H1-48.セブン-イレブン 江東潮見２丁目店,0,10,10,35.658249,139.815775,2024-02-08 13:54:04
155,H1-51.豊洲交通広場　東,22,4,26,35.654958,139.795718,2024-02-08 13:54:04
156,H1-52.辰巳駅,9,6,15,35.646756,139.809295,2024-02-08 13:54:04
157,D7-01.下落合図書館,5,10,15,35.715894,139.698578,2024-02-08 13:54:04
158,H1-50.豊洲交通広場　北,9,2,11,35.655457,139.795161,2024-02-08 13:54:04
159,A6-14.MG市ヶ谷ビルディング,0,2,2,35.690861,139.736393,2024-02-08 13:54:04
160,T2-21.ファミリーマート 練馬大泉町一丁目店,2,2,4,35.768448,139.601679,2024-02-08 13:54:04
161,A6-15.東急番町ビル,4,1,5,35.688929,139.7358,2024-02-08 13:54:04
162,A1-18.東京区政会館別館(特別区研修所),3,0,3,35.696202,139.752351,2024-02-08 13:54:04
163,T3-18.練馬駅北,10,9,19,35.738585,139.653396,2024-02-08 13:54:04
164,C1-43.KDX浜松町プレイス,3,3,6,35.658169,139.752509,2024-02-08 13:54:04
165,C5-27.プレミア海岸ビル,11,10,21,35.648948,139.757895,2024-02-08 13:54:04
166,I1-29.ローソン 勝島一丁目店,0,19,19,35.599987,139.745195,2024-02-08 13:54:04
167,H1-72.ネクストサイト深川ビル,19,2,21,35.674578,139.797396,2024-02-08 13:54:04
168,T1-11.むつみ台,0,3,3,35.768528,139.639807,2024-02-08 13:54:04
169,H1-167.大島八丁目公園,1,9,10,35.688074,139.838932,2024-02-08 13:54:04
170,K1-36.セブン-イレブン 大田区南雪谷5丁目店,0,11,11,35.587815,139.691748,2024-02-08 13:54:04
171,L1-01.羽根木公園,5,7,12,35.66088,139.654546,2024-02-08 13:54:04
172,P1-02.雑司ヶ谷一丁目,8,0,8,35.721738,139.723103,2024-02-08 13:54:04
173,I1-66.南大井文化センター駐車場,2,4,6,35.596733,139.73804,2024-02-08 13:54:04
174,L1-05.NTT烏山ビル,0,4,4,35.669285,139.597931,2024-02-08 13:54:04
175,L1-04.下馬中央公園,1,4,5,35.63367,139.678139,2024-02-08 13:54:04
176,L1-03.世田谷城阯公園,0,6,6,35.645838,139.647799,2024-02-08 13:54:04
177,L1-02.若林公園,5,2,7,35.647075,139.654472,2024-02-08 13:54:04
178,T2-30.ファミリーマート 練馬東大泉四丁目店,3,1,4,35.750804,139.58243,2024-02-08 13:54:04
179,L1-07.NTT成城ビル,2,1,3,35.648021,139.606529,2024-02-08 13:54:04
180,L1-06.NTT瀬田ビル,0,12,12,35.618357,139.626191,2024-02-08 13:54:04
181,T3-13.平和台児童公園,2,2,4,35.757298,139.664139,2024-02-08 13:54:04
182,T2-38.ファミリーマート 練馬上石神井四丁目店,7,2,9,35.727195,139.590179,2024-02-08 13:54:04
183,B1-28.アイルイムーブル日本橋,9,0,9,35.684502,139.77906,2024-02-08 13:54:04
184,A2-28.NTTコミュニケーションズ一ツ橋ビル駐車場,8,0,8,35.6915,139.75685,2024-02-08 13:54:04
185,C3-32.乃木公園,4,1,5,35.667936,139.72745,2024-02-08 13:54:04
186,T3-14.わらべ児童遊園,3,1,4,35.759774,139.654529,2024-02-08 13:54:04
187,T2-52.田柄中央児童公園,2,3,5,35.762395,139.641522,2024-02-08 13:54:04
188,M4-06.THE SHARE 原宿,9,0,9,35.671823,139.708158,2024-02-08 13:54:04
189,K1-10.セブン‐イレブン 大田区西糀谷１丁目店,1,3,4,35.559647,139.730098,2024-02-08 13:54:04
190,K1-09.セブン‐イレブン 大田区西蒲田２丁目店,0,22,22,35.570763,139.705895,2024-02-08 13:54:04
191,H1-63.東京スイソミル,0,15,15,35.65637,139.811765,2024-02-08 13:54:04
192,B1-16.小網町児童遊園,5,0,5,35.683695,139.780043,2024-02-08 13:54:04
193,H1-61.Brilliaランニングスタジアムマギーズ東京前,7,2,9,35.648281,139.786112,2024-02-08 13:54:04
194,K1-08.セブン‐イレブン 大田区東蒲田キネマ通り店,1,5,6,35.562368,139.730143,2024-02-08 13:54:04
195,C1-34.城山ガーデン,8,0,8,35.664479,139.743731,2024-02-08 13:54:04
196,H1-62.扇橋一丁目公園南,0,44,44,35.683343,139.812161,2024-02-08 13:54:04
197,J1-23.清水池公園,8,15,23,35.623756,139.692517,2024-02-08 13:54:04
198,C5-18.パークタワー品川ベイワード,9,10,19,35.634529,139.748378,2024-02-08 13:54:04
199,E4-07.ファミリーマート 本駒込二丁目店,3,1,4,35.727279,139.74627,2024-02-08 13:54:04
200,C5-45.パークアクシス芝浦キャナル,2,7,9,35.644794,139.755688,2024-02-08 13:54:04
201,A2-02.西神田公園（北側）,6,3,9,35.698591,139.755113,2024-02-08 13:54:04
202,T2-49.善福寺公園テニスクラブ,5,4,9,35.719674,139.593696,2024-02-08 13:54:04
203,H1-193.ライフ豊洲店,26,1,27,35.651833,139.79962,2024-02-08 13:54:04
204,A2-01.神田駿河台下,53,0,53,35.695762,139.761585,2024-02-08 13:54:04
205,I1-51.京急鈴ヶ森駐車場,0,15,15,35.589573,139.735585,2024-02-08 13:54:04
206,T2-36.サントピア テニスパーク,4,6,10,35.75195,139.616028,2024-02-08 13:54:04
207,G4-13. Parking in 両国駅前第2,0,3,3,35.696492,139.791591,2024-02-08 13:54:04
208,K1-120.蒲田駅消費者生活センター横自転車駐車場 屋上部,6,0,6,35.560125,139.71569,2024-02-08 13:54:04
209,N3-18.藤和シティコープ新中野3,5,1,6,35.69942,139.673964,2024-02-08 13:54:04
210,K1-145.トヨタモビリティ東京馬込テクニカル研修センター,6,7,13,35.58209,139.701362,2024-02-08 13:54:04
211,K1-100.多摩川台公園,5,0,5,35.589794,139.666955,2024-02-08 13:54:04
212,C1-54.ニッセイ虎ノ門ビル,12,0,12,35.664344,139.746662,2024-02-08 13:54:04
213,I1-52.カスタリアタワー品川シーサイド,9,1,10,35.607557,139.746866,2024-02-08 13:54:04
214,I1-53.天王洲公園,3,1,4,35.620355,139.749339,2024-02-08 13:54:04
215,C2-18.ブランシェ東麻布,0,3,3,35.656769,139.743224,2024-02-08 13:54:04
216,A3-45.鍛冶町2丁目,12,5,17,35.691578,139.77138,2024-02-08 13:54:04
217,H1-87.パークアクシス木場キャナルウエスト,0,26,26,35.662514,139.803694,2024-02-08 13:54:04
218,D6-20.淀橋けやき橋公園,6,9,15,35.693544,139.685806,2024-02-08 13:54:04
219,A3-46.神田須田町2丁目,0,0,0,35.695457,139.772972,2024-02-08 13:54:04
220,B3-13.国立がん研究センター,11,0,11,35.664871,139.767188,2024-02-08 13:54:04
221,I1-35.シーフォートスクエア,17,1,18,35.622954,139.750593,2024-02-08 13:54:04
222,K1-55.カバヤビル,6,12,18,35.576275,139.713704,2024-02-08 13:54:04
223,C3-24.SHARE GREEN 南青山 西エントランス,0,7,7,35.668419,139.724676,2024-02-08 13:54:04
224,A5-06.APA HOTEL PRIDE〈国会議事堂前〉,10,0,10,35.674468,139.741328,2024-02-08 13:54:04
225,A6-17.東京ガーデンテラス紀尾井町（プリンス通り側）,12,0,12,35.680431,139.738203,2024-02-08 13:54:04
226,B4-07.勝どき駅地下駐輪場,56,5,61,35.658135,139.776131,2024-02-08 13:54:04
227,B4-08.東京ミッドベイ勝どき（西仲通り）,4,14,18,35.656449,139.771302,2024-02-08 13:54:04
228,B3-04.築地市場駅地下駐輪場,17,0,17,35.664265,139.767426,2024-02-08 13:54:04
229,C5-10.シーバンス,11,2,13,35.649959,139.756068,2024-02-08 13:54:04
230,H1-34.門前仲町駅,47,3,50,35.67391,139.796165,2024-02-08 13:54:04
231,C3-10.ファミリーマート特許庁前店,0,6,6,35.670364,139.744684,2024-02-08 13:54:04
232,A1-01.千代田区役所,6,0,6,35.693799,139.753281,2024-02-08 13:54:04
233,A1-03.東京区政会館（メトロA5出口）,7,0,7,35.701073,139.747525,2024-02-08 13:54:04
234,B3-06.朝日新聞東京本社,4,0,4,35.664457,139.767214,2024-02-08 13:54:04
235,A1-04.東京区政会館（西側駐輪場）,7,0,7,35.701347,139.746951,2024-02-08 13:54:04
236,T1-03.四季の香公園,5,0,5,35.760585,139.626284,2024-02-08 13:54:04
237,T1-04.春の風公園,3,0,3,35.75731,139.624922,2024-02-08 13:54:04
238,T1-05.夏の雲公園,5,0,5,35.753964,139.629116,2024-02-08 13:54:04
239,H1-194.セブン-イレブン江東北砂5丁目店,0,5,5,35.68268,139.8353,2024-02-08 13:54:04
240,O5-03.新高円寺地下自転車駐輪場,5,9,14,35.697265,139.649397,2024-02-08 13:54:04
241,O3-06.アミーズ荻窪,3,1,4,35.714616,139.625116,2024-02-08 13:54:04
242,T2-03.リヴィンオズ大泉店,7,1,8,35.752383,139.594855,2024-02-08 13:54:04
243,O6-06.上高井戸1丁目,0,7,7,35.673055,139.611293,2024-02-08 13:54:04
244,T2-05.石神井図書館,3,1,4,35.736076,139.599676,2024-02-08 13:54:04
245,O5-02.馬橋ハイツ,4,2,6,35.705686,139.642587,2024-02-08 13:54:04
246,N1-07.プランドール上鷺宮,1,6,7,35.733292,139.630369,2024-02-08 13:54:04
247,E1-18.アーバネックス小石川春日,1,6,7,35.709261,139.746374,2024-02-08 13:54:04
248,T3-03.新桜台駅自転車駐車場,4,3,7,35.740378,139.667502,2024-02-08 13:54:04
249,O3-05.Nちゃりパーク,16,6,22,35.70389,139.6185,2024-02-08 13:54:04
250,O5-01.朝霞ハイツ,7,4,11,35.71038,139.64519,2024-02-08 13:54:04
251,L1-11.アイムタウン上祖師谷,2,1,3,35.656849,139.594422,2024-02-08 13:54:04
252,L1-12.鈴木リースホーム駐車場,11,3,14,35.646648,139.633038,2024-02-08 13:54:04
253,L1-13.わびさびホステル,2,2,4,35.647393,139.667085,2024-02-08 13:54:04
254,G2-05.リアナスカイパーク押上,5,1,6,35.715733,139.815451,2024-02-08 13:54:04
255,T3-02.早宮第二自転車駐車場,7,4,11,35.756846,139.652154,2024-02-08 13:54:04
256,I1-37.ガーデンシティ品川御殿山,6,3,9,35.623466,139.734359,2024-02-08 13:54:04
257,T2-47.上石神井駅北第二自転車駐車場,6,4,10,35.726523,139.5905,2024-02-08 13:54:04
258,C1-51.環二新橋四丁目,9,3,12,35.663843,139.757697,2024-02-08 13:54:04
259,M6-07.笹塚東,15,6,21,35.675436,139.670594,2024-02-08 13:54:04
260,M3-10.ウノサワ東急ビル,8,0,8,35.647757,139.712981,2024-02-08 13:54:04
261,C2-26.一の橋公園,6,1,7,35.655367,139.738075,2024-02-08 13:54:04
262,H1-14.ホテルリブマックス東京潮見駅前,4,1,5,35.658351,139.818229,2024-02-08 13:54:04
263,D2-12.ヴィアイン飯田橋後楽園,0,14,14,35.705774,139.743366,2024-02-08 13:54:04
264,D3-08.ホテルリブマックス高田馬場駅前,8,0,8,35.712952,139.701356,2024-02-08 13:54:04
265,H1-103.清澄庭園,4,5,9,35.680948,139.796917,2024-02-08 13:54:04
266,H1-104.木場公園,0,18,18,35.676488,139.809616,2024-02-08 13:54:04
267,H1-105.猿江恩賜公園,7,1,8,35.692277,139.817491,2024-02-08 13:54:04
268,G4-07.ディアレイシャス両国,2,2,4,35.69955,139.803204,2024-02-08 13:54:04
269,T2-46.大泉郵便局バス停自転車駐車場,0,9,9,35.766491,139.587232,2024-02-08 13:54:04
270,I1-18.東品川公園,5,1,6,35.61379,139.746617,2024-02-08 13:54:04
271,J1-03.西郷山公園,5,1,6,35.650688,139.696696,2024-02-08 13:54:04
272,J1-02.駒場野公園,10,4,14,35.657718,139.681043,2024-02-08 13:54:04
273,D2-14.ローソン 神楽坂駅北店,0,17,17,35.704201,139.735815,2024-02-08 13:54:04
274,K1-65.下丸子3丁目,7,5,12,35.571711,139.685337,2024-02-08 13:54:04
275,T2-43.学園通り自転車駐車場,8,0,8,35.7547,139.5871,2024-02-08 13:54:04
276,I1-46.セブン-イレブン 品川東中延2丁目店,0,7,7,35.608721,139.714158,2024-02-08 13:54:04
277,T2-04.石神井公園駅南口,11,1,12,35.743354,139.606592,2024-02-08 13:54:04
278,J1-06.観音橋自転車置場,33,12,45,35.642251,139.69692,2024-02-08 13:54:04
279,J1-05.東山公園　北,0,13,13,35.64853,139.686309,2024-02-08 13:54:04
280,J1-45.プラウド中目黒,0,3,3,35.63767,139.7045,2024-02-08 13:54:04
281,H1-168.大島五丁目公園,12,1,13,35.68642,139.836151,2024-02-08 13:54:04
282,J1-47.本町みなみ街かど公園,4,13,17,35.61847,139.70019,2024-02-08 13:54:04
283,J1-48.グランドエクセル祐天寺,0,19,19,35.64372,139.68777,2024-02-08 13:54:04
284,K1-101.小池公園,0,5,5,35.599541,139.697962,2024-02-08 13:54:04
285,H1-171.LOGI’Q南砂町,6,2,8,35.672877,139.842339,2024-02-08 13:54:04
286,H1-153.三井リンクラボ新木場1,8,2,10,35.63851,139.823534,2024-02-08 13:54:04
287,H1-154.やぐら橋下,20,0,20,35.631132,139.792726,2024-02-08 13:54:04
288,D5-11.NTTコミュニケーションズ新宿ビル,2,7,9,35.699312,139.696468,2024-02-08 13:54:04
289,C5-31.ヒルトン東京お台場,3,7,10,35.626267,139.771438,2024-02-08 13:54:04
290,K1-78.城南鋳物団地協同組合,0,10,10,35.567562,139.766854,2024-02-08 13:54:04
291,I1-68.八潮公園第二,0,8,8,35.600003,139.754288,2024-02-08 13:54:04
292,I1-67.八潮公園第一,0,11,11,35.601149,139.754284,2024-02-08 13:54:04
293,H1-123.ダイワロイネットホテル東京有明,19,2,21,35.634316,139.793199,2024-02-08 13:54:04
294,J1-24.ボヌールREIWA,4,1,5,35.612389,139.676238,2024-02-08 13:54:04
295,B2-12.東京ダイヤビルディング（東側）,16,2,18,35.674835,139.785656,2024-02-08 13:54:04
296,J1-15.二の橋自転車置場2,14,2,16,35.614391,139.678396,2024-02-08 13:54:04
297,H1-77.ライフ東砂店,0,11,11,35.684641,139.844243,2024-02-08 13:54:04
298,D1-09.NTT四谷ビル,1,2,3,35.691188,139.712079,2024-02-08 13:54:04
299,E4-11.プライマル千石,0,14,14,35.727519,139.742815,2024-02-08 13:54:04
300,I1-23.東海橋防災船着場,0,14,14,35.616114,139.74033,2024-02-08 13:54:04
301,A4-12.東京ミッドタウン日比谷,4,0,4,35.674274,139.759111,2024-02-08 13:54:04
302,K1-46.池上駅前自転車駐車場,6,6,12,35.571478,139.702779,2024-02-08 13:54:04
303,I1-24.しながわ区民公園(中央口),2,12,14,35.593611,139.738056,2024-02-08 13:54:04
304,T2-13.セブン-イレブン 練馬石神井町8丁目店,0,5,5,35.750414,139.600011,2024-02-08 13:54:04
305,O3-04.アヴァンセ阿佐ヶ谷,2,0,2,35.712,139.62816,2024-02-08 13:54:04
306,B4-01.黎明橋公園（駐輪場）,2,10,12,35.656071,139.780068,2024-02-08 13:54:04
307,T2-32.セブン-イレブン 練馬東大泉NTTビル店,4,4,8,35.750761,139.594457,2024-02-08 13:54:04
308,K1-142.コーラル洗足池,9,1,10,35.604567,139.689096,2024-02-08 13:54:04
309,K1-28.鵜の木特別出張所,4,0,4,35.574886,139.685122,2024-02-08 13:54:04
310,T1-02.ホテルカデンツァ東京,12,0,12,35.755106,139.621675,2024-02-08 13:54:04
311,C2-16.ザ・ベルグレイヴィア麻布,0,6,6,35.657264,139.743821,2024-02-08 13:54:04
312,N3-11.上高田区民活動センター,3,2,5,35.711501,139.672761,2024-02-08 13:54:04
313,T3-30.北西大松公園,2,2,4,35.765979,139.64931,2024-02-08 13:54:04
314,D6-05.新宿中央公園（水の広場）,5,1,6,35.690474,139.690219,2024-02-08 13:54:04
315,D6-07.新宿フロントタワー,3,5,8,35.696387,139.689924,2024-02-08 13:54:04
316,T2-73.早実グラウンド記念公園,2,2,4,35.734615,139.576214,2024-02-08 13:54:04
317,O7-03.永福町西幸モータープール東,2,9,11,35.67156,139.64609,2024-02-08 13:54:04
318,D1-03.新左門児童遊園,0,5,5,35.684523,139.720519,2024-02-08 13:54:04
319,D1-04.四谷見附公園,0,31,31,35.683448,139.728425,2024-02-08 13:54:04
320,I1-54.天王洲オーシャンスクエア,12,4,16,35.622356,139.749468,2024-02-08 13:54:04
321,D6-01.新宿区役所本庁舎,45,0,45,35.693602,139.703229,2024-02-08 13:54:04
322,D6-02.新宿区役所第二分庁舎,35,0,35,35.693976,139.706134,2024-02-08 13:54:04
323,D6-03.新宿中央公園（ポケットパーク）,9,0,9,35.691559,139.690029,2024-02-08 13:54:04
324,D6-04.新宿中央公園（ちびっこ広場）,7,2,9,35.686649,139.689821,2024-02-08 13:54:04
325,A6-21.日本工営ビル,2,2,4,35.684584,139.734442,2024-02-08 13:54:04
326,I1-77.セブン-イレブン品川西中延1丁目店,0,20,20,35.612217,139.708164,2024-02-08 13:54:04
327,T1-01.光が丘駅前広場,11,2,13,35.759164,139.629466,2024-02-08 13:54:04
328,T2-37.上石神井2丁目,2,6,8,35.729615,139.59532,2024-02-08 13:54:04
329,I1-75.セブン-イレブン品川二葉4丁目店,0,7,7,35.603275,139.713428,2024-02-08 13:54:04
330,M5-13.セブン-イレブン初台店,0,13,13,35.675049,139.68444,2024-02-08 13:54:04
331,D6-24.ＮＴＴ東日本 本社ビル,9,3,12,35.683102,139.688852,2024-02-08 13:54:04
332,H1-134.豊洲ぐるり公園,11,11,22,35.643141,139.777821,2024-02-08 13:54:04
333,H1-133.北砂2丁目公園,0,28,28,35.679001,139.825809,2024-02-08 13:54:04
334,E3-08.サガラマンション,0,4,4,35.722833,139.734662,2024-02-08 13:54:04
335,O4-05.阿佐ヶ谷南1-30,1,2,3,35.700703,139.639985,2024-02-08 13:54:04
336,O5-06.EXAM高円寺南,5,0,5,35.70273,139.65864,2024-02-08 13:54:04
337,G2-03.押上１丁目２６-４,5,0,5,35.710323,139.815215,2024-02-08 13:54:04
338,K1-132.多摩川駅前自転車等駐車場,15,0,15,35.587232,139.669519,2024-02-08 13:54:04
339,C5-47.oak港南品川,23,2,25,35.62413,139.744831,2024-02-08 13:54:04
340,D3-15.カースルいずみ,7,7,14,35.711324,139.711976,2024-02-08 13:54:04
341,C5-15.セブン-イレブン 港区芝浦ふ頭店,0,7,7,35.640215,139.755971,2024-02-08 13:54:04
342,C5-14.セブン-イレブン 港区汐彩橋店,0,17,17,35.640481,139.753659,2024-02-08 13:54:04
343,D5-01.新宿コズミックセンター,0,8,8,35.705244,139.70841,2024-02-08 13:54:04
344,H1-45.夢の島競技場,18,2,20,35.648596,139.824936,2024-02-08 13:54:04
345,E1-01.後楽橋横,24,1,25,35.702746,139.752009,2024-02-08 13:54:04
346,B1-15.ロイヤルパークホテル,0,13,13,35.682332,139.78722,2024-02-08 13:54:04
347,C4-05.白金台駅自転車駐車場,5,10,15,35.638927,139.727083,2024-02-08 13:54:04
348,E1-02.東京ドーム（ミーツポート）,8,1,9,35.70311,139.754951,2024-02-08 13:54:04
349,M2-06.あいおいニッセイ同和損保恵比寿ビル,7,0,7,35.647237,139.71512,2024-02-08 13:54:04
350,J1-12.工大橋下流自転車置場,3,0,3,35.605828,139.680265,2024-02-08 13:54:04
351,C5-25.NEX-TEC芝浦,38,0,38,35.639571,139.755551,2024-02-08 13:54:04
352,H1-175.ダイアパレス大島駅前,0,2,2,35.689543,139.836394,2024-02-08 13:54:04
353,C1-65.東京ポートシティ竹芝,10,3,13,35.654757,139.761516,2024-02-08 13:54:04
354,O2-03.西荻北5-8-17,3,2,5,35.709712,139.601846,2024-02-08 13:54:04
355,B2-21.八重洲二丁目北地区広場,2,0,2,35.67942,139.77004,2024-02-08 13:54:04
356,I1-101.下神明駅前,25,0,25,35.60838,139.726587,2024-02-08 13:54:04
357,N2-04.野方2丁目,6,0,6,35.713018,139.656768,2024-02-08 13:54:04
358,N2-05.野方3丁目,0,12,12,35.717877,139.654732,2024-02-08 13:54:04
359,K1-88.大田久が原西郵便局,0,6,6,35.582756,139.6925,2024-02-08 13:54:04
360,C5-51.トミンタワー台場一番街,1,9,10,35.634627,139.77663,2024-02-08 13:54:04
361,C4-10.亀塚公園,10,0,10,35.642764,139.741174,2024-02-08 13:54:04
362,H1-190.福山通運 東京支店,0,26,26,35.664845,139.796643,2024-02-08 13:54:04
363,C1-80.浜松町262ビル,9,3,12,35.654289,139.75557,2024-02-08 13:54:04
364,B2-19.リエトコートアルクスタワー,0,9,9,35.670506,139.77854,2024-02-08 13:54:04
365,C1-79.髙松コンストラクショングループ 東京本社ビル,0,6,6,35.648765,139.753363,2024-02-08 13:54:04
366,C5-43.オアーゼ芝浦MJビル,7,2,9,35.644798,139.752697,2024-02-08 13:54:04
367,J1-44.五本木2丁目,1,7,8,35.634441,139.687186,2024-02-08 13:54:04
368,B2-17.アーバネックス八丁堀,3,0,3,35.67518,139.77364,2024-02-08 13:54:04
369,M6-16.パールマンション,2,0,2,35.67464,139.67876,2024-02-08 13:54:04
370,G4-06.ドムス・スタイル両国,0,7,7,35.700453,139.798978,2024-02-08 13:54:04
371,G2-04.ラ　ステュディオ押上,3,2,5,35.712157,139.815298,2024-02-08 13:54:04
372,T3-15.セブン-イレブン練馬北町8丁目店,6,0,6,35.768105,139.646049,2024-02-08 13:54:04
373,C1-77.芝公園,13,5,18,35.65513,139.749645,2024-02-08 13:54:04
374,I1-27.小関橋公園,1,2,3,35.620699,139.730904,2024-02-08 13:54:04
375,B3-01.中央区役所,6,0,6,35.670855,139.772052,2024-02-08 13:54:04
376,A6-08.二番町ガーデン,4,1,5,35.685489,139.734562,2024-02-08 13:54:04
377,B1-01.十思公園,0,10,10,35.691058,139.777915,2024-02-08 13:54:04
378,B4-02.月島特別出張所,0,41,41,35.662197,139.782719,2024-02-08 13:54:04
379,A4-05.大手町タワー,16,1,17,35.685938,139.764886,2024-02-08 13:54:04
380,H1-22.豊洲市場（7街区）,28,42,70,35.6447,139.784512,2024-02-08 13:54:04
381,A6-07.二番町センタービル,0,3,3,35.685966,139.736328,2024-02-08 13:54:04
382,A2-12.神保町三井ビルディング,10,0,10,35.694532,139.760695,2024-02-08 13:54:04
383,E2-06.oto no ha Cafe,0,4,4,35.713991,139.725665,2024-02-08 13:54:04
384,B4-10.リバーシティ,0,14,14,35.668795,139.784784,2024-02-08 13:54:04
385,B1-03.常盤公園（北側）,7,2,9,35.688405,139.770068,2024-02-08 13:54:04
386,C5-19.グランドメゾン田町,6,1,7,35.645537,139.754899,2024-02-08 13:54:04
387,K1-11.ファミリーマート かわだ多摩川２丁目店,0,4,4,35.558289,139.697403,2024-02-08 13:54:04
388,J1-43.アルコタワー・ホテル雅叙園東京,12,0,12,35.63237,139.712681,2024-02-08 13:54:04
389,N1-03.鷺宮南駐輪場,6,3,9,35.721827,139.635949,2024-02-08 13:54:04
390,N2-06.江古田1丁目B,2,3,5,35.72515,139.672614,2024-02-08 13:54:04
391,D7-12.プラウド高田馬場,4,1,5,35.715538,139.701683,2024-02-08 13:54:04
392,K1-118.久が原3丁目,0,9,9,35.580741,139.687152,2024-02-08 13:54:04
393,K1-125.池上駅南口第1,0,2,2,35.571866,139.703214,2024-02-08 13:54:04
394,K1-117.安詳寺,5,14,19,35.581798,139.695222,2024-02-08 13:54:04
395,I1-91.アクロス目黒タワー,8,2,10,35.634019,139.719749,2024-02-08 13:54:04
396,K1-126.池上駅南口第2,2,1,3,35.571815,139.702387,2024-02-08 13:54:04
397,C5-50.お台場レインボー公園,12,0,12,35.633133,139.777315,2024-02-08 13:54:04
398,T3-26.富士見ランド公園,0,8,8,35.73701,139.627244,2024-02-08 13:54:04
399,T1-15.つのの山緑地,4,0,4,35.765144,139.636606,2024-02-08 13:54:04
400,T1-16.ゆりの木通り南公園,3,1,4,35.767582,139.636304,2024-02-08 13:54:04
401,H1-185.UR大島六丁目団地(第二),0,3,3,35.690038,139.833252,2024-02-08 13:54:04
402,H1-186.セブン-イレブン亀戸昭和橋通り店,0,9,9,35.694804,139.831357,2024-02-08 13:54:04
403,K1-96.西馬込駅前自転車駐車場,10,4,14,35.586408,139.705425,2024-02-08 13:54:04
404,H1-184.UR大島六丁目団地(第一),3,3,6,35.689913,139.833279,2024-02-08 13:54:04
405,A6-25.麹町仮住宅,4,0,4,35.679192,139.74019,2024-02-08 13:54:04
406,C1-69.塩釜公園,0,11,11,35.662908,139.755014,2024-02-08 13:54:04
407,C1-68.桜田公園,26,2,28,35.665214,139.757008,2024-02-08 13:54:04
408,A2-14.興和一橋ビル,15,0,15,35.6927,139.759311,2024-02-08 13:54:04
409,C5-41.トヨタモビリティ東京 芝浦店,3,4,7,35.639644,139.745532,2024-02-08 13:54:04
410,T2-22.ファミリーマート 石神井台7丁目店,4,1,5,35.731909,139.579685,2024-02-08 13:54:04
411,A6-20.紀尾井町PREX,6,0,6,35.68369,139.736936,2024-02-08 13:54:04
412,C5-24.GLOBAL FRONT TOWER,1,14,15,35.647713,139.755534,2024-02-08 13:54:04
413,E5-09.文京区 男女平等センター,3,12,15,35.70861,139.75768,2024-02-08 13:54:04
414,K1-37.東京サーハウス前,17,4,21,35.563874,139.685011,2024-02-08 13:54:04
415,B4-15.リバーシティ　イーストタワーズ,0,17,17,35.669188,139.785301,2024-02-08 13:54:04
416,M6-08.Be Good 幡ヶ谷,0,13,13,35.682453,139.677687,2024-02-08 13:54:04
417,D5-09.ハウジングステージ新宿,7,6,13,35.702277,139.701214,2024-02-08 13:54:04
418,D6-21.新宿5丁目,2,5,7,35.691613,139.711233,2024-02-08 13:54:04
419,K1-39.東京モノレール 流通センター駅前,27,2,29,35.581752,139.748705,2024-02-08 13:54:04
420,K1-38.ネクストサイト蒲田ビル,9,0,9,35.558916,139.717253,2024-02-08 13:54:04
421,T3-17.練馬区役所東庁舎(第二),5,0,5,35.735585,139.652544,2024-02-08 13:54:04
422,H1-107.大島小松川公園,0,27,27,35.692641,139.846346,2024-02-08 13:54:04
423,B1-11.浜町川緑道,2,45,47,35.684158,139.787649,2024-02-08 13:54:04
424,A6-19.番町麹町ビルディング,12,0,12,35.685578,139.732078,2024-02-08 13:54:04
425,B3-12.築地場外市場,13,5,18,35.665254,139.769301,2024-02-08 13:54:04
426,I1-40.御殿山トラストタワー,26,0,26,35.622371,139.737457,2024-02-08 13:54:04
427,M5-08.古賀政男音楽博物館,2,0,2,35.668091,139.680243,2024-02-08 13:54:04
428,H1-90.富士倉庫運輸(株) FACE-1前,0,10,10,35.655102,139.805205,2024-02-08 13:54:04
429,A3-38.パークホームズ千代田淡路町,4,0,4,35.695163,139.769566,2024-02-08 13:54:04
430,D2-11.神楽坂アインスタワー,2,4,6,35.702833,139.739,2024-02-08 13:54:04
431,C2-04.飯倉いきいきプラザ,0,4,4,35.656991,139.740739,2024-02-08 13:54:04
432,B1-09.スマイルホテル日本橋三越前,18,0,18,35.686101,139.776089,2024-02-08 13:54:04
433,E5-15.文京千駄木の郷,7,4,11,35.726499,139.759884,2024-02-08 13:54:04
434,C2-05.ありすいきいきプラザ,9,4,13,35.651046,139.727745,2024-02-08 13:54:04
435,C5-06.品川シーズンテラス,19,0,19,35.632303,139.742393,2024-02-08 13:54:04
436,B1-10.箱崎川第二公園,6,3,9,35.680833,139.784267,2024-02-08 13:54:04
437,L1-15.ソフィア,0,3,3,35.663222,139.587803,2024-02-08 13:54:04
438,A3-12.秋葉原UDX北側駐輪場前,15,0,15,35.70111,139.772855,2024-02-08 13:54:04
439,A2-08.KDX御茶ノ水ビル,6,3,9,35.700568,139.76013,2024-02-08 13:54:04
440,A3-07.淡路公園,4,2,6,35.696942,139.767302,2024-02-08 13:54:04
441,A1-08.飯田橋サクラテラス（早稲田通り）,10,1,11,35.699132,139.74462,2024-02-08 13:54:04
442,A3-13.富士ソフトビル（駐車場入口横）,3,15,18,35.700486,139.774254,2024-02-08 13:54:04
443,A2-09.テラススクエア,8,0,8,35.6931,139.7599,2024-02-08 13:54:04
444,A6-11.東京ガーデンテラス紀尾井町,17,5,22,35.67962,139.7364,2024-02-08 13:54:04
445,K1-124.矢口2丁目,1,4,5,35.564161,139.695187,2024-02-08 13:54:04
446,N3-15.ライオンズマンション中野東,1,2,3,35.71046,139.6855,2024-02-08 13:54:04
447,M3-11.渋谷道玄坂東急ビル,9,0,9,35.65718,139.698687,2024-02-08 13:54:04
448,H1-180.シティコート大島,8,0,8,35.691954,139.836462,2024-02-08 13:54:04
449,B1-27.日本橋本町4丁目,24,4,28,35.68973,139.77598,2024-02-08 13:54:04
450,M3-22.森谷ビル,15,0,15,35.64514,139.71686,2024-02-08 13:54:04
451,N3-17.東中野3丁目,9,1,10,35.70862,139.680679,2024-02-08 13:54:04
452,N2-10.関根ビル,0,5,5,35.733432,139.671241,2024-02-08 13:54:04
453,T1-06.秋の陽公園,5,0,5,35.762326,139.635226,2024-02-08 13:54:04
454,N1-02.鷺宮東駐輪場,0,14,14,35.721556,139.640397,2024-02-08 13:54:04
455,K1-140.西馬込駅前自転車駐車場(奥),14,0,14,35.586382,139.705116,2024-02-08 13:54:04
456,H1-182.錦糸町プライムタワー,13,1,14,35.695695,139.820507,2024-02-08 13:54:04
457,E5-05.駒込地域活動センター,0,9,9,35.728644,139.752183,2024-02-08 13:54:04
458,M3-06.渋谷第一生命ビル,5,0,5,35.657556,139.704129,2024-02-08 13:54:04
459,T2-42.石神井公園駅北第二自転車駐車場,2,3,5,35.74553,139.608939,2024-02-08 13:54:04
460,K1-144.蒲田五丁目44番自転車駐車場,10,0,10,35.559809,139.716993,2024-02-08 13:54:04
461,M3-07.渋谷ファーストプレイス,10,0,10,35.65506,139.69384,2024-02-08 13:54:04
462,H1-74.タダノ教習センター,9,1,10,35.63848,139.832305,2024-02-08 13:54:04
463,H1-151.コスモリード錦糸町,0,9,9,35.701347,139.819973,2024-02-08 13:54:04
464,T2-23.セブン-イレブン 練馬南大泉5丁目店,6,0,6,35.750185,139.579216,2024-02-08 13:54:04
465,M4-13.J-cube,3,0,3,35.66616,139.70458,2024-02-08 13:54:04
466,T2-65.さくらの辻公園,0,5,5,35.734805,139.599906,2024-02-08 13:54:04
467,T2-24.セブン-イレブン 練馬インター店,0,26,26,35.754586,139.606409,2024-02-08 13:54:04
468,O5-05.モンテ・ベルテ,0,2,2,35.701454,139.650518,2024-02-08 13:54:04
469,J1-42.都立大学駅北口バス停前,3,6,9,35.618622,139.67596,2024-02-08 13:54:04
470,K1-97.トミンタワー多摩川二丁目,0,13,13,35.555561,139.704345,2024-02-08 13:54:04
471,D1-14.コモレ四谷,0,5,5,35.68752,139.72818,2024-02-08 13:54:04
472,K1-106.ファミリーマート上池台夫婦坂店,1,8,9,35.599329,139.703343,2024-02-08 13:54:04
473,J1-39.松見坂公園,0,10,10,35.655483,139.687325,2024-02-08 13:54:04
474,J1-40.西小山公園,5,2,7,35.616541,139.697369,2024-02-08 13:54:04
475,J1-38.林試の森公園 北,6,6,12,35.626355,139.700153,2024-02-08 13:54:04
476,I1-84.セブン-イレブン西品川2丁目店,0,3,3,35.613819,139.728418,2024-02-08 13:54:04
477,D6-26.セブン-イレブン新宿６丁目文化センター通り店,7,2,9,35.694951,139.708219,2024-02-08 13:54:04
478,T2-25.ファミリーマート 高野台二丁目店,0,4,4,35.746045,139.620087,2024-02-08 13:54:04
479,I1-85.GOODOFFICE品川,2,3,5,35.621081,139.741178,2024-02-08 13:54:04
480,K1-74.大田スタジアム,4,3,7,35.587423,139.753871,2024-02-08 13:54:04
481,C1-64.東京虎ノ門グローバルスクエア,3,2,5,35.669941,139.749261,2024-02-08 13:54:04
482,K1-72.ファミリーマート大森西四丁目店,0,6,6,35.573358,139.723105,2024-02-08 13:54:04
483,H1-118.ファミリーマート亀戸駅前店,6,5,11,35.69839,139.825484,2024-02-08 13:54:04
484,I1-62.天王洲Rim,0,7,7,35.622277,139.745638,2024-02-08 13:54:04
485,H1-40.深川東京モダン館,4,1,5,35.674076,139.795008,2024-02-08 13:54:04
486,H1-117.東京パークサイドビル,8,1,9,35.671225,139.808561,2024-02-08 13:54:04
487,J1-01.目黒区総合庁舎,8,1,9,35.640675,139.698088,2024-02-08 13:54:04
488,C5-16.品川インターシティ,23,0,23,35.626704,139.742174,2024-02-08 13:54:04
489,A1-12.北の丸スクエア,7,0,7,35.695515,139.750213,2024-02-08 13:54:04
490,H1-46.セブン-イレブン 江東枝川2丁目店,0,21,21,35.659287,139.807358,2024-02-08 13:54:04
491,A2-25.プラウド神田駿河台,11,2,13,35.698991,139.76091,2024-02-08 13:54:04
492,C5-49.プラウドタワー芝浦,0,14,14,35.638912,139.747422,2024-02-08 13:54:04
493,T3-25.北町みのり公園,0,4,4,35.767627,139.65243,2024-02-08 13:54:04
494,H1-75.ジオ深川住吉,1,9,10,35.684247,139.815638,2024-02-08 13:54:04
495,T1-09.ローソン練馬旭町一丁目店,4,1,5,35.765704,139.625178,2024-02-08 13:54:04
496,T2-26.ファミリーマート 大泉学園町四丁目店,0,7,7,35.767388,139.587625,2024-02-08 13:54:04
497,T2-27.ファミリーマート 大泉長久保通り店,2,3,5,35.773841,139.591456,2024-02-08 13:54:04
498,C3-19.明治記念館西,3,1,4,35.678179,139.720809,2024-02-08 13:54:04
499,I1-11.鮫洲入江広場,11,3,14,35.603984,139.744504,2024-02-08 13:54:04
500,I1-10.品川シーサイド公園第1,12,6,18,35.607717,139.749478,2024-02-08 13:54:04
501,I1-09.東品川海上公園第1,0,12,12,35.616633,139.748945,2024-02-08 13:54:04
502,D3-06.セブン-イレブン高田馬場3丁目中央店,0,7,7,35.713872,139.698301,2024-02-08 13:54:04
503,K1-40.大田文化の森,0,17,17,35.579649,139.720263,2024-02-08 13:54:04
504,C1-41.港区立エコプラザ,7,2,9,35.658709,139.757036,2024-02-08 13:54:04
505,I1-13.八潮北公園,0,11,11,35.613421,139.75375,2024-02-08 13:54:04
506,I1-12.しながわ区民公園（北側）,2,2,4,35.596091,139.740884,2024-02-08 13:54:04
507,T3-31.パークサイド関口,3,5,8,35.74097,139.63836,2024-02-08 13:54:04
508,H1-183.MFLP新木場1,2,2,4,35.643958,139.838358,2024-02-08 13:54:04
509,T2-33.ウインドヒルズ189,2,4,6,35.74642,139.581204,2024-02-08 13:54:04
510,T2-67.陽和病院,0,7,7,35.761211,139.603316,2024-02-08 13:54:04
511,H1-82.セブンｰイレブン 北砂3丁目明治通り店,0,20,20,35.683514,139.827081,2024-02-08 13:54:04
512,T2-60.武蔵関公園（第一）,9,0,9,35.724747,139.565817,2024-02-08 13:54:04
513,I1-48.NTT 東日本 関東病院(北側),6,3,9,35.632191,139.725002,2024-02-08 13:54:04
514,T2-58.立野公園,3,2,5,35.716776,139.577975,2024-02-08 13:54:04
515,I1-100.東急荏原中延駅駐輪場,2,5,7,35.610444,139.712333,2024-02-08 13:54:04
516,T2-56.大泉公園（第一）,2,2,4,35.77228,139.58325,2024-02-08 13:54:04
517,T2-55.大泉町もみじやま公園,1,2,3,35.767296,139.602321,2024-02-08 13:54:04
518,T2-54.土支田農業公園,0,9,9,35.760939,139.609264,2024-02-08 13:54:04
519,I1-44.大井三ツ又商店街入口,7,0,7,35.604606,139.734483,2024-02-08 13:54:04
520,T2-62.大泉井頭公園,6,4,10,35.746681,139.57754,2024-02-08 13:54:04
521,T2-61.武蔵関公園（第二）,4,0,4,35.727826,139.570056,2024-02-08 13:54:04
522,T3-09.学田公園,4,1,5,35.730428,139.648704,2024-02-08 13:54:04
523,K1-105.東糀谷二丁目児童公園,0,7,7,35.555702,139.740802,2024-02-08 13:54:04
524,T3-04.サンパレス平和台,8,4,12,35.759827,139.659121,2024-02-08 13:54:04
525,K1-104.六郷BASE,1,5,6,35.543573,139.714393,2024-02-08 13:54:04
526,M4-16.神宮前6丁目,2,1,3,35.668673,139.702816,2024-02-08 13:54:04
527,K1-69.京急平和島第2Bバイク駐輪場,0,4,4,35.585747,139.735242,2024-02-08 13:54:04
528,H1-155.メブクス豊洲,6,14,20,35.645726,139.784496,2024-02-08 13:54:04
529,C2-11.一の橋,12,41,53,35.654726,139.737491,2024-02-08 13:54:04
530,C4-11.ザ・パークハウス 三田ガーデン,0,14,14,35.64816,139.737991,2024-02-08 13:54:04
531,H1-161.昭文社制作本部ビル,4,2,6,35.684003,139.794983,2024-02-08 13:54:04
532,N2-07.新井区民活動センター,1,4,5,35.714292,139.663327,2024-02-08 13:54:04
533,K1-87.羽田イノベーションシティ,2,8,10,35.547061,139.756277,2024-02-08 13:54:04
534,N3-16.COURT 5,5,0,5,35.699743,139.664608,2024-02-08 13:54:04
535,C4-01.高輪地区総合支所(5F),1,10,11,35.641833,139.734519,2024-02-08 13:54:04
536,C5-48.セブンイレブン港区海岸三丁目店,1,6,7,35.636808,139.752517,2024-02-08 13:54:04
537,H1-42.江東区スポーツ会館,0,29,29,35.683961,139.821559,2024-02-08 13:54:04
538,B2-10.東京ダイヤビルディング（北側）,0,12,12,35.675702,139.785229,2024-02-08 13:54:04
539,H1-43.東京イースト21,0,16,16,35.675639,139.815255,2024-02-08 13:54:04
540,B3-20.歌舞伎座タワー駐輪場2F,7,0,7,35.670106,139.768041,2024-02-08 13:54:04
541,B3-21.歌舞伎座タワー駐輪場3F,10,0,10,35.6701,139.76801,2024-02-08 13:54:04
542,K1-139.プラットホステル京急 羽田ホーム,8,2,10,35.548104,139.748889,2024-02-08 13:54:04
543,J1-58.目黒女子会館前,3,2,5,35.629011,139.69716,2024-02-08 13:54:04
544,T2-18.ファミリーマート練馬西税務署前店,3,1,4,35.745505,139.580878,2024-02-08 13:54:04
545,C3-23.LIFORK 南青山 北エントランス,14,15,29,35.669916,139.725701,2024-02-08 13:54:04
546,C1-46.新虎通りCORE,16,1,17,35.665124,139.754054,2024-02-08 13:54:04
547,C1-45.浜松町クレアタワー,15,3,18,35.656324,139.755927,2024-02-08 13:54:04
548,K1-53.セブン-イレブン 田園調布郵便局前店,15,5,20,35.589309,139.678587,2024-02-08 13:54:04
549,K1-52.大田区総合体育館,7,0,7,35.564152,139.727422,2024-02-08 13:54:04
550,T1-12.ファミリーマート 高松六丁目店,4,0,4,35.756873,139.616612,2024-02-08 13:54:04
551,D7-07.ローソン 新宿西落合三丁目店,0,5,5,35.725171,139.675897,2024-02-08 13:54:04
552,A6-16.一番町第二TGビル,3,2,5,35.688351,139.744321,2024-02-08 13:54:04
553,C3-33.PASONA SQUARE,13,0,13,35.667462,139.716058,2024-02-08 13:54:04
554,A3-24.岩本町ほほえみプラザ,0,11,11,35.69441,139.777715,2024-02-08 13:54:04
555,H1-35.ヒューリック豊洲プライムスクエア,6,1,7,35.652376,139.797724,2024-02-08 13:54:04
556,C5-11.フェイバリッチタワー品川,0,59,59,35.631729,139.749767,2024-02-08 13:54:04
557,E2-13.デルックス文京神楽坂,1,2,3,35.70781,139.732227,2024-02-08 13:54:04
558,C5-01.こうなん星の公園,44,3,47,35.629697,139.742167,2024-02-08 13:54:04
559,C5-02.港南緑水公園,0,76,76,35.628955,139.750731,2024-02-08 13:54:04
560,A3-22.龍閑児童公園,1,7,8,35.693234,139.779702,2024-02-08 13:54:04
561,A3-21.神田ふれあい通り第３,7,5,12,35.695176,139.772832,2024-02-08 13:54:04
562,H1-30.江東区役所（北側）,8,4,12,35.67338,139.8164,2024-02-08 13:54:04
563,C1-17.港区役所,4,0,4,35.657866,139.751068,2024-02-08 13:54:04
564,H1-31.江東区役所（南側）,14,3,17,35.67214,139.8166,2024-02-08 13:54:04
565,C1-09.愛宕グリーンヒルズ,9,0,9,35.662051,139.748132,2024-02-08 13:54:04
566,D1-02.四谷特別出張所（新宿御苑大木戸門前）,16,1,17,35.687435,139.714169,2024-02-08 13:54:04
567,D1-01.花園西公園,4,1,5,35.690612,139.711631,2024-02-08 13:54:04
568,C1-04.虎ノ門ヒルズ,12,2,14,35.666527,139.748804,2024-02-08 13:54:04
569,C1-05.西新橋2丁目（新虎通り）,14,0,14,35.665593,139.752617,2024-02-08 13:54:04
570,C1-73.日比谷フォートタワー,14,0,14,35.669871,139.753147,2024-02-08 13:54:04
571,K1-102.上池台四丁目公園,0,7,7,35.595119,139.6996,2024-02-08 13:54:04
572,M2-01.恵比寿保健相談所（恵比寿社会教育館）,0,14,14,35.64524,139.71946,2024-02-08 13:54:04
573,I1-98.コーポ荏原,0,5,5,35.60411,139.709784,2024-02-08 13:54:04
574,C3-17.セブン-イレブン 港区溜池山王店,3,15,18,35.670308,139.743242,2024-02-08 13:54:04
575,T2-11.石神井松の風文化公園,2,1,3,35.739471,139.595578,2024-02-08 13:54:04
576,M2-03.サイカパーク恵比寿,15,0,15,35.646581,139.710613,2024-02-08 13:54:04
577,M2-02.アメリカ橋公園,7,1,8,35.643606,139.713099,2024-02-08 13:54:04
578,T2-50.North Ridge 吉祥寺,8,1,9,35.72305,139.579555,2024-02-08 13:54:04
579,J1-35.目黒川田道街かど公園,5,0,5,35.634574,139.710332,2024-02-08 13:54:04
580,H1-174.ジュネス(エントランス側),0,2,2,35.682712,139.823961,2024-02-08 13:54:04
581,M6-17.笹塚一丁目駐輪場,2,5,7,35.672922,139.668729,2024-02-08 13:54:04
582,C4-14.神応ほっとプラザ,3,7,10,35.643711,139.724753,2024-02-08 13:54:04
583,K1-107.馬込駅A2出口,4,6,10,35.596854,139.712139,2024-02-08 13:54:04
584,T3-11.ガラクタ公園,1,2,3,35.740321,139.631256,2024-02-08 13:54:04
585,T2-80.みその緑地,2,3,5,35.756825,139.590528,2024-02-08 13:54:04
586,T3-24.AZEST新桜台,6,1,7,35.743962,139.670315,2024-02-08 13:54:04
587,D4-07.新宿余丁町ビル,0,9,9,35.698512,139.716482,2024-02-08 13:54:04
588,T3-01.練馬春日町駅自転車駐車場,7,0,7,35.751438,139.641265,2024-02-08 13:54:04
589,H1-89.BUDDY スポーツアリーナ,6,8,14,35.637041,139.781088,2024-02-08 13:54:04
590,E5-14.上野広小路駅（湯島側）,0,13,13,35.707313,139.771857,2024-02-08 13:54:04
591,H1-109.Brillia ist 東雲キャナルコート東側,0,46,46,35.648008,139.803487,2024-02-08 13:54:04
592,H1-108.Brillia ist 東雲キャナルコート北側,0,23,23,35.648431,139.803125,2024-02-08 13:54:04
593,C1-53.ホテルリブマックス新橋,4,0,4,35.661149,139.754612,2024-02-08 13:54:04
594,D7-10.染の里 おちあい,1,5,6,35.715211,139.689788,2024-02-08 13:54:04
595,A1-15.富士見みらい館,0,5,5,35.697167,139.745629,2024-02-08 13:54:04
596,E4-15.千石4丁目,1,4,5,35.729153,139.741368,2024-02-08 13:54:04
597,H1-111.ファミリーマート木場六丁目店,0,6,6,35.66688,139.80779,2024-02-08 13:54:04
598,C5-36.お台場海浜公園駅,2,1,3,35.62974,139.778178,2024-02-08 13:54:04
599,H1-10.出会い橋,15,0,15,35.625029,139.777344,2024-02-08 13:54:04
600,H1-11.テレコムセンター駅,7,14,21,35.61813,139.778698,2024-02-08 13:54:04
601,H1-47.トピレックプラザ,0,35,35,35.672481,139.835877,2024-02-08 13:54:04
602,H1-13.アーバンドック ららぽーと豊洲,19,0,19,35.654067,139.792376,2024-02-08 13:54:04
603,T2-66.大泉学園町希望ヶ丘公園,0,4,4,35.778605,139.588883,2024-02-08 13:54:04
604,C5-37.台場駅,0,24,24,35.626388,139.772453,2024-02-08 13:54:04
605,H1-16.豊洲三丁目公園,19,0,19,35.657477,139.796629,2024-02-08 13:54:04
606,H1-17.東雲水辺公園,0,68,68,35.64704,139.80469,2024-02-08 13:54:04
607,C1-72.新田町ビル,11,0,11,35.646307,139.746428,2024-02-08 13:54:04
608,K1-98.鵜の木松山公園,2,5,7,35.577433,139.680752,2024-02-08 13:54:04
609,C1-71.芝商業高校前交差点,0,5,5,35.65583,139.759896,2024-02-08 13:54:04
610,H1-122.東砂スポーツセンター,0,11,11,35.679167,139.839746,2024-02-08 13:54:04
611,O6-05.コージーコート久我山,0,5,5,35.687531,139.60439,2024-02-08 13:54:04
612,T2-39.ローソン 練馬大泉町五丁目店,6,2,8,35.758929,139.597548,2024-02-08 13:54:04
613,J1-50.大岡山公園,2,2,4,35.609958,139.684087,2024-02-08 13:54:04
614,J1-51.池尻大橋駅東口駐輪場,0,5,5,35.650627,139.687228,2024-02-08 13:54:04
615,K1-99.東原くすのき公園,6,2,8,35.584086,139.67898,2024-02-08 13:54:04
616,N3-12.桃園区民活動センター,2,1,3,35.702414,139.667327,2024-02-08 13:54:04
617,H1-191.三井リンクラボ新木場2,14,0,14,35.644863,139.831107,2024-02-08 13:54:04
618,M5-09.代々木上原駅前,5,0,5,35.66865,139.679251,2024-02-08 13:54:04
619,O3-09.NTT井草ビル第3ポート,3,4,7,35.714151,139.61693,2024-02-08 13:54:04
620,T1-07.土支田一丁目（笹目通り）,1,9,10,35.765913,139.619285,2024-02-08 13:54:04
621,K1-22.矢口特別出張所,2,3,5,35.562324,139.690486,2024-02-08 13:54:04
622,T3-08.中新井川児童遊園,2,5,7,35.728268,139.649188,2024-02-08 13:54:04
623,H1-78.ローソン新木場一丁目店,14,0,14,35.645604,139.834941,2024-02-08 13:54:04
624,A6-13.番町会館,5,1,6,35.689131,139.733071,2024-02-08 13:54:04
625,H1-71.セブン-イレブン 江東東陽4丁目,0,5,5,35.670906,139.819386,2024-02-08 13:54:04
626,D2-09.セブン-イレブン 新宿岩戸町店,3,0,3,35.700993,139.736355,2024-02-08 13:54:04
627,I1-08.天王洲アイル第一水辺広場,23,8,31,35.622294,139.751644,2024-02-08 13:54:04
628,I1-07.しながわ水族館,3,13,16,35.590641,139.736354,2024-02-08 13:54:04
629,D3-09.西早稲田3丁目,2,2,4,35.712545,139.713319,2024-02-08 13:54:04
630,E1-16.小石川3丁目緑地,2,19,21,35.714338,139.746346,2024-02-08 13:54:04
631,C5-28.芝浦ルネサイトタワー,6,1,7,35.643683,139.7506,2024-02-08 13:54:04
632,I1-59.文庫の森第一,13,9,22,35.612357,139.721484,2024-02-08 13:54:04
633,I1-60.文庫の森第二,0,5,5,35.611368,139.720424,2024-02-08 13:54:04
634,C1-38.KDX西新橋ビル（西側）,2,2,4,35.66495,139.750459,2024-02-08 13:54:04
635,C1-37.KDX西新橋ビル（北側）,5,0,5,35.665218,139.750827,2024-02-08 13:54:04
636,T2-14.NPC24H東大泉第6パーキング,0,6,6,35.747807,139.593599,2024-02-08 13:54:04
637,C3-12.赤坂センタービルディング前（青山通り）,4,4,8,35.676732,139.733905,2024-02-08 13:54:04
638,H1-36.フジゴルフセンター,0,20,20,35.66605,139.806699,2024-02-08 13:54:04
639,C1-27.虎ノ門2丁目タワー,14,0,14,35.668547,139.747175,2024-02-08 13:54:04
640,C5-12.第2東運ビル,5,3,8,35.633742,139.748281,2024-02-08 13:54:04
641,D6-08.新宿イーストサイドスクエア,7,0,7,35.697158,139.707887,2024-02-08 13:54:04
642,A4-08.永代通り（大手町駅B2c出口前）,23,1,24,35.684349,139.766958,2024-02-08 13:54:04
643,H1-37.東雲駅（東京湾岸道路）,32,3,35,35.640618,139.802455,2024-02-08 13:54:04
644,C3-11.赤坂見附南,1,0,1,35.676566,139.737083,2024-02-08 13:54:04
645,M6-04.本町東べんてん橋公園,0,18,18,35.687126,139.680702,2024-02-08 13:54:04
646,I1-79.品川浦第二,11,0,11,35.621904,139.741429,2024-02-08 13:54:04
647,K1-81.コーナン本羽田萩中店,9,4,13,35.549568,139.731093,2024-02-08 13:54:04
648,D6-25.新宿駅東南口自転車駐輪場,28,4,32,35.689755,139.701323,2024-02-08 13:54:04
649,I1-78.セブン-イレブン西大井店,3,8,11,35.601431,139.718659,2024-02-08 13:54:04
650,H1-136.東砂一丁目公園,0,17,17,35.683542,139.839763,2024-02-08 13:54:04
651,A6-23.セブン-イレブン 千代田三番町店,0,14,14,35.689466,139.745316,2024-02-08 13:54:04
652,C5-34.五色橋ビル,0,13,13,35.636644,139.751798,2024-02-08 13:54:04
653,K1-41.郷土博物館,0,12,12,35.588644,139.710413,2024-02-08 13:54:04
654,G2-06.ディアレイシャス押上スカイヴィレッジ,0,5,5,35.71408,139.810588,2024-02-08 13:54:04
655,O3-11.ハイリビング関根,6,2,8,35.707877,139.618926,2024-02-08 13:54:04
656,O7-02.永福中央公園,6,0,6,35.67121,139.64145,2024-02-08 13:54:04
657,K1-29.萩中文化センター,5,4,9,35.55017,139.728146,2024-02-08 13:54:04
658,K1-30.テクノFRONT森ケ崎,2,2,4,35.567922,139.746181,2024-02-08 13:54:04
659,K1-130.COCOONひろば平和島,18,0,18,35.578728,139.735238,2024-02-08 13:54:04
660,H1-81.豊洲IHIビル（北側）,21,0,21,35.659829,139.793243,2024-02-08 13:54:04
661,E4-03.昭和小学校北側（不忍通り）,25,8,33,35.73166,139.748625,2024-02-08 13:54:04
662,C2-12.六本木ファーストビル,15,0,15,35.66249,139.741397,2024-02-08 13:54:04
663,D3-16.セジョリ江戸川橋,5,10,15,35.708734,139.730509,2024-02-08 13:54:04
664,A5-04.日比谷パークフロント前　日比谷公園南面向い歩道上,6,2,8,35.671514,139.753952,2024-02-08 13:54:04
665,C3-22.OMO3東京赤坂 by 星野リゾート,8,0,8,35.674929,139.736053,2024-02-08 13:54:04
666,B1-20.竜閑さくら橋際街角広場,0,17,17,35.688301,139.768958,2024-02-08 13:54:04
667,H1-83.ローソン江東東雲店,2,11,13,35.642165,139.800439,2024-02-08 13:54:04
668,H1-84.NTT東日本辰巳ビル,0,20,20,35.647091,139.817333,2024-02-08 13:54:04
669,C5-26.ピアシティ芝浦ビル,6,8,14,35.644155,139.756216,2024-02-08 13:54:04
670,T3-28.ほしぞら緑地,0,3,3,35.755137,139.661208,2024-02-08 13:54:04
671,I1-88.セブン-イレブン品川南大井3丁目店,1,1,2,35.58768,139.734515,2024-02-08 13:54:04
672,I1-87.セブン-イレブン西大井滝王子通り店,0,7,7,35.599774,139.723467,2024-02-08 13:54:04
673,G4-11.ホテルマイステイズ浅草,19,3,22,35.703972,139.797327,2024-02-08 13:54:04
674,C5-30.フェイム芝浦インターウェーブ,0,11,11,35.647872,139.75391,2024-02-08 13:54:04
675,M6-13.JICA東京,9,3,12,35.673409,139.675203,2024-02-08 13:54:04
676,A4-13.アーバンネット大手町ビル,5,0,5,35.68557,139.766929,2024-02-08 13:54:04
677,B4-27.リバーシティ西ブロック,11,7,18,35.670491,139.784447,2024-02-08 13:54:04
678,K1-143.大森北1丁目,59,0,59,35.584914,139.730504,2024-02-08 13:54:04
679,E5-24.本郷6丁目,3,2,5,35.712445,139.758157,2024-02-08 13:54:04
680,D2-17.genten市ヶ谷店,10,0,10,35.690657,139.73255,2024-02-08 13:54:04
681,A4-14.東京国際フォーラム（有楽町駅ガード側）,7,0,7,35.675739,139.763712,2024-02-08 13:54:04
682,A2-27.丸紅ビル,6,0,6,35.690958,139.759876,2024-02-08 13:54:04
683,K1-135.北千束2丁目,4,2,6,35.608633,139.693653,2024-02-08 13:54:04
684,A1-19.九段会館テラス,4,0,4,35.694065,139.751801,2024-02-08 13:54:04
685,K1-136.BIG FUN 平和島,0,9,9,35.585489,139.740194,2024-02-08 13:54:04
686,K1-137.京浜島つばさ公園,0,14,14,35.571578,139.770532,2024-02-08 13:54:04
687,D1-16.ルネ新宿御苑タワー,7,3,10,35.690155,139.713377,2024-02-08 13:54:04
688,G6-01.オーキッドレジデンス森下,3,2,5,35.692547,139.799231,2024-02-08 13:54:04
689,T2-63.三原台公園,1,6,7,35.751471,139.599835,2024-02-08 13:54:04
690,O4-01.阿佐ヶ谷南公園,1,1,2,35.70328,139.62981,2024-02-08 13:54:04
691,B4-11.ダンスキューブ勝どき,0,17,17,35.656565,139.775073,2024-02-08 13:54:04
692,D1-06.四谷第六小学校北,10,0,10,35.681754,139.715256,2024-02-08 13:54:04
693,T2-64.高野台中央公園,1,2,3,35.746768,139.613885,2024-02-08 13:54:04
694,H1-169.セブンイレブン江東亀戸7丁目東店,0,10,10,35.697157,139.839835,2024-02-08 13:54:04
695,H1-170.セブンイレブン江東亀戸7丁目南店,0,32,32,35.695937,139.838017,2024-02-08 13:54:04
696,B2-16.ホテルサードニクス東京,4,1,5,35.67684,139.77876,2024-02-08 13:54:04
697,I1-93.中央海浜公園前交差点（南側）,4,1,5,35.595498,139.750654,2024-02-08 13:54:04
698,I1-92.中央海浜公園前交差点（北側）,10,0,10,35.595873,139.75134,2024-02-08 13:54:04
699,B1-26.Dash Living Nihonbashi,3,3,6,35.68802,139.78112,2024-02-08 13:54:04
700,H1-158.東京国際交流館,11,1,12,35.621845,139.776833,2024-02-08 13:54:04
701,J1-32.緑が丘駅前高架下,7,0,7,35.606793,139.678372,2024-02-08 13:54:04
702,K1-90.ファミリーマート大田仲池上一丁目店,1,5,6,35.5873,139.701644,2024-02-08 13:54:04
703,K1-91.穴守稲荷神社,4,6,10,35.550027,139.74973,2024-02-08 13:54:04
704,C1-67.京阪神 虎ノ門ビル,18,3,21,35.669228,139.751668,2024-02-08 13:54:04
705,K1-89.ファミリーマート大田千鳥三丁目店,3,2,5,35.572086,139.68708,2024-02-08 13:54:04
706,I1-97.トミンハイム東品川三丁目第二,14,5,19,35.613387,139.749307,2024-02-08 13:54:04
707,T2-51.練馬区役所石神井庁舎,10,0,10,35.743772,139.603317,2024-02-08 13:54:04
708,T2-75.石神井台二丁目緑地,3,0,3,35.734684,139.593628,2024-02-08 13:54:04
709,E5-19.千駄木公園,1,6,7,35.728333,139.757629,2024-02-08 13:54:04
710,E5-18.団子坂上広場,0,11,11,35.724921,139.75903,2024-02-08 13:54:04
711,A5-07.富国生命ビル,3,3,6,35.670452,139.75557,2024-02-08 13:54:04
712,H1-156.つどい橋下,0,9,9,35.630791,139.787396,2024-02-08 13:54:04
713,H1-159.夢の大橋西,16,0,16,35.627599,139.782953,2024-02-08 13:54:04
714,H1-143.ダイバーシティ東京 プラザ,8,2,10,35.624619,139.776006,2024-02-08 13:54:04
715,I1-57.大井水神公園,67,3,70,35.589972,139.729368,2024-02-08 13:54:04
716,B2-15.KABUTO ONE,4,2,6,35.68168,139.77825,2024-02-08 13:54:04
717,K1-64.多摩川グリーンスクエア,0,15,15,35.545459,139.719489,2024-02-08 13:54:04
718,T2-57.大泉公園（第二）,5,1,6,35.771708,139.583551,2024-02-08 13:54:04
719,A4-06.大手町ファーストスクエア,10,0,10,35.686037,139.764472,2024-02-08 13:54:04
720,C1-50.NTT虎ノ門ビル,11,3,14,35.666075,139.748008,2024-02-08 13:54:04
721,C1-23.三田いきいきプラザ,9,0,9,35.648637,139.749834,2024-02-08 13:54:04
722,H1-29.スカイズタワー＆ガーデン,0,71,71,35.647618,139.792152,2024-02-08 13:54:04
723,C1-21.汐留ビルディング,6,4,10,35.657363,139.75918,2024-02-08 13:54:04
724,A3-16.地蔵橋東児童遊園,2,4,6,35.691069,139.775376,2024-02-08 13:54:04
725,A3-18.美倉橋北児童遊園,0,11,11,35.69703,139.779928,2024-02-08 13:54:04
726,A4-01.丸ビル（南側駐輪場）,12,0,12,35.680514,139.764002,2024-02-08 13:54:04
727,A3-11.練成公園,2,6,8,35.703735,139.770629,2024-02-08 13:54:04
728,A3-10.芳林公園（北側）,0,9,9,35.701978,139.7698,2024-02-08 13:54:04
729,A6-02.いきいきプラザ一番町（西側駐輪場）,4,4,8,35.687031,139.739327,2024-02-08 13:54:04
730,A6-01.東郷元帥記念公園（南側）,2,3,5,35.689879,139.740178,2024-02-08 13:54:04
731,A5-03.参議院第二別館（永田町駅2番出口）,10,6,16,35.677763,139.74271,2024-02-08 13:54:04
732,A4-03.東京国際フォーラム（メトロD5出口）,8,0,8,35.675843,139.763329,2024-02-08 13:54:04
733,K1-15.セブン‐イレブン 大田区西蒲田店,3,0,3,35.56694,139.716331,2024-02-08 13:54:04
734,K1-49.ローソン仲池上一丁目店,1,9,10,35.586585,139.698552,2024-02-08 13:54:04
735,A2-06.東光電気工事 別館（屋内駐輪場）,7,0,7,35.69919,139.75701,2024-02-08 13:54:04
736,M4-01.新宿タカシマヤ,4,2,6,35.68714,139.702775,2024-02-08 13:54:04
737,M4-03.NTTドコモ代々木ビル,6,4,10,35.684451,139.702884,2024-02-08 13:54:04
738,M3-03.代官山 T-SITE,6,2,8,35.649823,139.700139,2024-02-08 13:54:04
739,K1-14.大森地域庁舎,7,2,9,35.578239,139.723262,2024-02-08 13:54:04
740,C5-46.ウエリスアーバン品川タワー,0,22,22,35.630961,139.746875,2024-02-08 13:54:04
741,C4-13.コシダコネクトビル,0,14,14,35.637765,139.739128,2024-02-08 13:54:04
742,K1-127.第二石井ビル,5,0,5,35.559286,139.722611,2024-02-08 13:54:04
743,C1-74.札の辻スクエア,6,1,7,35.645155,139.744543,2024-02-08 13:54:04
744,H1-164.森下三丁目第三児童遊園,1,18,19,35.68546,139.80244,2024-02-08 13:54:04
745,C1-78.CIRCLES新橋,8,1,9,35.66646,139.752138,2024-02-08 13:54:04
746,C3-34.3rd MINAMI AOYAMA,5,1,6,35.668622,139.715957,2024-02-08 13:54:04
747,O4-06.杉並区役所本庁舎,3,2,5,35.699328,139.636343,2024-02-08 13:54:04
748,D3-14.コーシャハイム高田馬場,5,1,6,35.712413,139.70168,2024-02-08 13:54:04
749,D7-11.新宿清掃事務所,2,4,6,35.716359,139.704377,2024-02-08 13:54:04
750,D5-08.ウエリス新宿早稲田の森,0,9,9,35.704597,139.708397,2024-02-08 13:54:04
751,E2-12.水道2丁目,0,29,29,35.709147,139.739183,2024-02-08 13:54:04
752,M6-10.京王コインパーク幡ヶ谷,0,10,10,35.6772,139.678117,2024-02-08 13:54:04
753,E3-05.文京スポーツセンター,49,11,60,35.721045,139.735687,2024-02-08 13:54:04
754,J1-36.WJ Haus,0,7,7,35.629067,139.711779,2024-02-08 13:54:04
755,K1-51.テクノポートカマタ 第2,11,0,11,35.555808,139.722791,2024-02-08 13:54:04
756,D1-13.新宿御苑新宿門【西側】,0,21,21,35.688945,139.706536,2024-02-08 13:54:04
757,I1-31.セブン-イレブン 品川戸越5丁目店,3,3,6,35.608193,139.719139,2024-02-08 13:54:04
758,T3-27.貫井川緑地,1,3,4,35.738427,139.632251,2024-02-08 13:54:04
759,H1-147.大島四丁目団地,12,5,17,35.68744,139.827075,2024-02-08 13:54:04
760,O4-02.成宗さくら公園,2,0,2,35.69638,139.63482,2024-02-08 13:54:04
761,O1-01.上瀬戸公園,2,2,4,35.72077,139.6045,2024-02-08 13:54:04
762,T2-15.NPC24H大泉学園南口パーキング,8,2,10,35.748611,139.584251,2024-02-08 13:54:04
763,O3-03.桃井1丁目5番地,6,0,6,35.71013,139.61194,2024-02-08 13:54:04
764,H1-08.東京テレポート駅,0,52,52,35.627087,139.779779,2024-02-08 13:54:04
765,H1-05.相鉄グランドフレッサ 東京ベイ有明,13,1,14,35.632148,139.79017,2024-02-08 13:54:04
766,H1-06.武蔵野大学,2,13,15,35.630185,139.786618,2024-02-08 13:54:04
767,A4-15.TOKIWAブリッジ,8,1,9,35.686389,139.769237,2024-02-08 13:54:04
768,H1-160.花の広場,8,9,17,35.633908,139.793322,2024-02-08 13:54:04
769,H1-01.豊洲ＩＨＩビル前（晴海通り）,10,0,10,35.658911,139.792531,2024-02-08 13:54:04
770,H1-02.豊洲駅,10,5,15,35.654196,139.79626,2024-02-08 13:54:04
771,J1-19.NTT東日本自由が丘ビル,3,1,4,35.615098,139.675954,2024-02-08 13:54:04
772,C2-19.広尾駅,4,1,5,35.650732,139.72256,2024-02-08 13:54:04
773,H1-114.東京夢の島マリーナ,5,9,14,35.651987,139.830691,2024-02-08 13:54:04
774,K1-71.ファミリーマート大田大森南店,2,3,5,35.562769,139.74327,2024-02-08 13:54:04
775,J1-20.すずめのお宿緑地公園,2,7,9,35.617773,139.685351,2024-02-08 13:54:04
776,H1-115.東京夢の島マリーナ 第4駐車場,2,12,14,35.650235,139.835993,2024-02-08 13:54:04
777,M5-10.富ヶ谷2丁目,15,1,16,35.665961,139.686491,2024-02-08 13:54:04
778,J1-21.中央緑地公園,0,9,9,35.630694,139.690482,2024-02-08 13:54:04
779,H1-116.出会い橋高架下,27,22,49,35.625037,139.777646,2024-02-08 13:54:04
780,M3-12.渋谷南東急ビル,6,0,6,35.656228,139.706284,2024-02-08 13:54:04
781,T2-01.大泉学園駅北口,4,1,5,35.749918,139.58618,2024-02-08 13:54:04
782,K1-06.大森駅入新井自転車駐車場,6,0,6,35.585269,139.726279,2024-02-08 13:54:04
783,D6-06.新宿中央公園（エコギャラリー下）,0,15,15,35.691199,139.687966,2024-02-08 13:54:04
784,D6-14.新宿ファーストウエスト,13,1,14,35.689529,139.695995,2024-02-08 13:54:04
785,D6-15.住友不動産西新宿ビル,11,0,11,35.69465,139.695911,2024-02-08 13:54:04
786,H1-56.南砂三丁目緑地公園西,0,29,29,35.672361,139.829825,2024-02-08 13:54:04
787,T2-74.扇橋公園,2,3,5,35.731791,139.588844,2024-02-08 13:54:04
788,B2-20.SHビル,3,0,3,35.675398,139.779962,2024-02-08 13:54:04
789,I1-17.東品川海上公園第2,0,16,16,35.616364,139.749171,2024-02-08 13:54:04
790,I1-16.品川浦,13,1,14,35.6214,139.741958,2024-02-08 13:54:04
791,A4-11.二重橋前駅(メトロ4番出口),4,0,4,35.680753,139.762069,2024-02-08 13:54:04
792,H1-76.有明物流センター,3,15,18,35.638571,139.78829,2024-02-08 13:54:04
793,K1-43.北馬込わくわく公園,0,14,14,35.600707,139.703216,2024-02-08 13:54:04
794,K1-42.馬込西公園,11,3,14,35.58849,139.70376,2024-02-08 13:54:04
795,T1-08.セブン-イレブン 練馬高松6丁目店,4,0,4,35.756506,139.620347,2024-02-08 13:54:04
796,T2-17.ファミリーマート 練馬石神井町八丁目店,0,6,6,35.74755,139.597968,2024-02-08 13:54:04
797,K1-31.テクノWING,0,12,12,35.546252,139.731708,2024-02-08 13:54:04
798,K1-32.石川町文化センター,5,0,5,35.601958,139.682876,2024-02-08 13:54:04
799,I1-20.しおじ公園,11,9,20,35.59632,139.751279,2024-02-08 13:54:04
800,I1-19.品川シーサイド公園第2,7,0,7,35.607571,139.749108,2024-02-08 13:54:04
801,J1-29.カスタリア目黒鷹番,2,3,5,35.626121,139.688576,2024-02-08 13:54:04
802,H1-127.古石場川親水公園,0,38,38,35.669291,139.795364,2024-02-08 13:54:04
803,D4-05.カスタリア新宿7丁目,0,14,14,35.700732,139.711472,2024-02-08 13:54:04
804,I1-71.セブン-イレブン南大井浜川店,1,1,2,35.596483,139.7355,2024-02-08 13:54:04
805,I1-72.セブン-イレブン大井店,0,20,20,35.600081,139.728193,2024-02-08 13:54:04
806,T3-21.くまのやま緑地,4,1,5,35.747038,139.667965,2024-02-08 13:54:04
807,K1-110.萩中集会所裏,9,5,14,35.550479,139.739538,2024-02-08 13:54:04
808,O2-02.シエール荻窪,30,0,30,35.708265,139.612703,2024-02-08 13:54:04
809,H1-128.豊洲市場（5街区）,31,3,34,35.645162,139.785386,2024-02-08 13:54:04
810,N1-09.若宮レジデンス,1,4,5,35.716184,139.643905,2024-02-08 13:54:04
811,M6-12.LIVART SEASON 幡ヶ谷,0,15,15,35.683156,139.67338,2024-02-08 13:54:04
812,H1-142.東京ベイ潮見プリンスホテル,0,19,19,35.660632,139.817294,2024-02-08 13:54:04
813,G1-01.鐘ヶ淵駅南自転車駐車場,1,8,9,35.732291,139.82012,2024-02-08 13:54:04
814,M1-01.渋谷区役所,8,0,8,35.66362,139.69801,2024-02-08 13:54:04
815,I1-83.かもめ歩道橋,0,24,24,35.600161,139.749902,2024-02-08 13:54:04
816,N4-05.セブン-イレブン中野鍋横店,3,2,5,35.693815,139.668571,2024-02-08 13:54:04
817,D4-02.JICA市ヶ谷ビル（地球ひろば／研究所）,7,0,7,35.694927,139.731328,2024-02-08 13:54:04
818,T3-19.なかみや児童遊園,1,4,5,35.749388,139.651824,2024-02-08 13:54:04
819,N1-08.上鷺自転車保管場所,2,5,7,35.729056,139.627864,2024-02-08 13:54:04
820,O7-06.松木1丁目,2,11,13,35.686015,139.642784,2024-02-08 13:54:04
821,E4-16.ビレッジワン,1,6,7,35.723723,139.740143,2024-02-08 13:54:04
822,D1-15.フロンティア四谷,1,8,9,35.68768,139.71937,2024-02-08 13:54:04
823,K1-128.大森西3丁目,2,13,15,35.571975,139.732137,2024-02-08 13:54:04
824,N1-06.大和区民活動センター,0,5,5,35.713562,139.649075,2024-02-08 13:54:04
825,G4-01.両国ビューホテル1,0,8,8,35.69566,139.79214,2024-02-08 13:54:04
826,G4-02.両国ビューホテル2,1,7,8,35.69562,139.79206,2024-02-08 13:54:04
827,G4-05.両国駅西口臨時自転車駐車場,18,2,20,35.698588,139.792946,2024-02-08 13:54:04
828,G4-03.本所1-6-5,10,4,14,35.702525,139.796632,2024-02-08 13:54:04
829,G5-01.牡丹橋自転車駐車場,15,3,18,35.693059,139.813417,2024-02-08 13:54:04
830,G5-02.横川3-7-10,17,20,37,35.70378,139.814298,2024-02-08 13:54:04
831,G4-04.NTTドコモ墨田ビル,14,7,21,35.697898,139.795345,2024-02-08 13:54:04
832,G2-02.押上1-23-8,1,7,8,35.710111,139.81488,2024-02-08 13:54:04
833,C5-13.区立芝浦西運河沿緑地,10,30,40,35.638245,139.749754,2024-02-08 13:54:04
834,D6-12.東京ビジネスホテル,0,3,3,35.69342,139.710568,2024-02-08 13:54:04
835,D6-11.ホテルリステル新宿,0,4,4,35.693029,139.711327,2024-02-08 13:54:04
836,D6-10.ホテルサンライト新宿,3,0,3,35.694201,139.707047,2024-02-08 13:54:04
837,H1-39.辰巳駅東口自転車駐車場,21,4,25,35.645823,139.812178,2024-02-08 13:54:04
838,H1-38.辰巳駅西口自転車駐車場,89,0,89,35.646857,139.808912,2024-02-08 13:54:04
839,C2-10.元麻布三丁目,0,7,7,35.655865,139.730566,2024-02-08 13:54:04
840,C2-09.麻布地区総合支所,1,1,2,35.660614,139.734771,2024-02-08 13:54:04
841,M3-20.東急ステイ渋谷新南口,8,0,8,35.65494,139.70534,2024-02-08 13:54:04
842,I1-86.ファミリーマート二葉三丁目店,3,0,3,35.601694,139.719778,2024-02-08 13:54:04
843,A2-23.axle御茶ノ水,7,0,7,35.696126,139.763297,2024-02-08 13:54:04
844,C4-02.白金台いきいきプラザ,4,1,5,35.63756,139.724981,2024-02-08 13:54:04
845,N3-04.東中野駅地下駐輪場,0,22,22,35.707883,139.683284,2024-02-08 13:54:04
846,N3-05.中野坂上駅地下駐輪場,0,6,6,35.698068,139.682781,2024-02-08 13:54:04
847,N3-03.青桐公園,0,15,15,35.697024,139.677846,2024-02-08 13:54:04
848,N3-01.中野四季の森公園,6,4,10,35.708487,139.662135,2024-02-08 13:54:04
849,N4-01.本四公園,1,9,10,35.69693,139.672721,2024-02-08 13:54:04
850,N4-02.栄町公園,0,11,11,35.686474,139.671383,2024-02-08 13:54:04
851,K1-57.池上本門寺,5,1,6,35.579585,139.705377,2024-02-08 13:54:04
852,C1-49.汐留シティセンター,11,3,14,35.666213,139.760907,2024-02-08 13:54:04
853,C4-15.クロスレジデンス白金高輪,1,12,13,35.642771,139.733046,2024-02-08 13:54:04
854,K1-56.NTT馬込ビル,0,9,9,35.588106,139.718852,2024-02-08 13:54:04
855,J1-41.CASSIA目黒,0,9,9,35.631319,139.70237,2024-02-08 13:54:04
856,A2-22.専修大学,6,0,6,35.696147,139.753709,2024-02-08 13:54:04
857,T3-20.はやいち公園,2,2,4,35.75312,139.65661,2024-02-08 13:54:04
858,B3-19.本の森ちゅうおう,9,0,9,35.67363,139.77623,2024-02-08 13:54:04
859,K1-86.IMPREST STAY TOKYO 蒲田,21,1,22,35.556267,139.727246,2024-02-08 13:54:04
860,T3-23.氷川台二丁目緑地,3,1,4,35.756575,139.669689,2024-02-08 13:54:04
861,T3-22.氷川台三丁目ちびっこ公園,1,2,3,35.750547,139.66707,2024-02-08 13:54:04
862,B1-23.NANAEI日本橋,3,4,7,35.679616,139.784341,2024-02-08 13:54:04
863,B2-11.京橋エドグラン,12,0,12,35.677576,139.769822,2024-02-08 13:54:04
864,N1-05.大野ハイツ,1,4,5,35.7266,139.62948,2024-02-08 13:54:04
865,B2-09.茅場町一丁目平和ビル,10,0,10,35.680203,139.778679,2024-02-08 13:54:04
866,B2-08.共同ビル（茅場町交差点前）,9,0,9,35.681012,139.778569,2024-02-08 13:54:04
867,B2-07.東京証券会館（北側）,1,0,1,35.680864,139.779331,2024-02-08 13:54:04
868,O3-12.大宮前体育館,0,3,3,35.696567,139.610517,2024-02-08 13:54:04
869,B1-08.明治座,0,20,20,35.688038,139.786561,2024-02-08 13:54:04
870,B4-05.ドコモ・バイクシェア晴海ポート,0,29,29,35.654165,139.781568,2024-02-08 13:54:04
871,B4-04.ＫＤＸ晴海ビル,0,0,0,35.65443,139.77843,2024-02-08 13:54:04
872,B4-03.桜の散歩道（晴海トリトンスクエア前）,6,10,16,35.658665,139.782553,2024-02-08 13:54:04
873,E5-08.セブン-イレブン 文京動坂上店,1,4,5,35.727778,139.756296,2024-02-08 13:54:04
874,H1-65.ローソン南砂日曹橋店,9,5,14,35.669507,139.825553,2024-02-08 13:54:04
875,H1-66.中川船番所資料館,0,8,8,35.687732,139.846383,2024-02-08 13:54:04
876,K1-113.ファミリーマート大田上池台四丁目店,1,6,7,35.594658,139.700133,2024-02-08 13:54:04
877,H1-64.ローソン東雲駅前店,9,1,10,35.640228,139.804267,2024-02-08 13:54:04
878,E1-11.小石川運動場前,12,3,15,35.703914,139.747061,2024-02-08 13:54:04
879,T2-70.三ツ塚けやき緑地,2,2,4,35.720318,139.570762,2024-02-08 13:54:04
880,H1-137.住友不動産ショッピングシティ有明ガーデン,21,0,21,35.638985,139.793653,2024-02-08 13:54:04
881,C5-40.芝浦ふ頭駅前暫定自転車駐車場,3,1,4,35.64096,139.75754,2024-02-08 13:54:04
882,M3-21.渋谷ソラスタ,11,0,11,35.65618,139.69612,2024-02-08 13:54:04
883,D7-03.中井駅北,20,11,31,35.715645,139.687486,2024-02-08 13:54:04
884,K1-119.シーンズ大森パークサイド,4,0,4,35.58223,139.72763,2024-02-08 13:54:04
885,M6-15.cova Hatagaya,0,2,2,35.67741,139.67383,2024-02-08 13:54:04
886,C2-25.アパホテル＆リゾート＜六本木駅東＞,34,9,43,35.661783,139.737242,2024-02-08 13:54:04
887,D4-10.東新宿ポート(余丁町6番),1,5,6,35.696585,139.713081,2024-02-08 13:54:04
888,O1-02.井荻南地下自転車駐車場,7,7,14,35.72424,139.61431,2024-02-08 13:54:04
889,O1-03.LUCKY HOUSE,1,3,4,35.72489,139.62383,2024-02-08 13:54:04
890,D6-30.京王プラザホテル,7,0,7,35.6897,139.694823,2024-02-08 13:54:04
891,D6-29.都庁第二本庁舎前,13,0,13,35.688735,139.692249,2024-02-08 13:54:04
892,O3-02.アートメゾン荻窪,6,2,8,35.71355,139.6199,2024-02-08 13:54:04
893,J1-57.トレインチ自由が丘,4,1,5,35.606667,139.667324,2024-02-08 13:54:04
894,O2-01.サカエフラット荻窪,10,1,11,35.70535,139.61497,2024-02-08 13:54:04
895,O3-01.西田公園,1,6,7,35.69575,139.62065,2024-02-08 13:54:04
896,K1-47.NTT雪ヶ谷ビル,9,2,11,35.598601,139.684747,2024-02-08 13:54:04
897,O7-04.永福町西幸モータープール西,7,1,8,35.67161,139.64527,2024-02-08 13:54:04
898,K1-48.ファミリーマート大田上池台三丁目店,0,15,15,35.590934,139.696915,2024-02-08 13:54:04
899,K1-111.本羽田公園,5,2,7,35.546499,139.736761,2024-02-08 13:54:04
900,C1-58.ウォーターズ竹芝,3,7,10,35.655937,139.763251,2024-02-08 13:54:04
901,K1-109.萩中公園プール駐輪場,8,0,8,35.549323,139.737091,2024-02-08 13:54:04
902,K1-108.仲江名公園,2,2,4,35.557999,139.732564,2024-02-08 13:54:04
903,E1-17.小石川パークスクエア,0,10,10,35.713913,139.745416,2024-02-08 13:54:04
904,D6-23.アパホテル 東新宿 歌舞伎町西,2,0,2,35.697535,139.703633,2024-02-08 13:54:04
905,H1-98.洲崎川緑道公園,0,34,34,35.668705,139.810549,2024-02-08 13:54:04
906,H1-99.南砂三丁目公園,19,5,24,35.669695,139.831874,2024-02-08 13:54:04
907,H1-96.越中島公園,0,17,17,35.668757,139.790156,2024-02-08 13:54:04
908,H1-97.浜園公園,0,18,18,35.661852,139.802224,2024-02-08 13:54:04
909,H1-94.新木場一丁目緑地公園,6,3,9,35.64423,139.835823,2024-02-08 13:54:04
910,H1-95.若洲公園,7,17,24,35.619451,139.834429,2024-02-08 13:54:04
911,J1-09.ファミリーマート佐野久下目黒店,2,3,5,35.629252,139.712716,2024-02-08 13:54:04
912,H1-93.新木場一丁目公園,7,0,7,35.64143,139.835455,2024-02-08 13:54:04
913,I1-55.鈴ヶ森公園,0,21,21,35.593559,139.734704,2024-02-08 13:54:04
914,O6-04.柏の宮公園,0,5,5,35.67834,139.62711,2024-02-08 13:54:04
915,B4-14.Brillia ist Tower 勝どき,0,21,21,35.660526,139.776816,2024-02-08 13:54:04
916,D7-08.上落合3丁目,2,11,13,35.71115,139.68232,2024-02-08 13:54:04
917,H1-21.UR東雲キャナルコート,0,85,85,35.646041,139.804495,2024-02-08 13:54:04
918,H1-20.日本科学未来館,23,7,30,35.619377,139.777582,2024-02-08 13:54:04
919,H1-19.UR豊洲四丁目団地,16,5,21,35.653603,139.80144,2024-02-08 13:54:04
920,T2-45.風致地区バス停第三自転車駐車場,0,7,7,35.771068,139.586798,2024-02-08 13:54:04
921,H1-33.深川ギャザリア（ウエストスクエア）,0,28,28,35.66789,139.803,2024-02-08 13:54:04
922,H1-32.区営塩浜住宅前,0,23,23,35.664591,139.813954,2024-02-08 13:54:04
923,H1-23.KDX豊洲グランスクエア,13,0,13,35.648085,139.798986,2024-02-08 13:54:04
924,C2-22.飯倉公園,10,0,10,35.655649,139.74427,2024-02-08 13:54:04
925,I1-89.下神明駅自転車駐車場,4,0,4,35.608402,139.726118,2024-02-08 13:54:04
926,C5-39.お台場海浜公園東,11,2,13,35.631021,139.778109,2024-02-08 13:54:04
927,C5-38.お台場海浜公園乗船場,0,15,15,35.628743,139.773915,2024-02-08 13:54:04
928,O4-08.ローソン阿佐ヶ谷青梅街道店,0,5,5,35.703203,139.62804,2024-02-08 13:54:04
929,T2-72.高塚南緑地,4,2,6,35.733132,139.570311,2024-02-08 13:54:04
930,O6-03.みなみ荘,6,4,10,35.68073,139.62803,2024-02-08 13:54:04
931,K1-129.ローソン東糀谷一丁目店,0,8,8,35.557427,139.739126,2024-02-08 13:54:04
932,E1-03.東京ドーム（黄色いビル横）,8,0,8,35.70319,139.751888,2024-02-08 13:54:04
933,K1-23.大田区役所本庁舎前,5,0,5,35.561183,139.716339,2024-02-08 13:54:04
934,T2-78.北大泉くれはし公園,1,2,3,35.761474,139.592735,2024-02-08 13:54:04
935,J1-53.ボヌールAllamanda,3,2,5,35.612833,139.675047,2024-02-08 13:54:04
936,A3-39.トーシン東神田ビル,0,4,4,35.694834,139.780333,2024-02-08 13:54:04
937,O6-01.高井戸みどり公園,4,5,9,35.67912,139.61074,2024-02-08 13:54:04
938,T2-79.大泉学園町八丁目緑地,4,2,6,35.774457,139.596182,2024-02-08 13:54:04
939,O5-04.リヴィエール,16,4,20,35.70104,139.65839,2024-02-08 13:54:04
940,N3-08.中野区役所(西側),6,0,6,35.707968,139.663519,2024-02-08 13:54:04
941,I1-99.北品川２丁目,4,2,6,35.61663,139.74192,2024-02-08 13:54:04
942,P1-01.サンシャインシティ,5,2,7,35.728846,139.718577,2024-02-08 13:54:04
943,N3-14.ヴィラソンサ落合,0,7,7,35.713227,139.680966,2024-02-08 13:54:04
944,H1-49.セブン-イレブン 江東新砂３丁目店,0,22,22,35.667892,139.8311,2024-02-08 13:54:04
945,I1-06.大森貝塚遺跡庭園,9,0,9,35.593489,139.72967,2024-02-08 13:54:04
946,M2-12.恵比寿プライムスクエアタワー北,8,1,9,35.650541,139.713361,2024-02-08 13:54:04
947,H1-69.ファミリーマート 江東石島店,0,31,31,35.680474,139.812316,2024-02-08 13:54:04
948,B3-09.築地永谷コーポラス,0,16,16,35.66523,139.776313,2024-02-08 13:54:04
949,E4-10.白山四丁目第二児童遊園横,3,8,11,35.720349,139.746924,2024-02-08 13:54:04
950,I1-03.大井町駅中央口（西側）,5,0,5,35.605617,139.73472,2024-02-08 13:54:04
951,I1-04.大井町歩道橋,5,0,5,35.605146,139.734694,2024-02-08 13:54:04
952,I1-01.品川区役所 本庁舎前,10,0,10,35.609052,139.729825,2024-02-08 13:54:04
953,I1-02.品川区役所 第三庁舎前,9,0,9,35.608161,139.730048,2024-02-08 13:54:04
954,G4-08.ブオンサンヴァレンティーノ,1,5,6,35.691677,139.793857,2024-02-08 13:54:04
955,J1-13.洗足二丁目駐輪場,13,4,17,35.61061,139.693443,2024-02-08 13:54:04
956,J1-16.八雲橋自転車置場,2,4,6,35.617353,139.672256,2024-02-08 13:54:04
957,H1-189.MFLP新木場2,0,36,36,35.634453,139.824,2024-02-08 13:54:04
958,M6-09.ファミリーマート渋谷本町店,0,11,11,35.683756,139.684965,2024-02-08 13:54:04
959,H1-113.123+N東雲店,0,36,36,35.646366,139.801492,2024-02-08 13:54:04
960,J1-17.ファミリーマート原町二丁目店,1,5,6,35.613902,139.691476,2024-02-08 13:54:04
961,E5-21.動坂公園,0,11,11,35.73176,139.756669,2024-02-08 13:54:04
962,E5-20.本郷2丁目,0,8,8,35.704391,139.758575,2024-02-08 13:54:04
963,T2-48.武蔵関駅南第二自転車駐車場,3,1,4,35.726064,139.578015,2024-02-08 13:54:04
964,A6-26.相互半蔵門ビル,6,3,9,35.683378,139.743189,2024-02-08 13:54:04
965,J1-31.守屋図書館,12,7,19,35.634194,139.688833,2024-02-08 13:54:04
966,M3-19.渋谷キャスト,21,0,21,35.662146,139.702793,2024-02-08 13:54:04
967,N1-04.都立家政南駐輪場,0,10,10,35.721679,139.645265,2024-02-08 13:54:04
968,N2-02.江古田1丁目A,1,2,3,35.724988,139.672511,2024-02-08 13:54:04
969,C1-56.鈴与竹芝ビル,3,2,5,35.654873,139.762103,2024-02-08 13:54:04
970,D3-07.戸塚特別出張所,6,1,7,35.71429,139.70507,2024-02-08 13:54:04
971,G4-12.プレミアムキューブ両国,0,7,7,35.70103,139.803341,2024-02-08 13:54:04
972,A2-21.神田神保町3丁目,7,0,7,35.694578,139.754434,2024-02-08 13:54:04
973,B4-19.コーシャタワー佃,0,25,25,35.668044,139.785801,2024-02-08 13:54:04
974,I1-81.戸越6丁目,16,4,20,35.608127,139.717865,2024-02-08 13:54:04
975,A6-24.国立劇場,0,15,15,35.682218,139.743292,2024-02-08 13:54:04
976,E5-23.ビレッジ千駄木,0,7,7,35.722353,139.760966,2024-02-08 13:54:04
977,H1-119.榎戸材木店,0,7,7,35.638319,139.834741,2024-02-08 13:54:04
978,C5-29.Hi-NODE(ハイノード),7,1,8,35.651672,139.760549,2024-02-08 13:54:04
979,J1-22.NTTコミュニケーションズ唐ヶ崎ビル,0,4,4,35.627373,139.692044,2024-02-08 13:54:04
980,A2-18.猿楽町SSビル東,4,1,5,35.698654,139.759762,2024-02-08 13:54:04
981,A2-19.猿楽町SSビル西,3,0,3,35.698641,139.759306,2024-02-08 13:54:04
982,C1-55.アーバンネット内幸町ビル,18,2,20,35.669267,139.756018,2024-02-08 13:54:04
983,D4-06.グリーンフォート河田,0,13,13,35.697143,139.718739,2024-02-08 13:54:04
984,K1-134.東調布公園,2,8,10,35.588363,139.69042,2024-02-08 13:54:04
985,M5-18.Luxe初台,0,5,5,35.679182,139.68596,2024-02-08 13:54:04
986,D7-06.エムアイセミナーハウス,3,2,5,35.721064,139.677128,2024-02-08 13:54:04
987,A3-37.ポータル秋葉原,0,24,24,35.695737,139.78162,2024-02-08 13:54:04
988,M5-11.あおい通り,8,1,9,35.688154,139.698975,2024-02-08 13:54:04
989,E5-04.保健サービスセンター本郷支所,0,5,5,35.727046,139.760439,2024-02-08 13:54:04
990,E5-03.汐見地域活動センター（本郷図書館）,0,5,5,35.725538,139.76116,2024-02-08 13:54:04
991,E5-01.文京総合体育館,30,1,31,35.708121,139.763583,2024-02-08 13:54:04
992,E4-01.千石南自転車駐車場,5,20,25,35.72707,139.746112,2024-02-08 13:54:04
993,E3-03.大塚公園,6,15,21,35.724286,139.730954,2024-02-08 13:54:04
994,E3-02.教育の森公園,4,13,17,35.719345,139.736198,2024-02-08 13:54:04
995,I1-25.セブン-イレブン 品川旗の台2丁目店,0,5,5,35.607084,139.705007,2024-02-08 13:54:04
996,B1-21.日本橋二丁目街角広場,10,0,10,35.680861,139.774493,2024-02-08 13:54:04
997,C3-30.東京赤坂NKビル (ヴィアインプライム赤坂),9,0,9,35.672652,139.738908,2024-02-08 13:54:04
998,A3-36.クロックカフェ東神田,0,5,5,35.694943,139.782718,2024-02-08 13:54:04
999,E1-14.いきいき礫川,0,9,9,35.711147,139.747386,2024-02-08 13:54:04
1000,D4-09.トミンハイム仲之町,0,14,14,35.69617,139.722021,2024-02-08 13:54:04
1001,L1-08.NTT砧ビル,0,6,6,35.63534,139.601602,2024-02-08 13:54:04
1002,L1-09.コージーK・駒沢,2,1,3,35.632689,139.654804,2024-02-08 13:54:04
1003,L1-10.宮坂2-4-10,0,7,7,35.652913,139.644825,2024-02-08 13:54:04
1004,I1-22.ウィラ大井 (ショッピングモール),1,4,5,35.596579,139.745009,2024-02-08 13:54:04
1005,K1-76.グリーンベルト,9,0,9,35.585178,139.726339,2024-02-08 13:54:04
1006,H1-121.南砂5丁目,0,41,41,35.676603,139.829736,2024-02-08 13:54:04
1007,M3-02.文化総合センター大和田,5,0,5,35.65558,139.69966,2024-02-08 13:54:04
1008,D4-04.ジェノヴィア新宿早稲田グリーンヴェール,1,5,6,35.700033,139.71983,2024-02-08 13:54:04
1009,A3-20.神田ふれあい通り第２,0,2,2,35.695005,139.772747,2024-02-08 13:54:04
1010,H1-120.豊洲5丁目,18,0,18,35.650948,139.799711,2024-02-08 13:54:04
1011,C5-42.DHC芝浦2丁目ビル,2,5,7,35.644241,139.753834,2024-02-08 13:54:04
1012,I1-65.セブン-イレブン品川東大井1丁目店,7,0,7,35.605996,139.743037,2024-02-08 13:54:04
1013,M2-04.広尾東公園,5,1,6,35.653382,139.721059,2024-02-08 13:54:04
1014,M3-13.渋谷駅東口地下駐輪場,18,1,19,35.657682,139.703307,2024-02-08 13:54:04
1015,A3-19.神田ふれあい通り第１,1,4,5,35.694904,139.772712,2024-02-08 13:54:04
1016,O6-07.ローソン杉並宮前一丁目店,2,3,5,35.689639,139.613516,2024-02-08 13:54:04
1017,T3-10.貫井一丁目緑地,0,3,3,35.736378,139.632485,2024-02-08 13:54:04
1018,M2-05.日本赤十字医療センター,2,8,10,35.65519,139.718559,2024-02-08 13:54:04
1019,T2-20.パークサイド石神井,0,13,13,35.741769,139.591103,2024-02-08 13:54:04
1020,N4-06.ローソン中野本町新橋通り店,0,6,6,35.695819,139.674326,2024-02-08 13:54:04
1021,T3-07.徳殿公園,3,1,4,35.726728,139.65874,2024-02-08 13:54:04
1022,K1-35.セブン-イレブン 大田区西六郷2丁目店,0,12,12,35.549778,139.707362,2024-02-08 13:54:04
1023,A3-27.秋葉原駅中央口（ヨドバシカメラ前）,5,5,10,35.698986,139.774099,2024-02-08 13:54:04
1024,A3-28.秋葉原駅電気街口(西側交通広場),5,0,5,35.699173,139.772629,2024-02-08 13:54:04
1025,H1-57.新木場駅,10,55,65,35.64508,139.826456,2024-02-08 13:54:04
1026,H1-58.潮見駅,0,27,27,35.658703,139.817251,2024-02-08 13:54:04
1027,D7-02.セブン-イレブン 新宿中落合3丁目店,0,16,16,35.722202,139.691712,2024-02-08 13:54:04
1028,D2-06.飯田濠,13,1,14,35.70057,139.74301,2024-02-08 13:54:04
1029,C5-17.鈴与浜松町ビル,5,5,10,35.651103,139.759092,2024-02-08 13:54:04
1030,H1-59.LYURO 東京清澄,0,24,24,35.681316,139.792176,2024-02-08 13:54:04
1031,H1-60.荒川・砂町庭球場西,0,29,29,35.679678,139.844892,2024-02-08 13:54:04
1032,K1-44.中馬込貝塚公園,2,5,7,35.594795,139.704951,2024-02-08 13:54:04
1033,M6-11.京王サイクルパーク笹塚,0,6,6,35.674337,139.668801,2024-02-08 13:54:04
1034,J1-49.伊勢脇公園,1,3,4,35.638864,139.696568,2024-02-08 13:54:04
1035,K1-45.たぬき山公園,1,7,8,35.592801,139.715472,2024-02-08 13:54:04
1036,D2-01.あずさセンタービル,12,6,18,35.702286,139.741093,2024-02-08 13:54:04
1037,C1-02.西新橋1丁目（外堀通り）,5,1,6,35.668791,139.753582,2024-02-08 13:54:04
1038,O3-07.NTT井草ビル第1ポート,2,1,3,35.714044,139.61688,2024-02-08 13:54:04
1039,T2-41.ローソン 練馬東大泉五丁目店,0,4,4,35.74248,139.58715,2024-02-08 13:54:04
1040,H1-144.南砂住宅,0,16,16,35.674199,139.822018,2024-02-08 13:54:04
1041,C3-28.ヒューリックＪＰ赤坂ビル,11,0,11,35.672477,139.739743,2024-02-08 13:54:04
1042,H1-145.東雲都橋住宅,0,12,12,35.643131,139.797784,2024-02-08 13:54:04
1043,I1-58.品川区役所　第二庁舎前,18,0,18,35.609664,139.730006,2024-02-08 13:54:04
1044,K1-92.蒲田駅西口自転車駐車場,25,0,25,35.561101,139.715173,2024-02-08 13:54:04
1045,A2-24.水道橋駅西口前,6,0,6,35.702271,139.752619,2024-02-08 13:54:04
1046,K1-94.昭和島駅前,0,25,25,35.572188,139.749613,2024-02-08 13:54:04
1047,M5-15.新宿マインズタワー,17,3,20,35.686567,139.699355,2024-02-08 13:54:04
1048,D7-13.日本光電本社南側,11,4,15,35.71936,139.679083,2024-02-08 13:54:04
1049,N3-09.中野区役所(北側),4,1,5,35.708259,139.663829,2024-02-08 13:54:04
1050,H1-163.森下公園,1,4,5,35.68663,139.799529,2024-02-08 13:54:04
1051,B4-23.交通広場（豊海町）,0,13,13,35.653771,139.769295,2024-02-08 13:54:04
1052,D6-18.ヨドバシカメラ 新宿西口本店前,0,6,6,35.689689,139.698231,2024-02-08 13:54:04
1053,I1-47.NTT 東日本 関東病院(南側),7,0,7,35.630151,139.725215,2024-02-08 13:54:04
1054,H1-112.ファミリーマート江東塩浜二丁目店,3,0,3,35.66305,139.8087,2024-02-08 13:54:04
1055,K1-103.雪谷特別出張所,0,7,7,35.594515,139.691219,2024-02-08 13:54:04
1056,E5-17.Village藍染,1,4,5,35.720896,139.76422,2024-02-08 13:54:04
1057,I1-49.京急鮫洲バイク駐輪場,5,1,6,35.603815,139.741362,2024-02-08 13:54:04
1058,I1-50.京急立会川第2バイク駐輪場,0,14,14,35.599196,139.739158,2024-02-08 13:54:04
1059,E4-14.NTT東日本大塚ビル,0,17,17,35.726188,139.741375,2024-02-08 13:54:04
1060,M2-07.ファミリーマート恵比寿駅東店,7,0,7,35.6471,139.712818,2024-02-08 13:54:04
1061,M4-07.千駄ヶ谷駅前,1,3,4,35.68082,139.71188,2024-02-08 13:54:04
1062,O5-07.バーンホーフ キクチ,11,9,20,35.698169,139.655665,2024-02-08 13:54:04
1063,J1-11.コンフォリア目黒青葉台,0,6,6,35.649023,139.696086,2024-02-08 13:54:04
1064,L1-14.給田3丁目,0,13,13,35.664335,139.590114,2024-02-08 13:54:04
1065,B4-06.月島駅地下駐輪場,1,16,17,35.66291,139.782564,2024-02-08 13:54:04
1066,C5-09.グランパーク,20,1,21,35.643202,139.746244,2024-02-08 13:54:04
1067,C5-08.AQUACITY芝浦,6,4,10,35.637366,139.74844,2024-02-08 13:54:04
1068,C3-08.赤坂パークビルヂング,5,0,5,35.671792,139.733668,2024-02-08 13:54:04
1069,C3-07.新青山ビル,17,1,18,35.672659,139.725644,2024-02-08 13:54:04
1070,C3-06.ホテルアジア会館,0,11,11,35.67064,139.728166,2024-02-08 13:54:04
1071,C1-24.三田国際ビル,0,10,10,35.653159,139.744673,2024-02-08 13:54:04
1072,C5-07.港区立港南図書館,0,36,36,35.632842,139.7495,2024-02-08 13:54:04
1073,A3-04.秋葉原公園,0,21,21,35.697642,139.774867,2024-02-08 13:54:04
1074,A3-05.和泉公園（西側入口）,4,2,6,35.698817,139.778898,2024-02-08 13:54:04
1075,A3-02.絶滅メディア博物館（楓ビル）,8,0,8,35.689575,139.767848,2024-02-08 13:54:04
1076,O3-10.メゾンパークス,3,5,8,35.716265,139.618954,2024-02-08 13:54:04
1077,A2-05.神田橋公園,0,1,1,35.689665,139.764091,2024-02-08 13:54:04
1078,A3-01.神田児童公園（西側交番横）,4,2,6,35.692983,139.76773,2024-02-08 13:54:04
1079,A2-03.西神田公園（西側）,5,0,5,35.698338,139.754876,2024-02-08 13:54:04
1080,M6-03.十三号通り公園,0,9,9,35.675198,139.663587,2024-02-08 13:54:04
1081,M6-02.サイカパーク笹塚,0,10,10,35.673444,139.666553,2024-02-08 13:54:04
1082,H1-165.亀戸梅屋敷,0,10,10,35.701318,139.825916,2024-02-08 13:54:04
1083,H1-166.亀戸クロック,17,2,19,35.696574,139.82972,2024-02-08 13:54:04
1084,M5-02.あいおいニッセイ同和損保新宿ビル,0,5,5,35.684423,139.692262,2024-02-08 13:54:04
1085,M6-01.幡ヶ谷駅高架下第一,23,13,36,35.677175,139.676769,2024-02-08 13:54:04
1086,A5-02.山王パークタワー,4,1,5,35.673555,139.741293,2024-02-08 13:54:04
1087,K1-116.旧呑川緑地（大森東五丁目）,6,6,12,35.567176,139.742345,2024-02-08 13:54:04
1088,K1-115.旧呑川緑地（大森中三丁目）,0,8,8,35.565685,139.736195,2024-02-08 13:54:04
1089,K1-114.下丸子公園,6,2,8,35.568722,139.680736,2024-02-08 13:54:04
1090,T3-05.東武練馬駅南,0,10,10,35.767129,139.664365,2024-02-08 13:54:04
1091,T1-14.ファミリーマート 練馬高松五丁目北店,4,0,4,35.761038,139.623148,2024-02-08 13:54:04
1092,C3-29.高橋是清翁記念公園,5,1,6,35.674094,139.728895,2024-02-08 13:54:04
1093,K1-141.蒲田駅西口歩道,5,0,5,35.561291,139.715076,2024-02-08 13:54:04
1094,C3-35.ワールド北青山ビル,17,0,17,35.667069,139.713423,2024-02-08 13:54:04
1095,M5-03.代々木大山公園,9,7,16,35.671282,139.675307,2024-02-08 13:54:04
1096,E5-13.弥生二丁目,4,2,6,35.715592,139.76192,2024-02-08 13:54:04
1097,E5-12.NK本郷ビル,0,6,6,35.704475,139.763041,2024-02-08 13:54:04
1098,B3-18.銀座松竹スクエア,9,0,9,35.668395,139.769849,2024-02-08 13:54:04
1099,C1-44.三田Avanti,5,1,6,35.64115,139.741471,2024-02-08 13:54:04
1100,T2-31.ファミリーマート 石神井台二丁目店,0,9,9,35.739488,139.590273,2024-02-08 13:54:04
1101,H1-150.ホテルヴィラフォンテーヌ南側,8,0,8,35.636978,139.791858,2024-02-08 13:54:04
1102,H1-149.有明ガーデン 公園口,7,1,8,35.639132,139.793047,2024-02-08 13:54:04
1103,H1-148.大島七丁目団地,0,17,17,35.694104,139.840278,2024-02-08 13:54:04
1104,B4-26.東武ストア晴海三丁目店,1,13,14,35.654371,139.779545,2024-02-08 13:54:04
1105,J1-26.田向公園,3,4,7,35.623459,139.687128,2024-02-08 13:54:04
1106,J1-25.碑文谷公園,3,5,8,35.625081,139.682632,2024-02-08 13:54:04
1107,H1-195.東京アクアティクスセンター,5,14,19,35.65238,139.815613,2024-02-08 13:54:04
1108,T1-13.ファミリーマート 練馬土支田二丁目店,0,14,14,35.761613,139.61349,2024-02-08 13:54:04
1109,T2-34.ファミリーマート 練馬富士見台店,0,5,5,35.73969,139.62125,2024-02-08 13:54:04
1110,T2-35.ファミリーマート 石神井台六丁目店,0,5,5,35.738607,139.585331,2024-02-08 13:54:04
1111,C1-81.田町タワー,20,0,20,35.646534,139.748913,2024-02-08 13:54:04
1112,J1-07.目黒川船入場,13,2,15,35.641992,139.701588,2024-02-08 13:54:04
1113,J1-08.目黒区民センター公園,14,4,18,35.634533,139.708868,2024-02-08 13:54:04
1114,D4-01.市谷仲之町,2,4,6,35.695102,139.723345,2024-02-08 13:54:04
1115,M2-11.鉢山町,15,1,16,35.652151,139.698426,2024-02-08 13:54:04
1116,E4-08.ドコモ・バイクシェア向丘ポート,0,8,8,35.720546,139.756685,2024-02-08 13:54:04
1117,D4-03.市谷加賀町2丁目,0,10,10,35.695636,139.727882,2024-02-08 13:54:04
1118,N1-01.BeGood野方,0,11,11,35.719717,139.64785,2024-02-08 13:54:04
1119,C2-03.アークヒルズサウスタワー,9,2,11,35.666357,139.73923,2024-02-08 13:54:04
1120,C2-01.アークヒルズ（アーク森ビル）,7,4,11,35.667107,139.739565,2024-02-08 13:54:04
1121,C2-02.六本木ヒルズ,26,1,27,35.661158,139.728533,2024-02-08 13:54:04
1122,C5-03.港南公園C,0,35,35,35.624966,139.746657,2024-02-08 13:54:04
1123,C5-04.みなとパーク芝浦,10,0,10,35.646801,139.751208,2024-02-08 13:54:04
1124,C1-16.機械振興会館,6,0,6,35.659442,139.745549,2024-02-08 13:54:04
1125,C1-14.新橋プラザビル,1,3,4,35.664461,139.756082,2024-02-08 13:54:04
1126,H1-73.イシマビル,0,5,5,35.67386,139.79976,2024-02-08 13:54:04
1127,O7-01.西永福公園,4,1,5,35.67753,139.63667,2024-02-08 13:54:04
1128,O6-02.富士見ヶ丘南自転車駐車場,6,2,8,35.68296,139.60861,2024-02-08 13:54:04
1129,K1-50.テクノポートカマタ 第1,6,0,6,35.556199,139.721476,2024-02-08 13:54:04
1130,J1-14.二の橋自転車置場1,38,1,39,35.614856,139.678208,2024-02-08 13:54:04
1131,O3-08.NTT井草ビル第２ポート,1,2,3,35.714077,139.61694,2024-02-08 13:54:04
1132,H1-124.セブン-イレブン 江東海辺店,1,11,12,35.680636,139.817977,2024-02-08 13:54:04
1133,D1-11.三井ガーデンホテル神宮外苑の杜プレミア,5,0,5,35.679807,139.715931,2024-02-08 13:54:04
1134,O7-07.ハレ永福,1,7,8,35.678913,139.639944,2024-02-08 13:54:04
1135,C5-32.トレードピアお台場,4,1,5,35.627891,139.776896,2024-02-08 13:54:04
1136,B4-18.豊海センタービル,0,5,5,35.653531,139.769431,2024-02-08 13:54:04
1137,D5-04.西戸山公園野球場,2,5,7,35.707388,139.700204,2024-02-08 13:54:04
1138,D5-03.北新宿公園,0,14,14,35.702288,139.68862,2024-02-08 13:54:04
1139,D3-04.鶴巻南公園,0,23,23,35.706182,139.723394,2024-02-08 13:54:04
1140,D3-03.甘泉園公園,0,15,15,35.712431,139.715418,2024-02-08 13:54:04
1141,K1-03.池上会館,0,7,7,35.576593,139.706597,2024-02-08 13:54:04
1142,K1-02.平和の森公園,11,4,15,35.579049,139.739878,2024-02-08 13:54:04
1143,K1-01.大森海苔のふるさと館,0,10,10,35.57685,139.742496,2024-02-08 13:54:04
1144,D6-13.新宿中央公園（ジャブジャブ池下）,8,1,9,35.687652,139.689254,2024-02-08 13:54:04
1145,T2-28.ファミリーマート 南大泉六丁目店,3,2,5,35.752217,139.571095,2024-02-08 13:54:04
1146,K1-05.平和島公園プール,13,4,17,35.581832,139.741581,2024-02-08 13:54:04
1147,K1-04.京急蒲田駅東口,19,0,19,35.559483,139.724273,2024-02-08 13:54:04
1148,E2-10.音羽パークロード（北入口）,13,2,15,35.716586,139.727705,2024-02-08 13:54:04
1149,E2-11.音羽パークロード（キャッチボール場横）,13,7,20,35.715382,139.728533,2024-02-08 13:54:04
1150,I1-21.大井競馬場(正門前),10,0,10,35.593887,139.741204,2024-02-08 13:54:04
1151,J1-27.衾町公園,1,0,1,35.623215,139.668472,2024-02-08 13:54:04
1152,T2-44.中島橋自転車駐車場,5,2,7,35.75372,139.584332,2024-02-08 13:54:04
1153,B3-15.ACホテル・バイ・マリオット東京銀座,8,0,8,35.668845,139.765144,2024-02-08 13:54:04
1154,D5-07.百人町1丁目,3,2,5,35.699252,139.697606,2024-02-08 13:54:04
1155,C4-04.ショパン高輪,0,10,10,35.632128,139.732097,2024-02-08 13:54:04
1156,B1-18.セブン-イレブン 日本橋小網町店,2,1,3,35.681352,139.781436,2024-02-08 13:54:04
1157,T2-71.わかば児童公園,4,3,7,35.7211,139.574669,2024-02-08 13:54:04
1158,M3-15.co-ba ebisu,5,1,6,35.647076,139.703964,2024-02-08 13:54:04
1159,C2-20.三井ガーデンホテル六本木プレミア,4,0,4,35.66206,139.735501,2024-02-08 13:54:04
1160,I1-70.五反田リバーステーション,3,5,8,35.624566,139.72448,2024-02-08 13:54:04
1161,E5-25.ジェノヴィア東大前グリーンヴェール,7,4,11,35.711875,139.759306,2024-02-08 13:54:04
1162,D1-12.ジェノヴィア新宿御苑グリーンヴェール,1,6,7,35.689017,139.714755,2024-02-08 13:54:04
1163,C5-33.msb Tamachi,37,1,38,35.645682,139.748768,2024-02-08 13:54:04
1164,G4-09.SYFORME MORISHITA Ⅱ 1,1,0,1,35.690348,139.796133,2024-02-08 13:54:04
1165,G4-10.SYFORME MORISHITA Ⅱ 2,1,4,5,35.690307,139.796128,2024-02-08 13:54:04
1166,N3-19.上高田パーキング,0,17,17,35.715878,139.673669,2024-02-08 13:54:04
1167,F6-01.松坂屋上野店,2,2,4,35.707305,139.773657,2024-02-08 13:54:04
1168,F4-01.SYFORME ASAKUSA,0,4,4,35.718832,139.791133,2024-02-08 13:54:04
1169,F2-02.アップルパーク浅草6丁目第3,0,3,3,35.716062,139.799552,2024-02-08 13:54:04
1170,F2-01.松が谷2丁目2,0,20,20,35.71283,139.787754,2024-02-08 13:54:04
1171,F1-02.台東デザイナーズビレッジ,1,6,7,35.706023,139.783751,2024-02-08 13:54:04
1172,F2-03.台東区生涯学習センター,0,6,6,35.717497,139.790055,2024-02-08 13:54:04
1173,K1-146.南馬込6丁目25-11,0,3,3,35.582743,139.710561,2024-02-08 13:54:04
1174,F3-01.清川1丁目18-11,0,17,17,35.724944,139.801684,2024-02-08 13:54:04
1175,F1-03.新御徒町駅自転車駐車場,4,12,16,35.706793,139.782985,2024-02-08 13:54:04
1176,F3-02.台東区リバーサイドスポーツセンター,0,7,7,35.717571,139.804216,2024-02-08 13:54:04
1177,I1-45.セブン-イレブン品川西五反田3丁目店,5,0,5,35.62541,139.718135,2024-02-08 13:54:04
1178,H1-135.北砂5丁目団地,0,34,34,35.684218,139.832843,2024-02-08 13:54:04
1179,C3-16.赤坂ガーデンシティ,0,10,10,35.6738,139.731525,2024-02-08 13:54:04
1180,J1-34.田道広場公園,7,3,10,35.636269,139.709073,2024-02-08 13:54:04
1181,O5-08.セシオン杉並,0,3,3,35.69714,139.65432,2024-02-08 13:54:04
1182,A2-04.ちよだプラットフォームスクウェア,10,0,10,35.691456,139.762228,2024-02-08 13:54:04
1183,I1-102.J.GRAN Court 品川西大井 EAST,2,5,7,35.598244,139.722447,2024-02-08 13:54:04
1184,H1-196.フットサルクラブ東京東陽町,5,1,6,35.665288,139.824294,2024-02-08 13:54:04
1185,F2-04.コンフォラス浅草マンション,0,3,3,35.717241,139.801674,2024-02-08 13:54:04
1186,G5-03.京成リッチモンドホテル東京錦糸町,3,2,5,35.693492,139.81506,2024-02-08 13:54:04
1187,K1-27.六郷文化センター,0,4,4,35.544715,139.707623,2024-02-08 13:54:04
1188,K1-147.トヨタモビリティ東京GRGarage東京蒲田店,2,0,2,35.552741,139.718404,2024-02-08 13:54:04
1189,K1-148.トヨタモビリティ東京 蒲田仲六郷店,6,0,6,35.552068,139.71747,2024-02-08 13:54:04
1190,K1-150.トヨタモビリティ東京 池上第二京浜店,1,4,5,35.568019,139.696379,2024-02-08 13:54:04
1191,K1-149.トヨタモビリティ東京 大田店,2,4,6,35.59336,139.715879,2024-02-08 13:54:04
1192,C1-82.トヨタモビリティ東京 港三田店,0,5,5,35.647831,139.739048,2024-02-08 13:54:04
1193,D4-11.トヨタモビリティ東京 新宿明治通り南店,2,0,2,35.699835,139.70808,2024-02-08 13:54:04
1194,C3-31.赤坂一丁目,13,4,17,35.670239,139.744285,2024-02-08 13:54:04
1195,E1-04.礫川公園,32,9,41,35.707853,139.751518,2024-02-08 13:54:04
1196,M3-23.円山町7-1,0,9,9,35.658229,139.694885,2024-02-08 13:54:04
1197,M3-24.渋谷道玄坂２丁目駐輪場,3,15,18,35.66026,139.69684,2024-02-08 13:54:04
1198,T3-32.練馬北町1丁目,1,4,5,35.764452,139.666299,2024-02-08 13:54:04
1199,H1-197.セブン-イレブン江東南砂葛西橋通り店,0,4,4,35.675361,139.825034,2024-02-08 13:54:04
1200,T2-84.石神井町二丁目緑地,0,3,3,35.748395,139.605958,2024-02-08 13:54:04
1201,T2-82.梅の木児童遊園,0,5,5,35.737899,139.576584,2024-02-08 13:54:04
1202,T2-83.西大泉さくら緑地,4,4,8,35.760442,139.573145,2024-02-08 13:54:04
1203,D7-05.西落合図書館,7,1,8,35.725818,139.678976,2024-02-08 13:54:04
1204,D6-28.東急ステイ新宿,3,0,3,35.690899,139.706348,2024-02-08 13:54:04
1205,T2-85.泉新公園,3,1,4,35.7547,139.601497,2024-02-08 13:54:04
1206,T2-86.石神井町八丁目緑地,2,1,3,35.746956,139.600798,2024-02-08 13:54:04
1207,T2-87.南大泉四丁目児童遊園,0,4,4,35.745607,139.573947,2024-02-08 13:54:04
1208,T2-88.南大泉かたまち緑地,0,4,4,35.739633,139.570457,2024-02-08 13:54:04
1209,T2-89.南大泉三丁目児童遊園,0,3,3,35.742755,139.568335,2024-02-08 13:54:04
1210,E2-05.護国寺駅西自転車駐車場,20,2,22,35.719421,139.725584,2024-02-08 13:54:04
1211,J1-59.第44興和ビル,2,1,3,35.647704,139.693671,2024-02-08 13:54:04
1212,C1-15.東京タワー,11,5,16,35.65928,139.744767,2024-02-08 13:54:04
1213,C5-20.ローソン芝浦二丁目店,4,0,4,35.645254,139.754765,2024-02-08 13:54:04
1214,C2-27.有栖川宮記念公園第一,17,0,17,35.651382,139.724392,2024-02-08 13:54:04
1215,C2-28.有栖川宮記念公園第二,4,4,8,35.651129,139.726003,2024-02-08 13:54:04
1216,C2-29.狸穴公園,4,1,5,35.658204,139.738935,2024-02-08 13:54:04
1217,T2-90.南田中四丁目緑地,2,2,4,35.733195,139.612327,2024-02-08 13:54:04
1218,T2-91.石神井町四丁目緑地,5,0,5,35.745272,139.604579,2024-02-08 13:54:04
1219,A3-41.秋葉原ダイビル,4,0,4,35.698917,139.771856,2024-02-08 13:54:04
1220,J1-54.田道住区センター三田分室,5,0,5,35.638904,139.712518,2024-02-08 13:54:04
1221,H1-140.キャナルパレス住吉,11,5,16,35.689896,139.815116,2024-02-08 13:54:04
1222,C1-57.虎ノ門ツインビルディング,7,0,7,35.667259,139.745643,2024-02-08 13:54:04
1223,K1-54.ファミリーマート大田久が原五丁目店,0,9,9,35.579435,139.698552,2024-02-08 13:54:04
1224,B1-29.ASTILE日本橋浜町,0,8,8,35.685504,139.790817,2024-02-08 13:54:04
1225,N3-20.SYFORME NAKANO-SAKAUE,3,2,5,35.701157,139.679617,2024-02-08 13:54:04
1226,D6-31.東急歌舞伎町タワー駐輪場,2,6,8,35.696207,139.700521,2024-02-08 13:54:04
1227,I1-30.ローソン 大井三丁目店,7,0,7,35.603327,139.729006,2024-02-08 13:54:04
1228,K1-151.PATH仲六郷,10,0,10,35.549465,139.711157,2024-02-08 13:54:04
1229,H1-198.Br Tower 有明 MID CROSS,4,3,7,35.63464,139.783445,2024-02-08 13:54:04
1230,H1-04.石と光の広場（国際展示場駅）,43,18,61,35.63363,139.79082,2024-02-08 13:54:04
1231,B4-24.ミュプレ月島,4,3,7,35.66288,139.78329,2024-02-08 13:54:04
1232,H1-199.ラ・ヴェール東陽町,1,9,10,35.664244,139.814506,2024-02-08 13:54:04
1233,H1-200.ヴェッセル木場南,0,11,11,35.662414,139.813333,2024-02-08 13:54:04
1234,F1-04.台東2丁目21,0,5,5,35.703465,139.780325,2024-02-08 13:54:04
1235,F3-03.ヴェルステージ南千住,0,5,5,35.728704,139.801867,2024-02-08 13:54:04
1236,J1-46.五本木西みどり街かど公園,0,6,6,35.632735,139.683899,2024-02-08 13:54:04
1237,K1-131.東急武蔵新田駅駐輪場,11,4,15,35.567146,139.693344,2024-02-08 13:54:04
1238,K1-152.アットホームスクエア前,0,8,8,35.543327,139.703223,2024-02-08 13:54:04
1239,B2-04.清水建設本社（都営地下鉄宝町駅 Ａ８出口）,15,2,17,35.676119,139.772895,2024-02-08 13:54:04
1240,H1-202.辰巳の森海浜公園,7,5,12,35.648107,139.813572,2024-02-08 13:54:04
1241,H1-201.ウエリスアーバン水天宮前2,1,5,6,35.678099,139.791831,2024-02-08 13:54:04
1242,I1-103.五反田ＪＰビルディング,3,0,3,35.622389,139.721552,2024-02-08 13:54:04
1243,L1-16.上祖師谷7丁目,13,1,14,35.65838,139.59231,2024-02-08 13:54:04
1244,O5-09.AppCruise中野,1,1,2,35.700772,139.66063,2024-02-08 13:54:04
1245,H1-203.セブン-イレブン江東木場３丁目店,0,9,9,35.67517,139.804087,2024-02-08 13:54:04
1246,H1-44.テプコ豊洲ビル,25,0,25,35.648726,139.790877,2024-02-08 13:54:04
1247,L1-17.赤堤3丁目,3,4,7,35.659787,139.636696,2024-02-08 13:54:04
1248,L1-18.上北沢1丁目,20,10,30,35.662796,139.626795,2024-02-08 13:54:04
1249,B3-16.明石町区民館,0,11,11,35.666001,139.778102,2024-02-08 13:54:04
1250,I1-104.源氏前ビル,5,0,5,35.603521,139.712345,2024-02-08 13:54:04
1251,J1-28.宮前公園,0,8,8,35.617699,139.664826,2024-02-08 13:54:04
1252,M6-18.セブン-イレブン渋谷本町3丁目店,0,3,3,35.686521,139.685017,2024-02-08 13:54:04
1253,O7-08.杉並区和泉2-3-17,0,4,4,35.67187,139.65474,2024-02-08 13:54:04
1254,T1-17.セブン-イレブン練馬田柄通店,6,1,7,35.75987,139.640474,2024-02-08 13:54:04
1255,H1-18.東京ビッグサイト,7,9,16,35.631192,139.79401,2024-02-08 13:54:04
1256,M3-01.渋谷マークシティ,11,2,13,35.657726,139.697802,2024-02-08 13:54:04
1257,H1-70.有明スポーツセンター,13,4,17,35.63403,139.784319,2024-02-08 13:54:04
1258,H1-41.深川北スポーツセンター,2,11,13,35.676475,139.804741,2024-02-08 13:54:04
1259,H1-55.深川江戸資料館,3,5,8,35.681089,139.800777,2024-02-08 13:54:04
1260,I1-61.五反田文化センター,3,4,7,35.622588,139.716159,2024-02-08 13:54:04
1261,N3-13.中部すこやか福祉センター,3,2,5,35.700052,139.673715,2024-02-08 13:54:04
1262,A4-02.東京サンケイビル,9,1,10,35.686847,139.765151,2024-02-08 13:54:04
1263,M3-09.ティップ.クロス TOKYO 渋谷,10,9,19,35.661475,139.699296,2024-02-08 13:54:04
1264,B3-02.サンクンガーデン,2,4,6,35.670336,139.771911,2024-02-08 13:54:04
1265,T2-10.勤労福祉会館,5,0,5,35.748153,139.58765,2024-02-08 13:54:04
1266,K1-133.東京港野鳥公園,13,0,13,35.584217,139.759232,2024-02-08 13:54:04
1267,K1-21.六郷特別出張所,0,8,8,35.55079,139.716517,2024-02-08 13:54:04
1268,H1-54.砂町文化センター,3,17,20,35.680052,139.831874,2024-02-08 13:54:04
1269,D1-08.新宿歴史博物館,3,1,4,35.689984,139.725261,2024-02-08 13:54:04
1270,E1-05.春日地下自転車駐車場,24,3,27,35.708291,139.753335,2024-02-08 13:54:04
1271,E1-15.播磨坂事業所,0,2,2,35.71724,139.74289,2024-02-08 13:54:04
1272,E5-02.不忍通りふれあい館,0,12,12,35.719356,139.764308,2024-02-08 13:54:04
1273,E4-02.向丘地域活動センター,8,5,13,35.717357,139.757817,2024-02-08 13:54:04
1274,C3-18.明治記念館,4,1,5,35.678509,139.721207,2024-02-08 13:54:04
1275,D5-05.中央図書館,13,2,15,35.705018,139.706841,2024-02-08 13:54:04
1276,E2-07.肥後細川庭園,10,3,13,35.713223,139.721699,2024-02-08 13:54:04
1277,A1-05.富士見出張所,0,3,3,35.699187,139.746348,2024-02-08 13:54:04
1278,E5-07.湯島三丁目児童遊園,3,5,8,35.707296,139.769393,2024-02-08 13:54:04
1279,D5-10.桜美林大学 新宿キャンパス,1,6,7,35.705154,139.697562,2024-02-08 13:54:04
1280,A3-08.神田明神（神田神社）,11,2,13,35.702029,139.768245,2024-02-08 13:54:04
1281,E2-14.永青文庫 ミュージアム,5,0,5,35.713145,139.723342,2024-02-08 13:54:04
1282,M5-17.小田急サザンタワー,8,1,9,35.6866,139.70014,2024-02-08 13:54:04
1283,K1-16.ファミリーマート 矢口二丁目店,3,3,6,35.563092,139.693548,2024-02-08 13:54:04
1284,H1-206.北砂5丁目団地2,0,10,10,35.683866,139.831809,2024-02-08 13:54:04
1285,G1-02.八広駅高架下,4,10,14,35.727495,139.828499,2024-02-08 13:54:04
1286,F4-02.Risingplace浅草四番館,0,4,4,35.717963,139.791025,2024-02-08 13:54:04
1287,H1-204.大島四丁目団地2,3,5,8,35.68832,139.828829,2024-02-08 13:54:04
1288,H1-205.大島四丁目団地3,5,5,10,35.688236,139.827711,2024-02-08 13:54:04
1289,H1-106.亀戸中央公園,12,7,19,35.699874,139.834263,2024-02-08 13:54:04
1290,E5-30.湯島3丁目15,0,12,12,35.705148,139.769314,2024-02-08 13:54:04
1291,B4-38.HARUMI FLAG SUN VILLAGE,0,24,24,35.650347,139.771785,2024-02-08 13:54:04
1292,B4-32.HARUMI FLAG SEA VILLAGE,0,10,10,35.648731,139.774995,2024-02-08 13:54:04
1293,B4-31.HARUMI FLAG PORT VILLAGE,0,19,19,35.650604,139.77724,2024-02-08 13:54:04
1294,B4-33.HARUMI FLAG SEA VILLAGE,0,15,15,35.649552,139.776369,2024-02-08 13:54:04
1295,B4-36.HARUMI FLAG SEA VILLAGE,2,10,12,35.650742,139.778097,2024-02-08 13:54:04
1296,B4-35.HARUMI FLAG SEA VILLAGE,1,11,12,35.650573,139.777908,2024-02-08 13:54:04
1297,B4-37.HARUMI FLAG SUN VILLAGE,0,17,17,35.649419,139.771447,2024-02-08 13:54:04
1298,B4-34.HARUMI FLAG SEA VILLAGE,2,10,12,35.649932,139.776958,2024-02-08 13:54:04
1299,B4-39.HARUMI FLAG SUN VILLAGE,0,18,18,35.650863,139.772549,2024-02-08 13:54:04
1300,B4-40.HARUMI FLAG SUN VILLAGE,0,15,15,35.651305,139.773379,2024-02-08 13:54:04
1301,B4-41.HARUMI FLAG SUN VILLAGE,0,17,17,35.649854,139.77334,2024-02-08 13:54:04
1302,B4-42.HARUMI FLAG SUN VILLAGE,0,11,11,35.649329,139.772656,2024-02-08 13:54:04
1303,B4-28.HARUMI FLAG PORT VILLAGE,4,7,11,35.651183,139.776119,2024-02-08 13:54:04
1304,B4-50.HARUMI FLAG PARK VILLAGE,2,7,9,35.648295,139.773973,2024-02-08 13:54:04
1305,B4-49.HARUMI FLAG PARK VILLAGE,4,12,16,35.648636,139.774251,2024-02-08 13:54:04
1306,B4-48.HARUMI FLAG PARK VILLAGE,0,5,5,35.649513,139.775287,2024-02-08 13:54:04
1307,B4-47.HARUMI FLAG PARK VILLAGE,2,4,6,35.649119,139.775138,2024-02-08 13:54:04
1308,B4-46.HARUMI FLAG PARK VILLAGE,0,25,25,35.649642,139.773859,2024-02-08 13:54:04
1309,B4-45.HARUMI FLAG PARK VILLAGE,0,24,24,35.649002,139.772764,2024-02-08 13:54:04
1310,B4-44.HARUMI FLAG PARK VILLAGE,3,10,13,35.648221,139.772666,2024-02-08 13:54:04
1311,B4-30.HARUMI FLAG PORT VILLAGE,2,9,11,35.651136,139.778218,2024-02-08 13:54:04
1312,B4-29.HARUMI FLAG PORT VILLAGE,0,17,17,35.651907,139.777391,2024-02-08 13:54:04
1313,L1-19.三軒茶屋1丁目駐輪場,1,3,4,35.639302,139.674744,2024-02-08 13:54:04
1314,O7-09.方南月極パーキング,8,9,17,35.678921,139.658289,2024-02-08 13:54:04
1315,O5-10.ローソン ツルハドラッグ杉並和田店,1,3,4,35.68942,139.662118,2024-02-08 13:54:04
1316,O2-04.西荻北1丁目,2,3,5,35.708082,139.607543,2024-02-08 13:54:04
1317,K1-75.三井不動産インダストリアルパーク羽田,6,4,10,35.556231,139.751408,2024-02-08 13:54:04
1318,F1-05.ホウエイコート秋葉原,0,2,2,35.703024,139.78052,2024-02-08 13:54:04
1319,C3-36.第35興和ビル,2,2,4,35.666349,139.741781,2024-02-08 13:54:04
1320,B4-53.晴海五丁目ターミナル,25,81,106,35.651627,139.773103,2024-02-08 13:54:04
1321,C5-44.ブランズタワー芝浦,9,0,9,35.643105,139.753039,2024-02-08 13:54:04
1322,A3-47.ホテルヴィラフォンテーヌ東京大手町,13,0,13,35.690602,139.766916,2024-02-08 13:54:04
1323,A1-20.菱和パレス九段,3,2,5,35.693021,139.740317,2024-02-08 13:54:04
0,E5-26.本郷4丁目,0,5,5,35.708596,139.758269,2024-02-08 16:00:04
1,A3-42.内神田3丁目,34,0,34,35.692599,139.770109,2024-02-08 16:00:04
2,T2-76.東中前の森緑地,3,2,5,35.748736,139.574839,2024-02-08 16:00:04
3,A2-20.神田スクエア,16,1,17,35.693408,139.762809,2024-02-08 16:00:04
4,K1-79.Tマークシティホテル東京大森,6,1,7,35.586993,139.736491,2024-02-08 16:00:04
5,K1-80.大森北6丁目,4,0,4,35.579849,139.731241,2024-02-08 16:00:04
6,H1-130.トヨタモビリティ東京 深川店,6,1,7,35.676643,139.816054,2024-02-08 16:00:04
7,H1-131.セブン-イレブン 江東佐賀2丁目店,0,3,3,35.679029,139.793535,2024-02-08 16:00:04
8,H1-132.セブン-イレブン 江東三好4丁目店,0,5,5,35.681418,139.809287,2024-02-08 16:00:04
9,A6-22.半蔵門PREX South,11,4,15,35.683433,139.740756,2024-02-08 16:00:04
10,I1-74.セブン-イレブン西五反田6丁目店,5,0,5,35.622403,139.71771,2024-02-08 16:00:04
11,G2-01.東京ソラマチ,6,1,7,35.709777,139.810189,2024-02-08 16:00:04
12,T2-59.平成公園,2,1,3,35.722917,139.587864,2024-02-08 16:00:04
13,I1-26.大崎西口公園,0,13,13,35.617475,139.729221,2024-02-08 16:00:04
14,I1-96.西五反田２丁目,10,0,10,35.627599,139.720463,2024-02-08 16:00:04
15,H1-172.サンヨーパシフィックマンション,0,8,8,35.668856,139.794069,2024-02-08 16:00:04
16,J1-56.青葉台四丁目街かど公園,3,1,4,35.654009,139.692727,2024-02-08 16:00:04
17,H1-173.森下駅前,19,20,39,35.687837,139.79654,2024-02-08 16:00:04
18,E3-01.大塚地域活動センター跡地,3,5,8,35.718656,139.734556,2024-02-08 16:00:04
19,E2-03.目白台運動公園,33,3,36,35.715556,139.721988,2024-02-08 16:00:04
20,T2-77.大泉なかよし緑地,3,1,4,35.759861,139.581682,2024-02-08 16:00:04
21,E2-01.江戸川橋Ｂ自転車駐車場,43,38,81,35.710381,139.732137,2024-02-08 16:00:04
22,E2-02.江戸川公園,11,5,16,35.710958,139.731165,2024-02-08 16:00:04
23,D7-14.大栄パーク西落合１丁目,4,1,5,35.720028,139.678936,2024-02-08 16:00:04
24,E1-07.礫川地域活動センター,6,1,7,35.712015,139.750284,2024-02-08 16:00:04
25,M6-05.七号通り公園,0,10,10,35.67917,139.67493,2024-02-08 16:00:04
26,H1-138.HW.HILLS新大橋,5,3,8,35.687416,139.795588,2024-02-08 16:00:04
27,B4-21.月島駅前第一駐輪場,22,4,26,35.663681,139.785651,2024-02-08 16:00:04
28,N2-03.野方1丁目,7,0,7,35.712179,139.65603,2024-02-08 16:00:04
29,C5-52.港南四丁目第3アパート駐車場,10,0,10,35.630109,139.747094,2024-02-08 16:00:04
30,E5-27.真正館駐車場,0,4,4,35.714875,139.76394,2024-02-08 16:00:04
31,C5-35.品川駅港南口,0,1,1,35.62822,139.741135,2024-02-08 16:00:04
32,N2-01.NTT野方ビル,4,1,5,35.710285,139.66173,2024-02-08 16:00:04
33,D6-27.新宿三井ビルディング二号館,7,2,9,35.686334,139.692881,2024-02-08 16:00:04
34,D1-10.曙橋駐輪場,4,10,14,35.691888,139.724365,2024-02-08 16:00:04
35,I1-39.MID POINT 目黒不動前,3,0,3,35.628116,139.713149,2024-02-08 16:00:04
36,E3-07.小日向1丁目,0,3,3,35.713388,139.737009,2024-02-08 16:00:04
37,C1-47.パークプレイス三田,9,0,9,35.641791,139.740734,2024-02-08 16:00:04
38,I1-38.ローソン 八潮三丁目店,10,34,44,35.594544,139.760423,2024-02-08 16:00:04
39,C2-24.Dash Living HigashiAzabu,5,0,5,35.655135,139.744449,2024-02-08 16:00:04
40,J1-04.菅刈公園,7,1,8,35.650351,139.692853,2024-02-08 16:00:04
41,O4-09.ローソン杉並本天沼一丁目店,1,2,3,35.712496,139.632778,2024-02-08 16:00:04
42,T3-29.平和台もものき緑地,1,2,3,35.755773,139.661913,2024-02-08 16:00:04
43,D2-10.市谷砂土原町3丁目,5,4,9,35.696242,139.735776,2024-02-08 16:00:04
44,C1-48.竹芝客船ターミナル,9,6,15,35.655139,139.762812,2024-02-08 16:00:04
45,B1-06.伊場仙ビル,4,1,5,35.687624,139.777125,2024-02-08 16:00:04
46,B2-01.鉄砲洲児童公園（西側）,0,0,0,35.67224,139.779348,2024-02-08 16:00:04
47,B1-04.産業会館,4,1,5,35.694164,139.787057,2024-02-08 16:00:04
48,B1-05.日本橋保健センター,0,9,9,35.687419,139.779053,2024-02-08 16:00:04
49,B2-05.ＮＴＴ東日本築地ビル,0,0,0,35.670674,139.775993,2024-02-08 16:00:04
50,B2-02.柳通り（東京スクエアガーデン前）,7,5,12,35.676393,139.768319,2024-02-08 16:00:04
51,B2-03.男女平等センター（ブーケ21）,9,0,9,35.673923,139.778671,2024-02-08 16:00:04
52,C2-13.麻布運動場,8,0,8,35.651718,139.728165,2024-02-08 16:00:04
53,D2-08.旧市ヶ谷商業高校,0,4,4,35.70074,139.731363,2024-02-08 16:00:04
54,C1-35.セブン-イレブン 三田駅北店,3,0,3,35.649032,139.750147,2024-02-08 16:00:04
55,B4-12.THE TOKYO TOWERS,0,55,55,35.655497,139.774556,2024-02-08 16:00:04
56,C5-21.セブン-イレブン 芝浦3丁目店,4,0,4,35.642399,139.746992,2024-02-08 16:00:04
57,H1-67.セブン-イレブン 江東亀戸9丁目店,5,9,14,35.69766,139.843408,2024-02-08 16:00:04
58,C2-15.住友不動産六本木グランドタワー,0,13,13,35.664367,139.737185,2024-02-08 16:00:04
59,C2-14.元麻布ヒルズ,2,8,10,35.653608,139.73138,2024-02-08 16:00:04
60,M6-14.ドコモショップ笹塚店,0,5,5,35.67323,139.66393,2024-02-08 16:00:04
61,N4-07.南台2丁目,4,2,6,35.68509,139.671102,2024-02-08 16:00:04
62,K1-68.ART FACTORY 城南島,0,9,9,35.580511,139.775957,2024-02-08 16:00:04
63,H1-178.北砂7丁目団地(第二),1,3,4,35.678031,139.837193,2024-02-08 16:00:04
64,H1-179.北砂7丁目団地(第三),1,10,11,35.678246,139.8366,2024-02-08 16:00:04
65,A1-17.雉子橋集積所,6,0,6,35.692605,139.755761,2024-02-08 16:00:04
66,H1-177.北砂7丁目団地(第一),0,10,10,35.678537,139.837391,2024-02-08 16:00:04
67,K1-95.城南島海浜公園,10,6,16,35.578259,139.783505,2024-02-08 16:00:04
68,B3-17.銀座6丁目-SQUARE,5,1,6,35.66711,139.76643,2024-02-08 16:00:04
69,J1-33.芳窪街かど公園,13,0,13,35.629861,139.666293,2024-02-08 16:00:04
70,N3-07.なかのZERO,4,1,5,35.70442,139.67141,2024-02-08 16:00:04
71,N4-04.弥生町5丁目,5,7,12,35.690897,139.668345,2024-02-08 16:00:04
72,A3-44.THE WAVES AKIHABARA,3,0,3,35.694679,139.779504,2024-02-08 16:00:04
73,K1-138.羽田エアポートガーデン,2,8,10,35.544534,139.763244,2024-02-08 16:00:04
74,C3-26.ホテルリブマックス赤坂,0,5,5,35.67011,139.733375,2024-02-08 16:00:04
75,C1-52.NTT三田ビル,6,0,6,35.652549,139.747789,2024-02-08 16:00:04
76,D1-07.Dash Living Shinjuku,3,0,3,35.689757,139.710091,2024-02-08 16:00:04
77,O4-07.ローソン成田西三丁目店,0,5,5,35.690311,139.62178,2024-02-08 16:00:04
78,H1-152.コンポジット亀戸ウエスト,0,6,6,35.699187,139.82429,2024-02-08 16:00:04
79,E1-13.エルアージュ小石川,0,21,21,35.71399,139.75137,2024-02-08 16:00:04
80,B4-22.リビオレゾン勝どきNEX,0,32,32,35.65554,139.77102,2024-02-08 16:00:04
81,H1-176.JMFビル東陽町02,1,3,4,35.667677,139.823552,2024-02-08 16:00:04
82,H1-102.ファミリーマート東砂七丁目店,2,4,6,35.672714,139.837914,2024-02-08 16:00:04
83,H1-101.ファミリーマート新木場一丁目店,0,9,9,35.642571,139.836766,2024-02-08 16:00:04
84,K1-67.京浜島防災広場,0,32,32,35.570508,139.764013,2024-02-08 16:00:04
85,K1-66.昭和島二丁目公園,0,13,13,35.575097,139.751446,2024-02-08 16:00:04
86,I1-80.リバーサイド品川港南ビル,8,0,8,35.622714,139.74471,2024-02-08 16:00:04
87,J1-10.NTTデータ駒場研修センター,7,2,9,35.655779,139.680948,2024-02-08 16:00:04
88,A2-17.竹橋ビル,5,3,8,35.692396,139.75639,2024-02-08 16:00:04
89,H1-91.亀戸駅北口第三自転車駐車場,12,4,16,35.696913,139.823911,2024-02-08 16:00:04
90,H1-92.亀戸駅東口第二自転車駐車場,5,10,15,35.69788,139.830559,2024-02-08 16:00:04
91,K1-59.京急梅屋敷第1駐車場,6,0,6,35.565768,139.727396,2024-02-08 16:00:04
92,K1-60.京急平和島第1駐車場,9,0,9,35.576336,139.733691,2024-02-08 16:00:04
93,I1-42.京急青横駐車場,0,0,0,35.611582,139.742528,2024-02-08 16:00:04
94,I1-43.京急南大井駐車場,7,1,8,35.594722,139.737101,2024-02-08 16:00:04
95,O7-05.ジーベック方南町,1,0,1,35.680849,139.65626,2024-02-08 16:00:04
96,H1-100.URアーバンライフ亀戸,22,5,27,35.697935,139.821855,2024-02-08 16:00:04
97,A6-10.紀尾井町ビル（西側）,9,3,12,35.682516,139.736494,2024-02-08 16:00:04
98,C3-02.赤坂地区総合支所,0,6,6,35.674788,139.731423,2024-02-08 16:00:04
99,C2-08.ファミリーマート西麻布霞町店,0,4,4,35.661673,139.721118,2024-02-08 16:00:04
100,A6-09.紀尾井町ビル（北側）,6,0,6,35.682902,139.736494,2024-02-08 16:00:04
101,H1-28.有明客船ターミナル,7,4,11,35.630063,139.792209,2024-02-08 16:00:04
102,B1-12.ファミリーマート堀留町二丁目店,0,9,9,35.687786,139.78205,2024-02-08 16:00:04
103,H1-26.青海客船ターミナル,5,9,14,35.619234,139.774485,2024-02-08 16:00:04
104,H1-27.パレットタウン乗船場,10,0,10,35.624467,139.781305,2024-02-08 16:00:04
105,O1-04.井草1-34,7,8,15,35.72758,139.62432,2024-02-08 16:00:04
106,C1-76.浜松町駅北口交通広場(ハマサイト前),11,4,15,35.656647,139.758301,2024-02-08 16:00:04
107,J1-52.駒沢一丁目公園前,8,1,9,35.629807,139.662398,2024-02-08 16:00:04
108,C1-75.虎ノ門PFビル,6,1,7,35.665466,139.748014,2024-02-08 16:00:04
109,B2-18.旭ビルディング,10,1,11,35.678291,139.78157,2024-02-08 16:00:04
110,N2-09.松山駐車場No.1,2,4,6,35.722991,139.673048,2024-02-08 16:00:04
111,I1-82.トミンハイム西五反田四丁目,2,3,5,35.627386,139.711182,2024-02-08 16:00:04
112,O4-03.ザ・ハウス,0,12,12,35.707035,139.633066,2024-02-08 16:00:04
113,O4-04.阿佐谷南3-43,15,1,16,35.704147,139.631955,2024-02-08 16:00:04
114,K1-83.北千束北児童公園,6,0,6,35.611085,139.68599,2024-02-08 16:00:04
115,I1-95.東京レールゲート EAST,0,10,10,35.584998,139.761055,2024-02-08 16:00:04
116,M5-19.グランリヴィエール代々木,4,0,4,35.68285,139.698528,2024-02-08 16:00:04
117,H1-192.ウエリスアーバン水天宮前,3,0,3,35.678296,139.791949,2024-02-08 16:00:04
118,N2-08.江古田区民活動センター,2,2,4,35.728893,139.670119,2024-02-08 16:00:04
119,D7-04.セブン-イレブン 新宿下落合3丁目店,3,0,3,35.722645,139.701982,2024-02-08 16:00:04
120,K1-82.西蒲田公園,7,0,7,35.561499,139.71123,2024-02-08 16:00:04
121,H1-68.芝浦工業大学附属中学高等学校,8,1,9,35.649274,139.792213,2024-02-08 16:00:04
122,K1-24.東糀谷防災公園,0,23,23,35.557074,139.74575,2024-02-08 16:00:04
123,H1-03.東雲駅,0,26,26,35.640736,139.804331,2024-02-08 16:00:04
124,K1-26.大森諏訪公園,0,5,5,35.574785,139.730762,2024-02-08 16:00:04
125,K1-25.鶴渡公園,3,0,3,35.56892,139.725082,2024-02-08 16:00:04
126,N3-10.エーエスホームズⅡ駐車場,5,1,6,35.702659,139.662563,2024-02-08 16:00:04
127,J1-37.中目黒公園,11,7,18,35.640398,139.704069,2024-02-08 16:00:04
128,A1-10.ヒューリック九段ビル,6,0,6,35.696449,139.750784,2024-02-08 16:00:04
129,K1-93.六間堀仲羽公園,0,4,4,35.548864,139.74484,2024-02-08 16:00:04
130,T2-53.上練馬公園,2,2,4,35.772863,139.626969,2024-02-08 16:00:04
131,M5-01.初台駅南口,0,10,10,35.680154,139.685937,2024-02-08 16:00:04
132,C1-60.専売ビル,12,0,12,35.647659,139.745055,2024-02-08 16:00:04
133,K1-85.大田区青少年交流センター ゆいっつ,0,6,6,35.583555,139.743381,2024-02-08 16:00:04
134,I1-64.株式会社ユアス ゆうパック取扱所：ポストのうしろ,6,4,10,35.622965,139.731014,2024-02-08 16:00:04
135,C4-09.ケーヨーデイツー三田店,3,1,4,35.646375,139.740061,2024-02-08 16:00:04
136,C1-61.環三浜松町駅南,24,14,38,35.653096,139.75739,2024-02-08 16:00:04
137,K1-84.佐伯山緑地,2,11,13,35.581698,139.71491,2024-02-08 16:00:04
138,C1-59.セレスティン芝三井ビルディング,7,3,10,35.650845,139.748346,2024-02-08 16:00:04
139,G2-07.レオーネ押上cube,3,1,4,35.706167,139.815955,2024-02-08 16:00:04
140,E1-06.文京シビックセンター,9,9,18,35.708265,139.751983,2024-02-08 16:00:04
141,D2-13.THE CENTER TOKYO,0,5,5,35.695646,139.725722,2024-02-08 16:00:04
142,E5-22.千駄木2丁目,0,3,3,35.724828,139.762583,2024-02-08 16:00:04
143,C4-07.品川プリンスホテル,10,0,10,35.628266,139.734171,2024-02-08 16:00:04
144,A3-43.unito CHIYODA,0,3,3,35.69474,139.77929,2024-02-08 16:00:04
145,C4-06.白金プラチナレジデンス,0,19,19,35.644134,139.723432,2024-02-08 16:00:04
146,I1-63.セブン-イレブン西五反田店,3,0,3,35.62765,139.719212,2024-02-08 16:00:04
147,H1-53.豊洲シビックセンター,0,16,16,35.653991,139.795513,2024-02-08 16:00:04
148,T3-16.練馬区役所東庁舎(第一),10,0,10,35.735428,139.652379,2024-02-08 16:00:04
149,T2-68.さくら原っぱ緑地,2,3,5,35.731372,139.619164,2024-02-08 16:00:04
150,T2-69.久保新田さくら公園,1,3,4,35.76525,139.575978,2024-02-08 16:00:04
151,H1-187.森下文化センター,4,1,5,35.685344,139.80234,2024-02-08 16:00:04
152,E4-04.セブン-イレブン 文京本駒込１丁目店,5,0,5,35.724707,139.750469,2024-02-08 16:00:04
153,M2-13.恵比寿プライムスクエアタワー南,8,0,8,35.649257,139.713272,2024-02-08 16:00:04
154,H1-48.セブン-イレブン 江東潮見２丁目店,0,9,9,35.658249,139.815775,2024-02-08 16:00:04
155,H1-51.豊洲交通広場　東,2,24,26,35.654958,139.795718,2024-02-08 16:00:04
156,H1-52.辰巳駅,0,60,60,35.646756,139.809295,2024-02-08 16:00:04
157,D7-01.下落合図書館,6,9,15,35.715894,139.698578,2024-02-08 16:00:04
158,H1-50.豊洲交通広場　北,0,29,29,35.655457,139.795161,2024-02-08 16:00:04
159,A6-14.MG市ヶ谷ビルディング,0,3,3,35.690861,139.736393,2024-02-08 16:00:04
160,T2-21.ファミリーマート 練馬大泉町一丁目店,2,2,4,35.768448,139.601679,2024-02-08 16:00:04
161,A6-15.東急番町ビル,3,0,3,35.688929,139.7358,2024-02-08 16:00:04
162,A1-18.東京区政会館別館(特別区研修所),1,4,5,35.696202,139.752351,2024-02-08 16:00:04
163,T3-18.練馬駅北,9,9,18,35.738585,139.653396,2024-02-08 16:00:04
164,C1-43.KDX浜松町プレイス,0,4,4,35.658169,139.752509,2024-02-08 16:00:04
165,C5-27.プレミア海岸ビル,10,8,18,35.648948,139.757895,2024-02-08 16:00:04
166,I1-29.ローソン 勝島一丁目店,0,8,8,35.599987,139.745195,2024-02-08 16:00:04
167,H1-72.ネクストサイト深川ビル,21,0,21,35.674578,139.797396,2024-02-08 16:00:04
168,T1-11.むつみ台,2,0,2,35.768528,139.639807,2024-02-08 16:00:04
169,T1-10.月見大橋下,1,3,4,35.758366,139.628982,2024-02-08 16:00:04
170,H1-167.大島八丁目公園,6,3,9,35.688074,139.838932,2024-02-08 16:00:04
171,K1-36.セブン-イレブン 大田区南雪谷5丁目店,3,2,5,35.587815,139.691748,2024-02-08 16:00:04
172,L1-01.羽根木公園,6,6,12,35.66088,139.654546,2024-02-08 16:00:04
173,P1-02.雑司ヶ谷一丁目,8,0,8,35.721738,139.723103,2024-02-08 16:00:04
174,I1-66.南大井文化センター駐車場,1,5,6,35.596733,139.73804,2024-02-08 16:00:04
175,L1-05.NTT烏山ビル,0,3,3,35.669285,139.597931,2024-02-08 16:00:04
176,L1-04.下馬中央公園,2,1,3,35.63367,139.678139,2024-02-08 16:00:04
177,L1-03.世田谷城阯公園,1,5,6,35.645838,139.647799,2024-02-08 16:00:04
178,L1-02.若林公園,5,2,7,35.647075,139.654472,2024-02-08 16:00:04
179,T2-30.ファミリーマート 練馬東大泉四丁目店,4,0,4,35.750804,139.58243,2024-02-08 16:00:04
180,L1-07.NTT成城ビル,2,1,3,35.648021,139.606529,2024-02-08 16:00:04
181,L1-06.NTT瀬田ビル,0,12,12,35.618357,139.626191,2024-02-08 16:00:04
182,T3-12.春日町西公園,3,1,4,35.748092,139.636587,2024-02-08 16:00:04
183,T3-13.平和台児童公園,2,2,4,35.757298,139.664139,2024-02-08 16:00:04
184,T2-38.ファミリーマート 練馬上石神井四丁目店,4,5,9,35.727195,139.590179,2024-02-08 16:00:04
185,B1-28.アイルイムーブル日本橋,9,0,9,35.684502,139.77906,2024-02-08 16:00:04
186,A2-28.NTTコミュニケーションズ一ツ橋ビル駐車場,8,0,8,35.6915,139.75685,2024-02-08 16:00:04
187,C3-32.乃木公園,3,1,4,35.667936,139.72745,2024-02-08 16:00:04
188,T3-14.わらべ児童遊園,3,1,4,35.759774,139.654529,2024-02-08 16:00:04
189,T2-52.田柄中央児童公園,3,1,4,35.762395,139.641522,2024-02-08 16:00:04
190,M4-06.THE SHARE 原宿,9,0,9,35.671823,139.708158,2024-02-08 16:00:04
191,K1-10.セブン‐イレブン 大田区西糀谷１丁目店,4,0,4,35.559647,139.730098,2024-02-08 16:00:04
192,K1-09.セブン‐イレブン 大田区西蒲田２丁目店,0,18,18,35.570763,139.705895,2024-02-08 16:00:04
193,H1-63.東京スイソミル,5,0,5,35.65637,139.811765,2024-02-08 16:00:04
194,B1-16.小網町児童遊園,3,1,4,35.683695,139.780043,2024-02-08 16:00:04
195,H1-61.Brilliaランニングスタジアムマギーズ東京前,0,12,12,35.648281,139.786112,2024-02-08 16:00:04
196,K1-08.セブン‐イレブン 大田区東蒲田キネマ通り店,5,0,5,35.562368,139.730143,2024-02-08 16:00:04
197,C1-34.城山ガーデン,6,2,8,35.664479,139.743731,2024-02-08 16:00:04
198,H1-62.扇橋一丁目公園南,0,12,12,35.683343,139.812161,2024-02-08 16:00:04
199,J1-23.清水池公園,12,10,22,35.623756,139.692517,2024-02-08 16:00:04
200,C5-18.パークタワー品川ベイワード,16,0,16,35.634529,139.748378,2024-02-08 16:00:04
201,E4-07.ファミリーマート 本駒込二丁目店,3,1,4,35.727279,139.74627,2024-02-08 16:00:04
202,C5-45.パークアクシス芝浦キャナル,7,0,7,35.644794,139.755688,2024-02-08 16:00:04
203,A2-02.西神田公園（北側）,7,1,8,35.698591,139.755113,2024-02-08 16:00:04
204,T2-49.善福寺公園テニスクラブ,5,4,9,35.719674,139.593696,2024-02-08 16:00:04
205,H1-193.ライフ豊洲店,25,2,27,35.651833,139.79962,2024-02-08 16:00:04
206,A2-01.神田駿河台下,51,1,52,35.695762,139.761585,2024-02-08 16:00:04
207,I1-51.京急鈴ヶ森駐車場,1,7,8,35.589573,139.735585,2024-02-08 16:00:04
208,T2-36.サントピア テニスパーク,5,5,10,35.75195,139.616028,2024-02-08 16:00:04
209,G4-13. Parking in 両国駅前第2,0,3,3,35.696492,139.791591,2024-02-08 16:00:04
210,K1-120.蒲田駅消費者生活センター横自転車駐車場 屋上部,6,0,6,35.560125,139.71569,2024-02-08 16:00:04
211,N3-18.藤和シティコープ新中野3,5,1,6,35.69942,139.673964,2024-02-08 16:00:04
212,K1-145.トヨタモビリティ東京馬込テクニカル研修センター,11,1,12,35.58209,139.701362,2024-02-08 16:00:04
213,K1-100.多摩川台公園,5,0,5,35.589794,139.666955,2024-02-08 16:00:04
214,C1-54.ニッセイ虎ノ門ビル,7,5,12,35.664344,139.746662,2024-02-08 16:00:04
215,I1-52.カスタリアタワー品川シーサイド,10,0,10,35.607557,139.746866,2024-02-08 16:00:04
216,I1-53.天王洲公園,0,6,6,35.620355,139.749339,2024-02-08 16:00:04
217,C2-18.ブランシェ東麻布,1,2,3,35.656769,139.743224,2024-02-08 16:00:04
218,A3-45.鍛冶町2丁目,12,2,14,35.691578,139.77138,2024-02-08 16:00:04
219,H1-87.パークアクシス木場キャナルウエスト,2,1,3,35.662514,139.803694,2024-02-08 16:00:04
220,D6-20.淀橋けやき橋公園,5,9,14,35.693544,139.685806,2024-02-08 16:00:04
221,A3-46.神田須田町2丁目,0,0,0,35.695457,139.772972,2024-02-08 16:00:04
222,B3-13.国立がん研究センター,10,1,11,35.664871,139.767188,2024-02-08 16:00:04
223,I1-35.シーフォートスクエア,7,10,17,35.622954,139.750593,2024-02-08 16:00:04
224,K1-55.カバヤビル,12,2,14,35.576275,139.713704,2024-02-08 16:00:04
225,C3-24.SHARE GREEN 南青山 西エントランス,0,7,7,35.668419,139.724676,2024-02-08 16:00:04
226,A5-06.APA HOTEL PRIDE〈国会議事堂前〉,10,0,10,35.674468,139.741328,2024-02-08 16:00:04
227,A6-17.東京ガーデンテラス紀尾井町（プリンス通り側）,12,0,12,35.680431,139.738203,2024-02-08 16:00:04
228,B4-07.勝どき駅地下駐輪場,53,5,58,35.658135,139.776131,2024-02-08 16:00:04
229,B4-08.東京ミッドベイ勝どき（西仲通り）,14,0,14,35.656449,139.771302,2024-02-08 16:00:04
230,B3-04.築地市場駅地下駐輪場,17,0,17,35.664265,139.767426,2024-02-08 16:00:04
231,C5-10.シーバンス,3,7,10,35.649959,139.756068,2024-02-08 16:00:04
232,H1-34.門前仲町駅,46,4,50,35.67391,139.796165,2024-02-08 16:00:04
233,C3-10.ファミリーマート特許庁前店,0,11,11,35.670364,139.744684,2024-02-08 16:00:04
234,A1-01.千代田区役所,5,1,6,35.693799,139.753281,2024-02-08 16:00:04
235,A1-03.東京区政会館（メトロA5出口）,6,1,7,35.701073,139.747525,2024-02-08 16:00:04
236,B3-06.朝日新聞東京本社,0,9,9,35.664457,139.767214,2024-02-08 16:00:04
237,A1-04.東京区政会館（西側駐輪場）,5,2,7,35.701347,139.746951,2024-02-08 16:00:04
238,T1-03.四季の香公園,5,0,5,35.760585,139.626284,2024-02-08 16:00:04
239,T1-04.春の風公園,3,0,3,35.75731,139.624922,2024-02-08 16:00:04
240,T1-05.夏の雲公園,5,0,5,35.753964,139.629116,2024-02-08 16:00:04
241,H1-194.セブン-イレブン江東北砂5丁目店,0,4,4,35.68268,139.8353,2024-02-08 16:00:04
242,O5-03.新高円寺地下自転車駐輪場,6,7,13,35.697265,139.649397,2024-02-08 16:00:04
243,O3-06.アミーズ荻窪,3,1,4,35.714616,139.625116,2024-02-08 16:00:04
244,T2-03.リヴィンオズ大泉店,7,1,8,35.752383,139.594855,2024-02-08 16:00:04
245,O6-06.上高井戸1丁目,0,7,7,35.673055,139.611293,2024-02-08 16:00:04
246,T2-05.石神井図書館,4,0,4,35.736076,139.599676,2024-02-08 16:00:04
247,T2-06.総合体育館,2,1,3,35.748957,139.621385,2024-02-08 16:00:04
248,O5-02.馬橋ハイツ,5,1,6,35.705686,139.642587,2024-02-08 16:00:04
249,N1-07.プランドール上鷺宮,2,4,6,35.733292,139.630369,2024-02-08 16:00:04
250,E1-18.アーバネックス小石川春日,5,0,5,35.709261,139.746374,2024-02-08 16:00:04
251,T3-03.新桜台駅自転車駐車場,5,2,7,35.740378,139.667502,2024-02-08 16:00:04
252,O3-05.Nちゃりパーク,15,8,23,35.70389,139.6185,2024-02-08 16:00:04
253,O5-01.朝霞ハイツ,10,1,11,35.71038,139.64519,2024-02-08 16:00:04
254,L1-11.アイムタウン上祖師谷,2,1,3,35.656849,139.594422,2024-02-08 16:00:04
255,L1-12.鈴木リースホーム駐車場,11,3,14,35.646648,139.633038,2024-02-08 16:00:04
256,L1-13.わびさびホステル,3,1,4,35.647393,139.667085,2024-02-08 16:00:04
257,G2-05.リアナスカイパーク押上,5,0,5,35.715733,139.815451,2024-02-08 16:00:04
258,T3-02.早宮第二自転車駐車場,7,4,11,35.756846,139.652154,2024-02-08 16:00:04
259,I1-37.ガーデンシティ品川御殿山,4,5,9,35.623466,139.734359,2024-02-08 16:00:04
260,T2-47.上石神井駅北第二自転車駐車場,5,4,9,35.726523,139.5905,2024-02-08 16:00:04
261,C1-51.環二新橋四丁目,10,0,10,35.663843,139.757697,2024-02-08 16:00:04
262,M6-07.笹塚東,14,6,20,35.675436,139.670594,2024-02-08 16:00:04
263,M3-10.ウノサワ東急ビル,8,0,8,35.647757,139.712981,2024-02-08 16:00:04
264,C2-26.一の橋公園,4,2,6,35.655367,139.738075,2024-02-08 16:00:04
265,H1-14.ホテルリブマックス東京潮見駅前,4,2,6,35.658351,139.818229,2024-02-08 16:00:04
266,D2-12.ヴィアイン飯田橋後楽園,0,9,9,35.705774,139.743366,2024-02-08 16:00:04
267,D3-08.ホテルリブマックス高田馬場駅前,6,2,8,35.712952,139.701356,2024-02-08 16:00:04
268,H1-103.清澄庭園,8,2,10,35.680948,139.796917,2024-02-08 16:00:04
269,H1-104.木場公園,11,0,11,35.676488,139.809616,2024-02-08 16:00:04
270,H1-105.猿江恩賜公園,7,0,7,35.692277,139.817491,2024-02-08 16:00:04
271,G4-07.ディアレイシャス両国,3,1,4,35.69955,139.803204,2024-02-08 16:00:04
272,T2-46.大泉郵便局バス停自転車駐車場,0,9,9,35.766491,139.587232,2024-02-08 16:00:04
273,I1-18.東品川公園,6,0,6,35.61379,139.746617,2024-02-08 16:00:04
274,J1-03.西郷山公園,5,1,6,35.650688,139.696696,2024-02-08 16:00:04
275,J1-02.駒場野公園,10,4,14,35.657718,139.681043,2024-02-08 16:00:04
276,D2-14.ローソン 神楽坂駅北店,0,5,5,35.704201,139.735815,2024-02-08 16:00:04
277,K1-65.下丸子3丁目,6,6,12,35.571711,139.685337,2024-02-08 16:00:04
278,T2-43.学園通り自転車駐車場,8,0,8,35.7547,139.5871,2024-02-08 16:00:04
279,I1-46.セブン-イレブン 品川東中延2丁目店,0,2,2,35.608721,139.714158,2024-02-08 16:00:04
280,T2-04.石神井公園駅南口,4,8,12,35.743354,139.606592,2024-02-08 16:00:04
281,J1-06.観音橋自転車置場,17,28,45,35.642251,139.69692,2024-02-08 16:00:04
282,J1-05.東山公園　北,0,10,10,35.64853,139.686309,2024-02-08 16:00:04
283,J1-45.プラウド中目黒,0,0,0,35.63767,139.7045,2024-02-08 16:00:04
284,H1-168.大島五丁目公園,11,0,11,35.68642,139.836151,2024-02-08 16:00:04
285,J1-47.本町みなみ街かど公園,8,8,16,35.61847,139.70019,2024-02-08 16:00:04
286,J1-48.グランドエクセル祐天寺,0,15,15,35.64372,139.68777,2024-02-08 16:00:04
287,K1-101.小池公園,2,3,5,35.599541,139.697962,2024-02-08 16:00:04
288,H1-171.LOGI’Q南砂町,9,0,9,35.672877,139.842339,2024-02-08 16:00:04
289,H1-153.三井リンクラボ新木場1,0,12,12,35.63851,139.823534,2024-02-08 16:00:04
290,H1-154.やぐら橋下,13,7,20,35.631132,139.792726,2024-02-08 16:00:04
291,D5-11.NTTコミュニケーションズ新宿ビル,1,8,9,35.699312,139.696468,2024-02-08 16:00:04
292,C5-31.ヒルトン東京お台場,2,8,10,35.626267,139.771438,2024-02-08 16:00:04
293,K1-78.城南鋳物団地協同組合,0,14,14,35.567562,139.766854,2024-02-08 16:00:04
294,I1-68.八潮公園第二,0,0,0,35.600003,139.754288,2024-02-08 16:00:04
295,I1-67.八潮公園第一,0,9,9,35.601149,139.754284,2024-02-08 16:00:04
296,H1-123.ダイワロイネットホテル東京有明,12,8,20,35.634316,139.793199,2024-02-08 16:00:04
297,J1-24.ボヌールREIWA,4,1,5,35.612389,139.676238,2024-02-08 16:00:04
298,B2-12.東京ダイヤビルディング（東側）,10,6,16,35.674835,139.785656,2024-02-08 16:00:04
299,J1-15.二の橋自転車置場2,14,2,16,35.614391,139.678396,2024-02-08 16:00:04
300,H1-77.ライフ東砂店,0,8,8,35.684641,139.844243,2024-02-08 16:00:04
301,D1-09.NTT四谷ビル,2,1,3,35.691188,139.712079,2024-02-08 16:00:04
302,E4-11.プライマル千石,0,13,13,35.727519,139.742815,2024-02-08 16:00:04
303,I1-23.東海橋防災船着場,9,0,9,35.616114,139.74033,2024-02-08 16:00:04
304,A4-12.東京ミッドタウン日比谷,0,5,5,35.674274,139.759111,2024-02-08 16:00:04
305,K1-46.池上駅前自転車駐車場,7,5,12,35.571478,139.702779,2024-02-08 16:00:04
306,I1-24.しながわ区民公園(中央口),2,10,12,35.593611,139.738056,2024-02-08 16:00:04
307,T2-13.セブン-イレブン 練馬石神井町8丁目店,1,3,4,35.750414,139.600011,2024-02-08 16:00:04
308,O3-04.アヴァンセ阿佐ヶ谷,1,1,2,35.712,139.62816,2024-02-08 16:00:04
309,B4-01.黎明橋公園（駐輪場）,7,1,8,35.656071,139.780068,2024-02-08 16:00:04
310,T2-32.セブン-イレブン 練馬東大泉NTTビル店,5,3,8,35.750761,139.594457,2024-02-08 16:00:04
311,K1-142.コーラル洗足池,8,1,9,35.604567,139.689096,2024-02-08 16:00:04
312,K1-28.鵜の木特別出張所,4,0,4,35.574886,139.685122,2024-02-08 16:00:04
313,T1-02.ホテルカデンツァ東京,11,1,12,35.755106,139.621675,2024-02-08 16:00:04
314,C2-16.ザ・ベルグレイヴィア麻布,0,4,4,35.657264,139.743821,2024-02-08 16:00:04
315,N3-11.上高田区民活動センター,3,2,5,35.711501,139.672761,2024-02-08 16:00:04
316,T3-30.北西大松公園,2,2,4,35.765979,139.64931,2024-02-08 16:00:04
317,D6-05.新宿中央公園（水の広場）,5,1,6,35.690474,139.690219,2024-02-08 16:00:04
318,D6-07.新宿フロントタワー,2,5,7,35.696387,139.689924,2024-02-08 16:00:04
319,T2-73.早実グラウンド記念公園,2,2,4,35.734615,139.576214,2024-02-08 16:00:04
320,O7-03.永福町西幸モータープール東,2,9,11,35.67156,139.64609,2024-02-08 16:00:04
321,D1-03.新左門児童遊園,1,0,1,35.684523,139.720519,2024-02-08 16:00:04
322,D1-04.四谷見附公園,0,22,22,35.683448,139.728425,2024-02-08 16:00:04
323,I1-54.天王洲オーシャンスクエア,7,8,15,35.622356,139.749468,2024-02-08 16:00:04
324,D6-01.新宿区役所本庁舎,44,1,45,35.693602,139.703229,2024-02-08 16:00:04
325,D6-02.新宿区役所第二分庁舎,33,2,35,35.693976,139.706134,2024-02-08 16:00:04
326,D6-03.新宿中央公園（ポケットパーク）,7,2,9,35.691559,139.690029,2024-02-08 16:00:04
327,D6-04.新宿中央公園（ちびっこ広場）,6,4,10,35.686649,139.689821,2024-02-08 16:00:04
328,A6-21.日本工営ビル,4,0,4,35.684584,139.734442,2024-02-08 16:00:04
329,I1-77.セブン-イレブン品川西中延1丁目店,0,1,1,35.612217,139.708164,2024-02-08 16:00:04
330,T1-01.光が丘駅前広場,10,3,13,35.759164,139.629466,2024-02-08 16:00:04
331,T2-37.上石神井2丁目,6,2,8,35.729615,139.59532,2024-02-08 16:00:04
332,I1-75.セブン-イレブン品川二葉4丁目店,1,2,3,35.603275,139.713428,2024-02-08 16:00:04
333,M5-13.セブン-イレブン初台店,0,4,4,35.675049,139.68444,2024-02-08 16:00:04
334,D6-24.ＮＴＴ東日本 本社ビル,7,2,9,35.683102,139.688852,2024-02-08 16:00:04
335,H1-134.豊洲ぐるり公園,7,15,22,35.643141,139.777821,2024-02-08 16:00:04
336,H1-133.北砂2丁目公園,0,15,15,35.679001,139.825809,2024-02-08 16:00:04
337,E3-08.サガラマンション,2,2,4,35.722833,139.734662,2024-02-08 16:00:04
338,O4-05.阿佐ヶ谷南1-30,1,2,3,35.700703,139.639985,2024-02-08 16:00:04
339,O5-06.EXAM高円寺南,5,0,5,35.70273,139.65864,2024-02-08 16:00:04
340,G2-03.押上１丁目２６-４,3,2,5,35.710323,139.815215,2024-02-08 16:00:04
341,K1-132.多摩川駅前自転車等駐車場,12,2,14,35.587232,139.669519,2024-02-08 16:00:04
342,C5-47.oak港南品川,22,0,22,35.62413,139.744831,2024-02-08 16:00:04
343,D3-15.カースルいずみ,9,4,13,35.711324,139.711976,2024-02-08 16:00:04
344,C5-15.セブン-イレブン 港区芝浦ふ頭店,0,1,1,35.640215,139.755971,2024-02-08 16:00:04
345,C5-14.セブン-イレブン 港区汐彩橋店,0,0,0,35.640481,139.753659,2024-02-08 16:00:04
346,D5-01.新宿コズミックセンター,0,11,11,35.705244,139.70841,2024-02-08 16:00:04
347,H1-45.夢の島競技場,17,3,20,35.648596,139.824936,2024-02-08 16:00:04
348,E1-01.後楽橋横,21,4,25,35.702746,139.752009,2024-02-08 16:00:04
349,B1-15.ロイヤルパークホテル,0,8,8,35.682332,139.78722,2024-02-08 16:00:04
350,C4-05.白金台駅自転車駐車場,10,1,11,35.638927,139.727083,2024-02-08 16:00:04
351,E1-02.東京ドーム（ミーツポート）,5,4,9,35.70311,139.754951,2024-02-08 16:00:04
352,M2-06.あいおいニッセイ同和損保恵比寿ビル,5,2,7,35.647237,139.71512,2024-02-08 16:00:04
353,J1-12.工大橋下流自転車置場,3,1,4,35.605828,139.680265,2024-02-08 16:00:04
354,C5-25.NEX-TEC芝浦,35,2,37,35.639571,139.755551,2024-02-08 16:00:04
355,H1-175.ダイアパレス大島駅前,0,1,1,35.689543,139.836394,2024-02-08 16:00:04
356,C1-65.東京ポートシティ竹芝,9,4,13,35.654757,139.761516,2024-02-08 16:00:04
357,O2-03.西荻北5-8-17,2,3,5,35.709712,139.601846,2024-02-08 16:00:04
358,B2-21.八重洲二丁目北地区広場,0,12,12,35.67942,139.77004,2024-02-08 16:00:04
359,I1-101.下神明駅前,25,0,25,35.60838,139.726587,2024-02-08 16:00:04
360,N2-04.野方2丁目,6,0,6,35.713018,139.656768,2024-02-08 16:00:04
361,N2-05.野方3丁目,4,7,11,35.717877,139.654732,2024-02-08 16:00:04
362,K1-88.大田久が原西郵便局,2,2,4,35.582756,139.6925,2024-02-08 16:00:04
363,C5-51.トミンタワー台場一番街,6,0,6,35.634627,139.77663,2024-02-08 16:00:04
364,C4-10.亀塚公園,10,0,10,35.642764,139.741174,2024-02-08 16:00:04
365,H1-190.福山通運 東京支店,2,16,18,35.664845,139.796643,2024-02-08 16:00:04
366,C1-80.浜松町262ビル,10,2,12,35.654289,139.75557,2024-02-08 16:00:04
367,B2-19.リエトコートアルクスタワー,7,0,7,35.670506,139.77854,2024-02-08 16:00:04
368,C1-79.髙松コンストラクショングループ 東京本社ビル,1,3,4,35.648765,139.753363,2024-02-08 16:00:04
369,C5-43.オアーゼ芝浦MJビル,9,0,9,35.644798,139.752697,2024-02-08 16:00:04
370,J1-44.五本木2丁目,0,8,8,35.634441,139.687186,2024-02-08 16:00:04
371,B2-17.アーバネックス八丁堀,2,1,3,35.67518,139.77364,2024-02-08 16:00:04
372,M6-16.パールマンション,2,0,2,35.67464,139.67876,2024-02-08 16:00:04
373,G4-06.ドムス・スタイル両国,2,3,5,35.700453,139.798978,2024-02-08 16:00:04
374,G2-04.ラ　ステュディオ押上,4,0,4,35.712157,139.815298,2024-02-08 16:00:04
375,T3-15.セブン-イレブン練馬北町8丁目店,6,0,6,35.768105,139.646049,2024-02-08 16:00:04
376,C1-77.芝公園,12,5,17,35.65513,139.749645,2024-02-08 16:00:04
377,I1-27.小関橋公園,0,4,4,35.620699,139.730904,2024-02-08 16:00:04
378,B3-01.中央区役所,2,3,5,35.670855,139.772052,2024-02-08 16:00:04
379,A6-08.二番町ガーデン,3,1,4,35.685489,139.734562,2024-02-08 16:00:04
380,B1-01.十思公園,0,9,9,35.691058,139.777915,2024-02-08 16:00:04
381,B4-02.月島特別出張所,0,27,27,35.662197,139.782719,2024-02-08 16:00:04
382,A4-05.大手町タワー,6,11,17,35.685938,139.764886,2024-02-08 16:00:04
383,H1-22.豊洲市場（7街区）,16,54,70,35.6447,139.784512,2024-02-08 16:00:04
384,A6-07.二番町センタービル,0,2,2,35.685966,139.736328,2024-02-08 16:00:04
385,A2-12.神保町三井ビルディング,9,1,10,35.694532,139.760695,2024-02-08 16:00:04
386,E2-06.oto no ha Cafe,0,4,4,35.713991,139.725665,2024-02-08 16:00:04
387,B4-10.リバーシティ,2,2,4,35.668795,139.784784,2024-02-08 16:00:04
388,B1-03.常盤公園（北側）,8,1,9,35.688405,139.770068,2024-02-08 16:00:04
389,C5-19.グランドメゾン田町,7,0,7,35.645537,139.754899,2024-02-08 16:00:04
390,K1-11.ファミリーマート かわだ多摩川２丁目店,0,3,3,35.558289,139.697403,2024-02-08 16:00:04
391,J1-43.アルコタワー・ホテル雅叙園東京,9,2,11,35.63237,139.712681,2024-02-08 16:00:04
392,N1-03.鷺宮南駐輪場,6,3,9,35.721827,139.635949,2024-02-08 16:00:04
393,N2-06.江古田1丁目B,4,2,6,35.72515,139.672614,2024-02-08 16:00:04
394,D7-12.プラウド高田馬場,3,2,5,35.715538,139.701683,2024-02-08 16:00:04
395,K1-118.久が原3丁目,1,8,9,35.580741,139.687152,2024-02-08 16:00:04
396,K1-125.池上駅南口第1,1,1,2,35.571866,139.703214,2024-02-08 16:00:04
397,K1-117.安詳寺,6,13,19,35.581798,139.695222,2024-02-08 16:00:04
398,I1-91.アクロス目黒タワー,8,0,8,35.634019,139.719749,2024-02-08 16:00:04
399,K1-126.池上駅南口第2,2,1,3,35.571815,139.702387,2024-02-08 16:00:04
400,C5-50.お台場レインボー公園,12,0,12,35.633133,139.777315,2024-02-08 16:00:04
401,T3-26.富士見ランド公園,1,7,8,35.73701,139.627244,2024-02-08 16:00:04
402,T1-15.つのの山緑地,4,0,4,35.765144,139.636606,2024-02-08 16:00:04
403,T1-16.ゆりの木通り南公園,3,1,4,35.767582,139.636304,2024-02-08 16:00:04
404,H1-185.UR大島六丁目団地(第二),2,2,4,35.690038,139.833252,2024-02-08 16:00:04
405,H1-186.セブン-イレブン亀戸昭和橋通り店,0,9,9,35.694804,139.831357,2024-02-08 16:00:04
406,K1-96.西馬込駅前自転車駐車場,0,14,14,35.586408,139.705425,2024-02-08 16:00:04
407,H1-184.UR大島六丁目団地(第一),2,3,5,35.689913,139.833279,2024-02-08 16:00:04
408,A6-25.麹町仮住宅,3,1,4,35.679192,139.74019,2024-02-08 16:00:04
409,C1-69.塩釜公園,0,2,2,35.662908,139.755014,2024-02-08 16:00:04
410,C1-68.桜田公園,27,0,27,35.665214,139.757008,2024-02-08 16:00:04
411,A2-14.興和一橋ビル,13,2,15,35.6927,139.759311,2024-02-08 16:00:04
412,C5-41.トヨタモビリティ東京 芝浦店,5,0,5,35.639644,139.745532,2024-02-08 16:00:04
413,T2-22.ファミリーマート 石神井台7丁目店,5,0,5,35.731909,139.579685,2024-02-08 16:00:04
414,A6-20.紀尾井町PREX,5,1,6,35.68369,139.736936,2024-02-08 16:00:04
415,C5-24.GLOBAL FRONT TOWER,6,1,7,35.647713,139.755534,2024-02-08 16:00:04
416,E5-09.文京区 男女平等センター,4,9,13,35.70861,139.75768,2024-02-08 16:00:04
417,K1-37.東京サーハウス前,20,1,21,35.563874,139.685011,2024-02-08 16:00:04
418,B4-15.リバーシティ　イーストタワーズ,0,8,8,35.669188,139.785301,2024-02-08 16:00:04
419,M6-08.Be Good 幡ヶ谷,6,0,6,35.682453,139.677687,2024-02-08 16:00:04
420,D5-09.ハウジングステージ新宿,11,0,11,35.702277,139.701214,2024-02-08 16:00:04
421,D6-21.新宿5丁目,2,2,4,35.691613,139.711233,2024-02-08 16:00:04
422,K1-39.東京モノレール 流通センター駅前,6,23,29,35.581752,139.748705,2024-02-08 16:00:04
423,K1-38.ネクストサイト蒲田ビル,9,0,9,35.558916,139.717253,2024-02-08 16:00:04
424,T3-17.練馬区役所東庁舎(第二),4,1,5,35.735585,139.652544,2024-02-08 16:00:04
425,H1-107.大島小松川公園,1,24,25,35.692641,139.846346,2024-02-08 16:00:04
426,B1-11.浜町川緑道,12,35,47,35.684158,139.787649,2024-02-08 16:00:04
427,A6-19.番町麹町ビルディング,10,2,12,35.685578,139.732078,2024-02-08 16:00:04
428,B3-12.築地場外市場,15,3,18,35.665254,139.769301,2024-02-08 16:00:04
429,I1-40.御殿山トラストタワー,25,1,26,35.622371,139.737457,2024-02-08 16:00:04
430,M5-08.古賀政男音楽博物館,2,0,2,35.668091,139.680243,2024-02-08 16:00:04
431,H1-90.富士倉庫運輸(株) FACE-1前,0,2,2,35.655102,139.805205,2024-02-08 16:00:04
432,A3-38.パークホームズ千代田淡路町,4,0,4,35.695163,139.769566,2024-02-08 16:00:04
433,D2-11.神楽坂アインスタワー,2,3,5,35.702833,139.739,2024-02-08 16:00:04
434,C2-04.飯倉いきいきプラザ,2,1,3,35.656991,139.740739,2024-02-08 16:00:04
435,B1-09.スマイルホテル日本橋三越前,12,6,18,35.686101,139.776089,2024-02-08 16:00:04
436,E5-15.文京千駄木の郷,7,4,11,35.726499,139.759884,2024-02-08 16:00:04
437,C2-05.ありすいきいきプラザ,12,0,12,35.651046,139.727745,2024-02-08 16:00:04
438,C5-06.品川シーズンテラス,17,2,19,35.632303,139.742393,2024-02-08 16:00:04
439,B1-10.箱崎川第二公園,7,0,7,35.680833,139.784267,2024-02-08 16:00:04
440,L1-15.ソフィア,0,3,3,35.663222,139.587803,2024-02-08 16:00:04
441,A3-12.秋葉原UDX北側駐輪場前,0,15,15,35.70111,139.772855,2024-02-08 16:00:04
442,A2-08.KDX御茶ノ水ビル,5,4,9,35.700568,139.76013,2024-02-08 16:00:04
443,A3-07.淡路公園,3,1,4,35.696942,139.767302,2024-02-08 16:00:04
444,A1-08.飯田橋サクラテラス（早稲田通り）,0,12,12,35.699132,139.74462,2024-02-08 16:00:04
445,A3-13.富士ソフトビル（駐車場入口横）,5,14,19,35.700486,139.774254,2024-02-08 16:00:04
446,A2-09.テラススクエア,6,2,8,35.6931,139.7599,2024-02-08 16:00:04
447,A6-11.東京ガーデンテラス紀尾井町,14,10,24,35.67962,139.7364,2024-02-08 16:00:04
448,K1-124.矢口2丁目,4,0,4,35.564161,139.695187,2024-02-08 16:00:04
449,N3-15.ライオンズマンション中野東,2,1,3,35.71046,139.6855,2024-02-08 16:00:04
450,M3-11.渋谷道玄坂東急ビル,8,1,9,35.65718,139.698687,2024-02-08 16:00:04
451,H1-180.シティコート大島,8,0,8,35.691954,139.836462,2024-02-08 16:00:04
452,B1-27.日本橋本町4丁目,25,3,28,35.68973,139.77598,2024-02-08 16:00:04
453,M3-22.森谷ビル,15,0,15,35.64514,139.71686,2024-02-08 16:00:04
454,N3-17.東中野3丁目,10,0,10,35.70862,139.680679,2024-02-08 16:00:04
455,N2-10.関根ビル,1,4,5,35.733432,139.671241,2024-02-08 16:00:04
456,T1-06.秋の陽公園,3,1,4,35.762326,139.635226,2024-02-08 16:00:04
457,N1-02.鷺宮東駐輪場,0,13,13,35.721556,139.640397,2024-02-08 16:00:04
458,K1-140.西馬込駅前自転車駐車場(奥),4,10,14,35.586382,139.705116,2024-02-08 16:00:04
459,H1-182.錦糸町プライムタワー,14,0,14,35.695695,139.820507,2024-02-08 16:00:04
460,E5-05.駒込地域活動センター,1,2,3,35.728644,139.752183,2024-02-08 16:00:04
461,M3-06.渋谷第一生命ビル,6,0,6,35.657556,139.704129,2024-02-08 16:00:04
462,T2-42.石神井公園駅北第二自転車駐車場,2,3,5,35.74553,139.608939,2024-02-08 16:00:04
463,K1-144.蒲田五丁目44番自転車駐車場,10,0,10,35.559809,139.716993,2024-02-08 16:00:04
464,M3-07.渋谷ファーストプレイス,8,2,10,35.65506,139.69384,2024-02-08 16:00:04
465,H1-74.タダノ教習センター,5,5,10,35.63848,139.832305,2024-02-08 16:00:04
466,H1-151.コスモリード錦糸町,3,4,7,35.701347,139.819973,2024-02-08 16:00:04
467,T2-23.セブン-イレブン 練馬南大泉5丁目店,6,0,6,35.750185,139.579216,2024-02-08 16:00:04
468,M4-13.J-cube,3,0,3,35.66616,139.70458,2024-02-08 16:00:04
469,T2-65.さくらの辻公園,3,2,5,35.734805,139.599906,2024-02-08 16:00:04
470,T2-24.セブン-イレブン 練馬インター店,0,24,24,35.754586,139.606409,2024-02-08 16:00:04
471,O5-05.モンテ・ベルテ,0,2,2,35.701454,139.650518,2024-02-08 16:00:04
472,J1-42.都立大学駅北口バス停前,4,5,9,35.618622,139.67596,2024-02-08 16:00:04
473,K1-97.トミンタワー多摩川二丁目,13,0,13,35.555561,139.704345,2024-02-08 16:00:04
474,D1-14.コモレ四谷,0,1,1,35.68752,139.72818,2024-02-08 16:00:04
475,K1-106.ファミリーマート上池台夫婦坂店,5,2,7,35.599329,139.703343,2024-02-08 16:00:04
476,J1-39.松見坂公園,0,9,9,35.655483,139.687325,2024-02-08 16:00:04
477,J1-40.西小山公園,7,0,7,35.616541,139.697369,2024-02-08 16:00:04
478,J1-38.林試の森公園 北,9,2,11,35.626355,139.700153,2024-02-08 16:00:04
479,I1-84.セブン-イレブン西品川2丁目店,0,0,0,35.613819,139.728418,2024-02-08 16:00:04
480,D6-26.セブン-イレブン新宿６丁目文化センター通り店,8,0,8,35.694951,139.708219,2024-02-08 16:00:04
481,T2-25.ファミリーマート 高野台二丁目店,0,5,5,35.746045,139.620087,2024-02-08 16:00:04
482,I1-85.GOODOFFICE品川,2,0,2,35.621081,139.741178,2024-02-08 16:00:04
483,K1-74.大田スタジアム,3,4,7,35.587423,139.753871,2024-02-08 16:00:04
484,C1-64.東京虎ノ門グローバルスクエア,3,2,5,35.669941,139.749261,2024-02-08 16:00:04
485,K1-72.ファミリーマート大森西四丁目店,1,0,1,35.573358,139.723105,2024-02-08 16:00:04
486,H1-118.ファミリーマート亀戸駅前店,4,7,11,35.69839,139.825484,2024-02-08 16:00:04
487,I1-62.天王洲Rim,3,0,3,35.622277,139.745638,2024-02-08 16:00:04
488,H1-40.深川東京モダン館,2,0,2,35.674076,139.795008,2024-02-08 16:00:04
489,H1-117.東京パークサイドビル,9,0,9,35.671225,139.808561,2024-02-08 16:00:04
490,J1-01.目黒区総合庁舎,9,0,9,35.640675,139.698088,2024-02-08 16:00:04
491,C5-16.品川インターシティ,18,4,22,35.626704,139.742174,2024-02-08 16:00:04
492,A1-12.北の丸スクエア,7,0,7,35.695515,139.750213,2024-02-08 16:00:04
493,H1-46.セブン-イレブン 江東枝川2丁目店,0,0,0,35.659287,139.807358,2024-02-08 16:00:04
494,A2-25.プラウド神田駿河台,11,2,13,35.698991,139.76091,2024-02-08 16:00:04
495,C5-49.プラウドタワー芝浦,0,0,0,35.638912,139.747422,2024-02-08 16:00:04
496,T3-25.北町みのり公園,1,3,4,35.767627,139.65243,2024-02-08 16:00:04
497,H1-75.ジオ深川住吉,6,1,7,35.684247,139.815638,2024-02-08 16:00:04
498,T1-09.ローソン練馬旭町一丁目店,4,1,5,35.765704,139.625178,2024-02-08 16:00:04
499,T2-26.ファミリーマート 大泉学園町四丁目店,0,6,6,35.767388,139.587625,2024-02-08 16:00:04
500,T2-27.ファミリーマート 大泉長久保通り店,3,1,4,35.773841,139.591456,2024-02-08 16:00:04
501,C3-19.明治記念館西,3,1,4,35.678179,139.720809,2024-02-08 16:00:04
502,I1-11.鮫洲入江広場,12,0,12,35.603984,139.744504,2024-02-08 16:00:04
503,I1-10.品川シーサイド公園第1,8,9,17,35.607717,139.749478,2024-02-08 16:00:04
504,I1-09.東品川海上公園第1,0,1,1,35.616633,139.748945,2024-02-08 16:00:04
505,D3-06.セブン-イレブン高田馬場3丁目中央店,0,8,8,35.713872,139.698301,2024-02-08 16:00:04
506,K1-40.大田文化の森,0,11,11,35.579649,139.720263,2024-02-08 16:00:04
507,C1-41.港区立エコプラザ,6,0,6,35.658709,139.757036,2024-02-08 16:00:04
508,I1-13.八潮北公園,0,13,13,35.613421,139.75375,2024-02-08 16:00:04
509,I1-12.しながわ区民公園（北側）,3,0,3,35.596091,139.740884,2024-02-08 16:00:04
510,T2-09.こぐれの森緑地,4,6,10,35.763741,139.588847,2024-02-08 16:00:04
511,T3-31.パークサイド関口,3,5,8,35.74097,139.63836,2024-02-08 16:00:04
512,H1-183.MFLP新木場1,0,7,7,35.643958,139.838358,2024-02-08 16:00:04
513,T2-33.ウインドヒルズ189,2,4,6,35.74642,139.581204,2024-02-08 16:00:04
514,T2-67.陽和病院,0,8,8,35.761211,139.603316,2024-02-08 16:00:04
515,H1-82.セブンｰイレブン 北砂3丁目明治通り店,0,14,14,35.683514,139.827081,2024-02-08 16:00:04
516,T2-60.武蔵関公園（第一）,9,0,9,35.724747,139.565817,2024-02-08 16:00:04
517,I1-48.NTT 東日本 関東病院(北側),5,3,8,35.632191,139.725002,2024-02-08 16:00:04
518,T2-58.立野公園,3,2,5,35.716776,139.577975,2024-02-08 16:00:04
519,I1-100.東急荏原中延駅駐輪場,5,1,6,35.610444,139.712333,2024-02-08 16:00:04
520,T2-56.大泉公園（第一）,2,2,4,35.77228,139.58325,2024-02-08 16:00:04
521,T2-55.大泉町もみじやま公園,2,1,3,35.767296,139.602321,2024-02-08 16:00:04
522,T2-54.土支田農業公園,2,7,9,35.760939,139.609264,2024-02-08 16:00:04
523,I1-44.大井三ツ又商店街入口,6,1,7,35.604606,139.734483,2024-02-08 16:00:04
524,T2-62.大泉井頭公園,6,4,10,35.746681,139.57754,2024-02-08 16:00:04
525,T2-61.武蔵関公園（第二）,4,0,4,35.727826,139.570056,2024-02-08 16:00:04
526,T3-09.学田公園,4,0,4,35.730428,139.648704,2024-02-08 16:00:04
527,K1-105.東糀谷二丁目児童公園,0,8,8,35.555702,139.740802,2024-02-08 16:00:04
528,T3-04.サンパレス平和台,8,4,12,35.759827,139.659121,2024-02-08 16:00:04
529,K1-104.六郷BASE,3,3,6,35.543573,139.714393,2024-02-08 16:00:04
530,M4-16.神宮前6丁目,2,1,3,35.668673,139.702816,2024-02-08 16:00:04
531,K1-69.京急平和島第2Bバイク駐輪場,4,0,4,35.585747,139.735242,2024-02-08 16:00:04
532,H1-155.メブクス豊洲,0,34,34,35.645726,139.784496,2024-02-08 16:00:04
533,C2-11.一の橋,14,37,51,35.654726,139.737491,2024-02-08 16:00:04
534,C4-11.ザ・パークハウス 三田ガーデン,9,0,9,35.64816,139.737991,2024-02-08 16:00:04
535,H1-161.昭文社制作本部ビル,6,0,6,35.684003,139.794983,2024-02-08 16:00:04
536,N2-07.新井区民活動センター,2,3,5,35.714292,139.663327,2024-02-08 16:00:04
537,K1-87.羽田イノベーションシティ,2,8,10,35.547061,139.756277,2024-02-08 16:00:04
538,N3-16.COURT 5,5,0,5,35.699743,139.664608,2024-02-08 16:00:04
539,C4-01.高輪地区総合支所(5F),6,4,10,35.641833,139.734519,2024-02-08 16:00:04
540,C5-48.セブンイレブン港区海岸三丁目店,3,0,3,35.636808,139.752517,2024-02-08 16:00:04
541,H1-42.江東区スポーツ会館,0,18,18,35.683961,139.821559,2024-02-08 16:00:04
542,B2-10.東京ダイヤビルディング（北側）,0,3,3,35.675702,139.785229,2024-02-08 16:00:04
543,H1-43.東京イースト21,0,11,11,35.675639,139.815255,2024-02-08 16:00:04
544,B3-20.歌舞伎座タワー駐輪場2F,5,2,7,35.670106,139.768041,2024-02-08 16:00:04
545,B3-21.歌舞伎座タワー駐輪場3F,9,1,10,35.6701,139.76801,2024-02-08 16:00:04
546,K1-139.プラットホステル京急 羽田ホーム,8,2,10,35.548104,139.748889,2024-02-08 16:00:04
547,J1-58.目黒女子会館前,3,1,4,35.629011,139.69716,2024-02-08 16:00:04
548,T2-18.ファミリーマート練馬西税務署前店,4,0,4,35.745505,139.580878,2024-02-08 16:00:04
549,C3-23.LIFORK 南青山 北エントランス,14,15,29,35.669916,139.725701,2024-02-08 16:00:04
550,C1-46.新虎通りCORE,14,0,14,35.665124,139.754054,2024-02-08 16:00:04
551,C1-45.浜松町クレアタワー,13,3,16,35.656324,139.755927,2024-02-08 16:00:04
552,K1-53.セブン-イレブン 田園調布郵便局前店,18,2,20,35.589309,139.678587,2024-02-08 16:00:04
553,K1-52.大田区総合体育館,7,0,7,35.564152,139.727422,2024-02-08 16:00:04
554,T1-12.ファミリーマート 高松六丁目店,1,2,3,35.756873,139.616612,2024-02-08 16:00:04
555,D7-07.ローソン 新宿西落合三丁目店,2,3,5,35.725171,139.675897,2024-02-08 16:00:04
556,A6-16.一番町第二TGビル,1,3,4,35.688351,139.744321,2024-02-08 16:00:04
557,C3-33.PASONA SQUARE,12,0,12,35.667462,139.716058,2024-02-08 16:00:04
558,A3-24.岩本町ほほえみプラザ,0,5,5,35.69441,139.777715,2024-02-08 16:00:04
559,H1-35.ヒューリック豊洲プライムスクエア,6,0,6,35.652376,139.797724,2024-02-08 16:00:04
560,C5-11.フェイバリッチタワー品川,0,1,1,35.631729,139.749767,2024-02-08 16:00:04
561,E2-13.デルックス文京神楽坂,3,1,4,35.70781,139.732227,2024-02-08 16:00:04
562,C5-01.こうなん星の公園,0,68,68,35.629697,139.742167,2024-02-08 16:00:04
563,C5-02.港南緑水公園,2,26,28,35.628955,139.750731,2024-02-08 16:00:04
564,A3-22.龍閑児童公園,3,2,5,35.693234,139.779702,2024-02-08 16:00:04
565,A3-21.神田ふれあい通り第３,7,5,12,35.695176,139.772832,2024-02-08 16:00:04
566,H1-30.江東区役所（北側）,6,6,12,35.67338,139.8164,2024-02-08 16:00:04
567,C1-17.港区役所,2,2,4,35.657866,139.751068,2024-02-08 16:00:04
568,H1-31.江東区役所（南側）,14,2,16,35.67214,139.8166,2024-02-08 16:00:04
569,C1-09.愛宕グリーンヒルズ,7,2,9,35.662051,139.748132,2024-02-08 16:00:04
570,D1-02.四谷特別出張所（新宿御苑大木戸門前）,14,3,17,35.687435,139.714169,2024-02-08 16:00:04
571,D1-01.花園西公園,5,0,5,35.690612,139.711631,2024-02-08 16:00:04
572,C1-04.虎ノ門ヒルズ,8,6,14,35.666527,139.748804,2024-02-08 16:00:04
573,C1-05.西新橋2丁目（新虎通り）,14,0,14,35.665593,139.752617,2024-02-08 16:00:04
574,C1-73.日比谷フォートタワー,14,0,14,35.669871,139.753147,2024-02-08 16:00:04
575,K1-102.上池台四丁目公園,1,5,6,35.595119,139.6996,2024-02-08 16:00:04
576,M2-01.恵比寿保健相談所（恵比寿社会教育館）,0,8,8,35.64524,139.71946,2024-02-08 16:00:04
577,I1-98.コーポ荏原,1,1,2,35.60411,139.709784,2024-02-08 16:00:04
578,C3-17.セブン-イレブン 港区溜池山王店,0,20,20,35.670308,139.743242,2024-02-08 16:00:04
579,T2-11.石神井松の風文化公園,3,0,3,35.739471,139.595578,2024-02-08 16:00:04
580,M2-03.サイカパーク恵比寿,14,0,14,35.646581,139.710613,2024-02-08 16:00:04
581,M2-02.アメリカ橋公園,8,0,8,35.643606,139.713099,2024-02-08 16:00:04
582,T2-50.North Ridge 吉祥寺,6,3,9,35.72305,139.579555,2024-02-08 16:00:04
583,J1-35.目黒川田道街かど公園,6,0,6,35.634574,139.710332,2024-02-08 16:00:04
584,H1-174.ジュネス(エントランス側),2,0,2,35.682712,139.823961,2024-02-08 16:00:04
585,M6-17.笹塚一丁目駐輪場,1,6,7,35.672922,139.668729,2024-02-08 16:00:04
586,C4-14.神応ほっとプラザ,4,6,10,35.643711,139.724753,2024-02-08 16:00:04
587,K1-107.馬込駅A2出口,4,3,7,35.596854,139.712139,2024-02-08 16:00:04
588,T3-11.ガラクタ公園,1,2,3,35.740321,139.631256,2024-02-08 16:00:04
589,T2-80.みその緑地,2,3,5,35.756825,139.590528,2024-02-08 16:00:04
590,T3-24.AZEST新桜台,5,2,7,35.743962,139.670315,2024-02-08 16:00:04
591,D4-07.新宿余丁町ビル,0,2,2,35.698512,139.716482,2024-02-08 16:00:04
592,T3-01.練馬春日町駅自転車駐車場,6,1,7,35.751438,139.641265,2024-02-08 16:00:04
593,H1-89.BUDDY スポーツアリーナ,0,17,17,35.637041,139.781088,2024-02-08 16:00:04
594,E5-14.上野広小路駅（湯島側）,0,15,15,35.707313,139.771857,2024-02-08 16:00:04
595,H1-109.Brillia ist 東雲キャナルコート東側,0,0,0,35.648008,139.803487,2024-02-08 16:00:04
596,H1-108.Brillia ist 東雲キャナルコート北側,3,2,5,35.648431,139.803125,2024-02-08 16:00:04
597,C1-53.ホテルリブマックス新橋,3,1,4,35.661149,139.754612,2024-02-08 16:00:04
598,D7-10.染の里 おちあい,2,3,5,35.715211,139.689788,2024-02-08 16:00:04
599,A1-15.富士見みらい館,0,3,3,35.697167,139.745629,2024-02-08 16:00:04
600,E4-15.千石4丁目,4,0,4,35.729153,139.741368,2024-02-08 16:00:04
601,H1-111.ファミリーマート木場六丁目店,0,0,0,35.66688,139.80779,2024-02-08 16:00:04
602,C5-36.お台場海浜公園駅,0,1,1,35.62974,139.778178,2024-02-08 16:00:04
603,H1-10.出会い橋,15,0,15,35.625029,139.777344,2024-02-08 16:00:04
604,H1-11.テレコムセンター駅,3,18,21,35.61813,139.778698,2024-02-08 16:00:04
605,H1-47.トピレックプラザ,0,24,24,35.672481,139.835877,2024-02-08 16:00:04
606,H1-13.アーバンドック ららぽーと豊洲,16,3,19,35.654067,139.792376,2024-02-08 16:00:04
607,T2-66.大泉学園町希望ヶ丘公園,0,4,4,35.778605,139.588883,2024-02-08 16:00:04
608,C5-37.台場駅,0,27,27,35.626388,139.772453,2024-02-08 16:00:04
609,H1-16.豊洲三丁目公園,11,8,19,35.657477,139.796629,2024-02-08 16:00:04
610,H1-17.東雲水辺公園,14,0,14,35.64704,139.80469,2024-02-08 16:00:04
611,C1-72.新田町ビル,6,3,9,35.646307,139.746428,2024-02-08 16:00:04
612,K1-98.鵜の木松山公園,3,4,7,35.577433,139.680752,2024-02-08 16:00:04
613,C1-71.芝商業高校前交差点,0,6,6,35.65583,139.759896,2024-02-08 16:00:04
614,H1-122.東砂スポーツセンター,2,9,11,35.679167,139.839746,2024-02-08 16:00:04
615,O6-05.コージーコート久我山,0,5,5,35.687531,139.60439,2024-02-08 16:00:04
616,T2-39.ローソン 練馬大泉町五丁目店,2,6,8,35.758929,139.597548,2024-02-08 16:00:04
617,J1-50.大岡山公園,3,0,3,35.609958,139.684087,2024-02-08 16:00:04
618,J1-51.池尻大橋駅東口駐輪場,0,5,5,35.650627,139.687228,2024-02-08 16:00:04
619,K1-99.東原くすのき公園,6,0,6,35.584086,139.67898,2024-02-08 16:00:04
620,N3-12.桃園区民活動センター,2,1,3,35.702414,139.667327,2024-02-08 16:00:04
621,H1-191.三井リンクラボ新木場2,14,0,14,35.644863,139.831107,2024-02-08 16:00:04
622,M5-09.代々木上原駅前,4,0,4,35.66865,139.679251,2024-02-08 16:00:04
623,O3-09.NTT井草ビル第3ポート,5,2,7,35.714151,139.61693,2024-02-08 16:00:04
624,T1-07.土支田一丁目（笹目通り）,3,7,10,35.765913,139.619285,2024-02-08 16:00:04
625,K1-22.矢口特別出張所,5,0,5,35.562324,139.690486,2024-02-08 16:00:04
626,T3-08.中新井川児童遊園,3,3,6,35.728268,139.649188,2024-02-08 16:00:04
627,H1-78.ローソン新木場一丁目店,12,2,14,35.645604,139.834941,2024-02-08 16:00:04
628,A6-13.番町会館,4,2,6,35.689131,139.733071,2024-02-08 16:00:04
629,H1-71.セブン-イレブン 江東東陽4丁目,0,13,13,35.670906,139.819386,2024-02-08 16:00:04
630,D2-09.セブン-イレブン 新宿岩戸町店,2,0,2,35.700993,139.736355,2024-02-08 16:00:04
631,I1-08.天王洲アイル第一水辺広場,16,14,30,35.622294,139.751644,2024-02-08 16:00:04
632,I1-07.しながわ水族館,13,1,14,35.590641,139.736354,2024-02-08 16:00:04
633,D3-09.西早稲田3丁目,2,1,3,35.712545,139.713319,2024-02-08 16:00:04
634,E1-16.小石川3丁目緑地,13,0,13,35.714338,139.746346,2024-02-08 16:00:04
635,C5-28.芝浦ルネサイトタワー,7,0,7,35.643683,139.7506,2024-02-08 16:00:04
636,I1-59.文庫の森第一,18,0,18,35.612357,139.721484,2024-02-08 16:00:04
637,I1-60.文庫の森第二,4,0,4,35.611368,139.720424,2024-02-08 16:00:04
638,C1-38.KDX西新橋ビル（西側）,0,5,5,35.66495,139.750459,2024-02-08 16:00:04
639,C1-37.KDX西新橋ビル（北側）,4,1,5,35.665218,139.750827,2024-02-08 16:00:04
640,T2-14.NPC24H東大泉第6パーキング,1,5,6,35.747807,139.593599,2024-02-08 16:00:04
641,C3-12.赤坂センタービルディング前（青山通り）,2,6,8,35.676732,139.733905,2024-02-08 16:00:04
642,H1-36.フジゴルフセンター,3,6,9,35.66605,139.806699,2024-02-08 16:00:04
643,C1-27.虎ノ門2丁目タワー,6,8,14,35.668547,139.747175,2024-02-08 16:00:04
644,C5-12.第2東運ビル,3,0,3,35.633742,139.748281,2024-02-08 16:00:04
645,D6-08.新宿イーストサイドスクエア,5,1,6,35.697158,139.707887,2024-02-08 16:00:04
646,A4-08.永代通り（大手町駅B2c出口前）,18,3,21,35.684349,139.766958,2024-02-08 16:00:04
647,H1-37.東雲駅（東京湾岸道路）,30,3,33,35.640618,139.802455,2024-02-08 16:00:04
648,C3-11.赤坂見附南,0,3,3,35.676566,139.737083,2024-02-08 16:00:04
649,M6-04.本町東べんてん橋公園,0,19,19,35.687126,139.680702,2024-02-08 16:00:04
650,I1-79.品川浦第二,13,0,13,35.621904,139.741429,2024-02-08 16:00:04
651,K1-81.コーナン本羽田萩中店,10,1,11,35.549568,139.731093,2024-02-08 16:00:04
652,D6-25.新宿駅東南口自転車駐輪場,25,3,28,35.689755,139.701323,2024-02-08 16:00:04
653,I1-78.セブン-イレブン西大井店,9,0,9,35.601431,139.718659,2024-02-08 16:00:04
654,H1-136.東砂一丁目公園,7,9,16,35.683542,139.839763,2024-02-08 16:00:04
655,A6-23.セブン-イレブン 千代田三番町店,0,11,11,35.689466,139.745316,2024-02-08 16:00:04
656,C5-34.五色橋ビル,0,9,9,35.636644,139.751798,2024-02-08 16:00:04
657,K1-41.郷土博物館,0,9,9,35.588644,139.710413,2024-02-08 16:00:04
658,G2-06.ディアレイシャス押上スカイヴィレッジ,0,5,5,35.71408,139.810588,2024-02-08 16:00:04
659,O3-11.ハイリビング関根,3,4,7,35.707877,139.618926,2024-02-08 16:00:04
660,O7-02.永福中央公園,6,0,6,35.67121,139.64145,2024-02-08 16:00:04
661,K1-29.萩中文化センター,5,4,9,35.55017,139.728146,2024-02-08 16:00:04
662,K1-30.テクノFRONT森ケ崎,0,2,2,35.567922,139.746181,2024-02-08 16:00:04
663,K1-130.COCOONひろば平和島,18,0,18,35.578728,139.735238,2024-02-08 16:00:04
664,H1-81.豊洲IHIビル（北側）,13,7,20,35.659829,139.793243,2024-02-08 16:00:04
665,E4-03.昭和小学校北側（不忍通り）,26,7,33,35.73166,139.748625,2024-02-08 16:00:04
666,C2-12.六本木ファーストビル,10,1,11,35.66249,139.741397,2024-02-08 16:00:04
667,D3-16.セジョリ江戸川橋,8,6,14,35.708734,139.730509,2024-02-08 16:00:04
668,A5-04.日比谷パークフロント前　日比谷公園南面向い歩道上,1,6,7,35.671514,139.753952,2024-02-08 16:00:04
669,C3-22.OMO3東京赤坂 by 星野リゾート,8,0,8,35.674929,139.736053,2024-02-08 16:00:04
670,B1-20.竜閑さくら橋際街角広場,0,21,21,35.688301,139.768958,2024-02-08 16:00:04
671,H1-83.ローソン江東東雲店,5,1,6,35.642165,139.800439,2024-02-08 16:00:04
672,H1-84.NTT東日本辰巳ビル,0,21,21,35.647091,139.817333,2024-02-08 16:00:04
673,C5-26.ピアシティ芝浦ビル,7,0,7,35.644155,139.756216,2024-02-08 16:00:04
674,T3-28.ほしぞら緑地,0,3,3,35.755137,139.661208,2024-02-08 16:00:04
675,I1-88.セブン-イレブン品川南大井3丁目店,1,0,1,35.58768,139.734515,2024-02-08 16:00:04
676,I1-87.セブン-イレブン西大井滝王子通り店,0,1,1,35.599774,139.723467,2024-02-08 16:00:04
677,G4-11.ホテルマイステイズ浅草,20,2,22,35.703972,139.797327,2024-02-08 16:00:04
678,C5-30.フェイム芝浦インターウェーブ,4,1,5,35.647872,139.75391,2024-02-08 16:00:04
679,M6-13.JICA東京,10,2,12,35.673409,139.675203,2024-02-08 16:00:04
680,A4-13.アーバンネット大手町ビル,1,4,5,35.68557,139.766929,2024-02-08 16:00:04
681,B4-27.リバーシティ西ブロック,15,1,16,35.670491,139.784447,2024-02-08 16:00:04
682,K1-143.大森北1丁目,60,0,60,35.584914,139.730504,2024-02-08 16:00:04
683,E5-24.本郷6丁目,5,0,5,35.712445,139.758157,2024-02-08 16:00:04
684,D2-17.genten市ヶ谷店,9,1,10,35.690657,139.73255,2024-02-08 16:00:04
685,A4-14.東京国際フォーラム（有楽町駅ガード側）,5,0,5,35.675739,139.763712,2024-02-08 16:00:04
686,A2-27.丸紅ビル,4,3,7,35.690958,139.759876,2024-02-08 16:00:04
687,K1-135.北千束2丁目,4,2,6,35.608633,139.693653,2024-02-08 16:00:04
688,A1-19.九段会館テラス,2,2,4,35.694065,139.751801,2024-02-08 16:00:04
689,K1-136.BIG FUN 平和島,0,9,9,35.585489,139.740194,2024-02-08 16:00:04
690,K1-137.京浜島つばさ公園,0,16,16,35.571578,139.770532,2024-02-08 16:00:04
691,D1-16.ルネ新宿御苑タワー,8,1,9,35.690155,139.713377,2024-02-08 16:00:04
692,G6-01.オーキッドレジデンス森下,5,0,5,35.692547,139.799231,2024-02-08 16:00:04
693,T2-63.三原台公園,1,6,7,35.751471,139.599835,2024-02-08 16:00:04
694,O4-01.阿佐ヶ谷南公園,1,0,1,35.70328,139.62981,2024-02-08 16:00:04
695,B4-11.ダンスキューブ勝どき,0,9,9,35.656565,139.775073,2024-02-08 16:00:04
696,D1-06.四谷第六小学校北,9,0,9,35.681754,139.715256,2024-02-08 16:00:04
697,T2-64.高野台中央公園,1,2,3,35.746768,139.613885,2024-02-08 16:00:04
698,H1-169.セブンイレブン江東亀戸7丁目東店,4,6,10,35.697157,139.839835,2024-02-08 16:00:04
699,H1-170.セブンイレブン江東亀戸7丁目南店,0,22,22,35.695937,139.838017,2024-02-08 16:00:04
700,B2-16.ホテルサードニクス東京,0,3,3,35.67684,139.77876,2024-02-08 16:00:04
701,I1-93.中央海浜公園前交差点（南側）,5,0,5,35.595498,139.750654,2024-02-08 16:00:04
702,I1-92.中央海浜公園前交差点（北側）,8,2,10,35.595873,139.75134,2024-02-08 16:00:04
703,B1-26.Dash Living Nihonbashi,4,2,6,35.68802,139.78112,2024-02-08 16:00:04
704,H1-158.東京国際交流館,12,0,12,35.621845,139.776833,2024-02-08 16:00:04
705,J1-32.緑が丘駅前高架下,6,1,7,35.606793,139.678372,2024-02-08 16:00:04
706,K1-90.ファミリーマート大田仲池上一丁目店,3,3,6,35.5873,139.701644,2024-02-08 16:00:04
707,K1-91.穴守稲荷神社,2,8,10,35.550027,139.74973,2024-02-08 16:00:04
708,C1-67.京阪神 虎ノ門ビル,19,2,21,35.669228,139.751668,2024-02-08 16:00:04
709,K1-89.ファミリーマート大田千鳥三丁目店,3,2,5,35.572086,139.68708,2024-02-08 16:00:04
710,I1-97.トミンハイム東品川三丁目第二,16,2,18,35.613387,139.749307,2024-02-08 16:00:04
711,T2-51.練馬区役所石神井庁舎,3,7,10,35.743772,139.603317,2024-02-08 16:00:04
712,T2-75.石神井台二丁目緑地,3,0,3,35.734684,139.593628,2024-02-08 16:00:04
713,E5-19.千駄木公園,3,0,3,35.728333,139.757629,2024-02-08 16:00:04
714,E5-18.団子坂上広場,0,9,9,35.724921,139.75903,2024-02-08 16:00:04
715,A5-07.富国生命ビル,1,3,4,35.670452,139.75557,2024-02-08 16:00:04
716,H1-156.つどい橋下,0,9,9,35.630791,139.787396,2024-02-08 16:00:04
717,H1-159.夢の大橋西,14,2,16,35.627599,139.782953,2024-02-08 16:00:04
718,H1-143.ダイバーシティ東京 プラザ,8,1,9,35.624619,139.776006,2024-02-08 16:00:04
719,I1-57.大井水神公園,65,3,68,35.589972,139.729368,2024-02-08 16:00:04
720,B2-15.KABUTO ONE,1,5,6,35.68168,139.77825,2024-02-08 16:00:04
721,K1-64.多摩川グリーンスクエア,1,6,7,35.545459,139.719489,2024-02-08 16:00:04
722,T2-57.大泉公園（第二）,5,1,6,35.771708,139.583551,2024-02-08 16:00:04
723,A4-06.大手町ファーストスクエア,0,15,15,35.686037,139.764472,2024-02-08 16:00:04
724,C1-50.NTT虎ノ門ビル,11,3,14,35.666075,139.748008,2024-02-08 16:00:04
725,C1-23.三田いきいきプラザ,8,0,8,35.648637,139.749834,2024-02-08 16:00:04
726,H1-29.スカイズタワー＆ガーデン,0,0,0,35.647618,139.792152,2024-02-08 16:00:04
727,C1-21.汐留ビルディング,6,4,10,35.657363,139.75918,2024-02-08 16:00:04
728,A3-16.地蔵橋東児童遊園,2,4,6,35.691069,139.775376,2024-02-08 16:00:04
729,A3-18.美倉橋北児童遊園,0,4,4,35.69703,139.779928,2024-02-08 16:00:04
730,A4-01.丸ビル（南側駐輪場）,7,3,10,35.680514,139.764002,2024-02-08 16:00:04
731,A3-11.練成公園,1,6,7,35.703735,139.770629,2024-02-08 16:00:04
732,A3-10.芳林公園（北側）,0,7,7,35.701978,139.7698,2024-02-08 16:00:04
733,A6-02.いきいきプラザ一番町（西側駐輪場）,7,0,7,35.687031,139.739327,2024-02-08 16:00:04
734,A6-01.東郷元帥記念公園（南側）,3,0,3,35.689879,139.740178,2024-02-08 16:00:04
735,A5-03.参議院第二別館（永田町駅2番出口）,10,3,13,35.677763,139.74271,2024-02-08 16:00:04
736,A4-03.東京国際フォーラム（メトロD5出口）,6,0,6,35.675843,139.763329,2024-02-08 16:00:04
737,K1-15.セブン‐イレブン 大田区西蒲田店,3,0,3,35.56694,139.716331,2024-02-08 16:00:04
738,K1-49.ローソン仲池上一丁目店,7,1,8,35.586585,139.698552,2024-02-08 16:00:04
739,A2-06.東光電気工事 別館（屋内駐輪場）,7,0,7,35.69919,139.75701,2024-02-08 16:00:04
740,M4-01.新宿タカシマヤ,2,4,6,35.68714,139.702775,2024-02-08 16:00:04
741,M4-03.NTTドコモ代々木ビル,7,3,10,35.684451,139.702884,2024-02-08 16:00:04
742,M3-03.代官山 T-SITE,5,3,8,35.649823,139.700139,2024-02-08 16:00:04
743,K1-14.大森地域庁舎,6,0,6,35.578239,139.723262,2024-02-08 16:00:04
744,C5-46.ウエリスアーバン品川タワー,5,0,5,35.630961,139.746875,2024-02-08 16:00:04
745,C4-13.コシダコネクトビル,0,13,13,35.637765,139.739128,2024-02-08 16:00:04
746,K1-127.第二石井ビル,2,2,4,35.559286,139.722611,2024-02-08 16:00:04
747,C1-74.札の辻スクエア,6,0,6,35.645155,139.744543,2024-02-08 16:00:04
748,H1-164.森下三丁目第三児童遊園,8,4,12,35.68546,139.80244,2024-02-08 16:00:04
749,C1-78.CIRCLES新橋,9,0,9,35.66646,139.752138,2024-02-08 16:00:04
750,C3-34.3rd MINAMI AOYAMA,4,2,6,35.668622,139.715957,2024-02-08 16:00:04
751,O4-06.杉並区役所本庁舎,2,3,5,35.699328,139.636343,2024-02-08 16:00:04
752,D3-14.コーシャハイム高田馬場,6,0,6,35.712413,139.70168,2024-02-08 16:00:04
753,D7-11.新宿清掃事務所,3,2,5,35.716359,139.704377,2024-02-08 16:00:04
754,D5-08.ウエリス新宿早稲田の森,3,4,7,35.704597,139.708397,2024-02-08 16:00:04
755,E2-12.水道2丁目,0,7,7,35.709147,139.739183,2024-02-08 16:00:04
756,M6-10.京王コインパーク幡ヶ谷,0,3,3,35.6772,139.678117,2024-02-08 16:00:04
757,E3-05.文京スポーツセンター,39,21,60,35.721045,139.735687,2024-02-08 16:00:04
758,J1-36.WJ Haus,0,3,3,35.629067,139.711779,2024-02-08 16:00:04
759,K1-51.テクノポートカマタ 第2,10,1,11,35.555808,139.722791,2024-02-08 16:00:04
760,D1-13.新宿御苑新宿門【西側】,0,21,21,35.688945,139.706536,2024-02-08 16:00:04
761,I1-31.セブン-イレブン 品川戸越5丁目店,4,1,5,35.608193,139.719139,2024-02-08 16:00:04
762,T3-27.貫井川緑地,1,3,4,35.738427,139.632251,2024-02-08 16:00:04
763,H1-147.大島四丁目団地,14,2,16,35.68744,139.827075,2024-02-08 16:00:04
764,O4-02.成宗さくら公園,2,0,2,35.69638,139.63482,2024-02-08 16:00:04
765,O1-01.上瀬戸公園,2,2,4,35.72077,139.6045,2024-02-08 16:00:04
766,T2-15.NPC24H大泉学園南口パーキング,4,5,9,35.748611,139.584251,2024-02-08 16:00:04
767,O3-03.桃井1丁目5番地,7,0,7,35.71013,139.61194,2024-02-08 16:00:04
768,H1-08.東京テレポート駅,4,38,42,35.627087,139.779779,2024-02-08 16:00:04
769,H1-05.相鉄グランドフレッサ 東京ベイ有明,13,1,14,35.632148,139.79017,2024-02-08 16:00:04
770,H1-06.武蔵野大学,0,17,17,35.630185,139.786618,2024-02-08 16:00:04
771,A4-15.TOKIWAブリッジ,2,7,9,35.686389,139.769237,2024-02-08 16:00:04
772,H1-160.花の広場,7,10,17,35.633908,139.793322,2024-02-08 16:00:04
773,H1-01.豊洲ＩＨＩビル前（晴海通り）,6,3,9,35.658911,139.792531,2024-02-08 16:00:04
774,H1-02.豊洲駅,0,30,30,35.654196,139.79626,2024-02-08 16:00:04
775,J1-19.NTT東日本自由が丘ビル,3,1,4,35.615098,139.675954,2024-02-08 16:00:04
776,C2-19.広尾駅,5,0,5,35.650732,139.72256,2024-02-08 16:00:04
777,H1-114.東京夢の島マリーナ,5,9,14,35.651987,139.830691,2024-02-08 16:00:04
778,K1-71.ファミリーマート大田大森南店,2,2,4,35.562769,139.74327,2024-02-08 16:00:04
779,J1-20.すずめのお宿緑地公園,4,4,8,35.617773,139.685351,2024-02-08 16:00:04
780,H1-115.東京夢の島マリーナ 第4駐車場,2,12,14,35.650235,139.835993,2024-02-08 16:00:04
781,M5-10.富ヶ谷2丁目,16,1,17,35.665961,139.686491,2024-02-08 16:00:04
782,J1-21.中央緑地公園,0,3,3,35.630694,139.690482,2024-02-08 16:00:04
783,H1-116.出会い橋高架下,27,22,49,35.625037,139.777646,2024-02-08 16:00:04
784,M3-12.渋谷南東急ビル,7,0,7,35.656228,139.706284,2024-02-08 16:00:04
785,T2-01.大泉学園駅北口,1,4,5,35.749918,139.58618,2024-02-08 16:00:04
786,K1-06.大森駅入新井自転車駐車場,4,0,4,35.585269,139.726279,2024-02-08 16:00:04
787,D6-06.新宿中央公園（エコギャラリー下）,0,14,14,35.691199,139.687966,2024-02-08 16:00:04
788,D6-14.新宿ファーストウエスト,10,4,14,35.689529,139.695995,2024-02-08 16:00:04
789,D6-15.住友不動産西新宿ビル,11,0,11,35.69465,139.695911,2024-02-08 16:00:04
790,H1-56.南砂三丁目緑地公園西,0,27,27,35.672361,139.829825,2024-02-08 16:00:04
791,T2-74.扇橋公園,2,3,5,35.731791,139.588844,2024-02-08 16:00:04
792,B2-20.SHビル,3,0,3,35.675398,139.779962,2024-02-08 16:00:04
793,I1-17.東品川海上公園第2,6,0,6,35.616364,139.749171,2024-02-08 16:00:04
794,I1-16.品川浦,14,0,14,35.6214,139.741958,2024-02-08 16:00:04
795,A4-11.二重橋前駅(メトロ4番出口),4,0,4,35.680753,139.762069,2024-02-08 16:00:04
796,H1-76.有明物流センター,7,11,18,35.638571,139.78829,2024-02-08 16:00:04
797,K1-43.北馬込わくわく公園,0,9,9,35.600707,139.703216,2024-02-08 16:00:04
798,K1-42.馬込西公園,11,3,14,35.58849,139.70376,2024-02-08 16:00:04
799,T1-08.セブン-イレブン 練馬高松6丁目店,4,0,4,35.756506,139.620347,2024-02-08 16:00:04
800,T2-17.ファミリーマート 練馬石神井町八丁目店,0,5,5,35.74755,139.597968,2024-02-08 16:00:04
801,K1-31.テクノWING,0,10,10,35.546252,139.731708,2024-02-08 16:00:04
802,K1-32.石川町文化センター,5,0,5,35.601958,139.682876,2024-02-08 16:00:04
803,I1-20.しおじ公園,13,5,18,35.59632,139.751279,2024-02-08 16:00:04
804,I1-19.品川シーサイド公園第2,7,0,7,35.607571,139.749108,2024-02-08 16:00:04
805,J1-29.カスタリア目黒鷹番,4,1,5,35.626121,139.688576,2024-02-08 16:00:04
806,H1-127.古石場川親水公園,0,19,19,35.669291,139.795364,2024-02-08 16:00:04
807,D4-05.カスタリア新宿7丁目,0,10,10,35.700732,139.711472,2024-02-08 16:00:04
808,I1-71.セブン-イレブン南大井浜川店,1,1,2,35.596483,139.7355,2024-02-08 16:00:04
809,I1-72.セブン-イレブン大井店,0,0,0,35.600081,139.728193,2024-02-08 16:00:04
810,T3-21.くまのやま緑地,4,1,5,35.747038,139.667965,2024-02-08 16:00:04
811,K1-110.萩中集会所裏,8,5,13,35.550479,139.739538,2024-02-08 16:00:04
812,O2-02.シエール荻窪,30,0,30,35.708265,139.612703,2024-02-08 16:00:04
813,H1-128.豊洲市場（5街区）,21,13,34,35.645162,139.785386,2024-02-08 16:00:04
814,N1-09.若宮レジデンス,2,3,5,35.716184,139.643905,2024-02-08 16:00:04
815,M6-12.LIVART SEASON 幡ヶ谷,0,9,9,35.683156,139.67338,2024-02-08 16:00:04
816,H1-142.東京ベイ潮見プリンスホテル,3,3,6,35.660632,139.817294,2024-02-08 16:00:04
817,G1-01.鐘ヶ淵駅南自転車駐車場,1,8,9,35.732291,139.82012,2024-02-08 16:00:04
818,M1-01.渋谷区役所,4,4,8,35.66362,139.69801,2024-02-08 16:00:04
819,I1-83.かもめ歩道橋,0,20,20,35.600161,139.749902,2024-02-08 16:00:04
820,N4-05.セブン-イレブン中野鍋横店,3,1,4,35.693815,139.668571,2024-02-08 16:00:04
821,D4-02.JICA市ヶ谷ビル（地球ひろば／研究所）,7,0,7,35.694927,139.731328,2024-02-08 16:00:04
822,T3-19.なかみや児童遊園,1,4,5,35.749388,139.651824,2024-02-08 16:00:04
823,N1-08.上鷺自転車保管場所,2,5,7,35.729056,139.627864,2024-02-08 16:00:04
824,O7-06.松木1丁目,2,11,13,35.686015,139.642784,2024-02-08 16:00:04
825,E4-16.ビレッジワン,6,0,6,35.723723,139.740143,2024-02-08 16:00:04
826,D1-15.フロンティア四谷,3,5,8,35.68768,139.71937,2024-02-08 16:00:04
827,K1-128.大森西3丁目,9,4,13,35.571975,139.732137,2024-02-08 16:00:04
828,N1-06.大和区民活動センター,2,3,5,35.713562,139.649075,2024-02-08 16:00:04
829,G4-01.両国ビューホテル1,1,6,7,35.69566,139.79214,2024-02-08 16:00:04
830,G4-02.両国ビューホテル2,2,6,8,35.69562,139.79206,2024-02-08 16:00:04
831,G4-05.両国駅西口臨時自転車駐車場,17,2,19,35.698588,139.792946,2024-02-08 16:00:04
832,G4-03.本所1-6-5,9,5,14,35.702525,139.796632,2024-02-08 16:00:04
833,G5-01.牡丹橋自転車駐車場,17,0,17,35.693059,139.813417,2024-02-08 16:00:04
834,G5-02.横川3-7-10,18,19,37,35.70378,139.814298,2024-02-08 16:00:04
835,G4-04.NTTドコモ墨田ビル,13,6,19,35.697898,139.795345,2024-02-08 16:00:04
836,G2-02.押上1-23-8,2,6,8,35.710111,139.81488,2024-02-08 16:00:04
837,C5-13.区立芝浦西運河沿緑地,34,0,34,35.638245,139.749754,2024-02-08 16:00:04
838,D6-12.東京ビジネスホテル,0,3,3,35.69342,139.710568,2024-02-08 16:00:04
839,D6-11.ホテルリステル新宿,0,3,3,35.693029,139.711327,2024-02-08 16:00:04
840,D6-10.ホテルサンライト新宿,1,0,1,35.694201,139.707047,2024-02-08 16:00:04
841,H1-39.辰巳駅東口自転車駐車場,17,8,25,35.645823,139.812178,2024-02-08 16:00:04
842,H1-38.辰巳駅西口自転車駐車場,89,0,89,35.646857,139.808912,2024-02-08 16:00:04
843,C2-10.元麻布三丁目,0,6,6,35.655865,139.730566,2024-02-08 16:00:04
844,C2-09.麻布地区総合支所,0,3,3,35.660614,139.734771,2024-02-08 16:00:04
845,M3-20.東急ステイ渋谷新南口,8,0,8,35.65494,139.70534,2024-02-08 16:00:04
846,I1-86.ファミリーマート二葉三丁目店,0,3,3,35.601694,139.719778,2024-02-08 16:00:04
847,A2-23.axle御茶ノ水,6,1,7,35.696126,139.763297,2024-02-08 16:00:04
848,C4-02.白金台いきいきプラザ,4,1,5,35.63756,139.724981,2024-02-08 16:00:04
849,N3-04.東中野駅地下駐輪場,0,22,22,35.707883,139.683284,2024-02-08 16:00:04
850,N3-05.中野坂上駅地下駐輪場,0,5,5,35.698068,139.682781,2024-02-08 16:00:04
851,N3-03.青桐公園,0,12,12,35.697024,139.677846,2024-02-08 16:00:04
852,N3-01.中野四季の森公園,4,6,10,35.708487,139.662135,2024-02-08 16:00:04
853,N4-01.本四公園,1,8,9,35.69693,139.672721,2024-02-08 16:00:04
854,N4-02.栄町公園,2,0,2,35.686474,139.671383,2024-02-08 16:00:04
855,K1-57.池上本門寺,5,1,6,35.579585,139.705377,2024-02-08 16:00:04
856,C1-49.汐留シティセンター,8,2,10,35.666213,139.760907,2024-02-08 16:00:04
857,C4-15.クロスレジデンス白金高輪,0,12,12,35.642771,139.733046,2024-02-08 16:00:04
858,K1-56.NTT馬込ビル,0,6,6,35.588106,139.718852,2024-02-08 16:00:04
859,J1-41.CASSIA目黒,3,2,5,35.631319,139.70237,2024-02-08 16:00:04
860,A2-22.専修大学,6,0,6,35.696147,139.753709,2024-02-08 16:00:04
861,T3-20.はやいち公園,2,2,4,35.75312,139.65661,2024-02-08 16:00:04
862,B3-19.本の森ちゅうおう,6,2,8,35.67363,139.77623,2024-02-08 16:00:04
863,K1-86.IMPREST STAY TOKYO 蒲田,22,0,22,35.556267,139.727246,2024-02-08 16:00:04
864,T3-23.氷川台二丁目緑地,3,1,4,35.756575,139.669689,2024-02-08 16:00:04
865,T3-22.氷川台三丁目ちびっこ公園,1,2,3,35.750547,139.66707,2024-02-08 16:00:04
866,B1-23.NANAEI日本橋,4,0,4,35.679616,139.784341,2024-02-08 16:00:04
867,B2-11.京橋エドグラン,5,7,12,35.677576,139.769822,2024-02-08 16:00:04
868,N1-05.大野ハイツ,1,4,5,35.7266,139.62948,2024-02-08 16:00:04
869,B2-09.茅場町一丁目平和ビル,5,5,10,35.680203,139.778679,2024-02-08 16:00:04
870,B2-08.共同ビル（茅場町交差点前）,4,5,9,35.681012,139.778569,2024-02-08 16:00:04
871,B2-07.東京証券会館（北側）,0,1,1,35.680864,139.779331,2024-02-08 16:00:04
872,O3-12.大宮前体育館,1,1,2,35.696567,139.610517,2024-02-08 16:00:04
873,B1-08.明治座,0,8,8,35.688038,139.786561,2024-02-08 16:00:04
874,B4-05.ドコモ・バイクシェア晴海ポート,0,28,28,35.654165,139.781568,2024-02-08 16:00:04
875,B4-04.ＫＤＸ晴海ビル,0,0,0,35.65443,139.77843,2024-02-08 16:00:04
876,B4-03.桜の散歩道（晴海トリトンスクエア前）,3,11,14,35.658665,139.782553,2024-02-08 16:00:04
877,E5-08.セブン-イレブン 文京動坂上店,4,0,4,35.727778,139.756296,2024-02-08 16:00:04
878,H1-65.ローソン南砂日曹橋店,13,1,14,35.669507,139.825553,2024-02-08 16:00:04
879,H1-66.中川船番所資料館,6,0,6,35.687732,139.846383,2024-02-08 16:00:04
880,K1-113.ファミリーマート大田上池台四丁目店,1,6,7,35.594658,139.700133,2024-02-08 16:00:04
881,H1-64.ローソン東雲駅前店,8,2,10,35.640228,139.804267,2024-02-08 16:00:04
882,E1-11.小石川運動場前,11,3,14,35.703914,139.747061,2024-02-08 16:00:04
883,T2-70.三ツ塚けやき緑地,2,2,4,35.720318,139.570762,2024-02-08 16:00:04
884,H1-137.住友不動産ショッピングシティ有明ガーデン,17,1,18,35.638985,139.793653,2024-02-08 16:00:04
885,C5-40.芝浦ふ頭駅前暫定自転車駐車場,0,3,3,35.64096,139.75754,2024-02-08 16:00:04
886,M3-21.渋谷ソラスタ,10,1,11,35.65618,139.69612,2024-02-08 16:00:04
887,D7-03.中井駅北,21,10,31,35.715645,139.687486,2024-02-08 16:00:04
888,K1-119.シーンズ大森パークサイド,4,0,4,35.58223,139.72763,2024-02-08 16:00:04
889,M6-15.cova Hatagaya,0,2,2,35.67741,139.67383,2024-02-08 16:00:04
890,C2-25.アパホテル＆リゾート＜六本木駅東＞,38,4,42,35.661783,139.737242,2024-02-08 16:00:04
891,D4-10.東新宿ポート(余丁町6番),2,2,4,35.696585,139.713081,2024-02-08 16:00:04
892,O1-02.井荻南地下自転車駐車場,5,8,13,35.72424,139.61431,2024-02-08 16:00:04
893,O1-03.LUCKY HOUSE,1,3,4,35.72489,139.62383,2024-02-08 16:00:04
894,D6-30.京王プラザホテル,7,0,7,35.6897,139.694823,2024-02-08 16:00:04
895,D6-29.都庁第二本庁舎前,12,1,13,35.688735,139.692249,2024-02-08 16:00:04
896,O3-02.アートメゾン荻窪,6,2,8,35.71355,139.6199,2024-02-08 16:00:04
897,J1-57.トレインチ自由が丘,4,0,4,35.606667,139.667324,2024-02-08 16:00:04
898,O2-01.サカエフラット荻窪,10,1,11,35.70535,139.61497,2024-02-08 16:00:04
899,O3-01.西田公園,3,3,6,35.69575,139.62065,2024-02-08 16:00:04
900,K1-47.NTT雪ヶ谷ビル,7,2,9,35.598601,139.684747,2024-02-08 16:00:04
901,O7-04.永福町西幸モータープール西,7,1,8,35.67161,139.64527,2024-02-08 16:00:04
902,K1-48.ファミリーマート大田上池台三丁目店,0,9,9,35.590934,139.696915,2024-02-08 16:00:04
903,K1-111.本羽田公園,6,1,7,35.546499,139.736761,2024-02-08 16:00:04
904,C1-58.ウォーターズ竹芝,3,6,9,35.655937,139.763251,2024-02-08 16:00:04
905,K1-109.萩中公園プール駐輪場,7,1,8,35.549323,139.737091,2024-02-08 16:00:04
906,K1-108.仲江名公園,2,1,3,35.557999,139.732564,2024-02-08 16:00:04
907,E1-17.小石川パークスクエア,4,0,4,35.713913,139.745416,2024-02-08 16:00:04
908,D6-23.アパホテル 東新宿 歌舞伎町西,1,0,1,35.697535,139.703633,2024-02-08 16:00:04
909,H1-98.洲崎川緑道公園,0,15,15,35.668705,139.810549,2024-02-08 16:00:04
910,H1-99.南砂三丁目公園,18,5,23,35.669695,139.831874,2024-02-08 16:00:04
911,H1-96.越中島公園,0,16,16,35.668757,139.790156,2024-02-08 16:00:04
912,H1-97.浜園公園,0,6,6,35.661852,139.802224,2024-02-08 16:00:04
913,H1-94.新木場一丁目緑地公園,3,6,9,35.64423,139.835823,2024-02-08 16:00:04
914,H1-95.若洲公園,5,19,24,35.619451,139.834429,2024-02-08 16:00:04
915,J1-09.ファミリーマート佐野久下目黒店,4,0,4,35.629252,139.712716,2024-02-08 16:00:04
916,H1-93.新木場一丁目公園,0,10,10,35.64143,139.835455,2024-02-08 16:00:04
917,I1-55.鈴ヶ森公園,0,0,0,35.593559,139.734704,2024-02-08 16:00:04
918,O6-04.柏の宮公園,1,4,5,35.67834,139.62711,2024-02-08 16:00:04
919,B4-14.Brillia ist Tower 勝どき,3,1,4,35.660526,139.776816,2024-02-08 16:00:04
920,D7-08.上落合3丁目,1,12,13,35.71115,139.68232,2024-02-08 16:00:04
921,H1-21.UR東雲キャナルコート,0,9,9,35.646041,139.804495,2024-02-08 16:00:04
922,H1-20.日本科学未来館,22,8,30,35.619377,139.777582,2024-02-08 16:00:04
923,H1-19.UR豊洲四丁目団地,21,0,21,35.653603,139.80144,2024-02-08 16:00:04
924,T2-45.風致地区バス停第三自転車駐車場,3,4,7,35.771068,139.586798,2024-02-08 16:00:04
925,H1-33.深川ギャザリア（ウエストスクエア）,0,5,5,35.66789,139.803,2024-02-08 16:00:04
926,H1-32.区営塩浜住宅前,14,0,14,35.664591,139.813954,2024-02-08 16:00:04
927,H1-23.KDX豊洲グランスクエア,10,0,10,35.648085,139.798986,2024-02-08 16:00:04
928,C2-22.飯倉公園,8,0,8,35.655649,139.74427,2024-02-08 16:00:04
929,I1-89.下神明駅自転車駐車場,5,0,5,35.608402,139.726118,2024-02-08 16:00:04
930,C5-39.お台場海浜公園東,13,0,13,35.631021,139.778109,2024-02-08 16:00:04
931,C5-38.お台場海浜公園乗船場,0,17,17,35.628743,139.773915,2024-02-08 16:00:04
932,O4-08.ローソン阿佐ヶ谷青梅街道店,0,5,5,35.703203,139.62804,2024-02-08 16:00:04
933,T2-72.高塚南緑地,5,1,6,35.733132,139.570311,2024-02-08 16:00:04
934,O6-03.みなみ荘,6,4,10,35.68073,139.62803,2024-02-08 16:00:04
935,K1-129.ローソン東糀谷一丁目店,0,6,6,35.557427,139.739126,2024-02-08 16:00:04
936,E1-03.東京ドーム（黄色いビル横）,7,1,8,35.70319,139.751888,2024-02-08 16:00:04
937,K1-23.大田区役所本庁舎前,6,0,6,35.561183,139.716339,2024-02-08 16:00:04
938,T2-78.北大泉くれはし公園,2,1,3,35.761474,139.592735,2024-02-08 16:00:04
939,J1-53.ボヌールAllamanda,2,3,5,35.612833,139.675047,2024-02-08 16:00:04
940,A3-39.トーシン東神田ビル,0,5,5,35.694834,139.780333,2024-02-08 16:00:04
941,O6-01.高井戸みどり公園,5,4,9,35.67912,139.61074,2024-02-08 16:00:04
942,T2-79.大泉学園町八丁目緑地,4,2,6,35.774457,139.596182,2024-02-08 16:00:04
943,O5-04.リヴィエール,16,4,20,35.70104,139.65839,2024-02-08 16:00:04
944,N3-08.中野区役所(西側),1,5,6,35.707968,139.663519,2024-02-08 16:00:04
945,I1-99.北品川２丁目,6,0,6,35.61663,139.74192,2024-02-08 16:00:04
946,P1-01.サンシャインシティ,4,2,6,35.728846,139.718577,2024-02-08 16:00:04
947,N3-14.ヴィラソンサ落合,0,6,6,35.713227,139.680966,2024-02-08 16:00:04
948,H1-49.セブン-イレブン 江東新砂３丁目店,0,21,21,35.667892,139.8311,2024-02-08 16:00:04
949,I1-06.大森貝塚遺跡庭園,9,0,9,35.593489,139.72967,2024-02-08 16:00:04
950,M2-12.恵比寿プライムスクエアタワー北,8,0,8,35.650541,139.713361,2024-02-08 16:00:04
951,H1-69.ファミリーマート 江東石島店,0,20,20,35.680474,139.812316,2024-02-08 16:00:04
952,B3-09.築地永谷コーポラス,8,4,12,35.66523,139.776313,2024-02-08 16:00:04
953,E4-10.白山四丁目第二児童遊園横,6,3,9,35.720349,139.746924,2024-02-08 16:00:04
954,I1-03.大井町駅中央口（西側）,6,0,6,35.605617,139.73472,2024-02-08 16:00:04
955,I1-04.大井町歩道橋,4,0,4,35.605146,139.734694,2024-02-08 16:00:04
956,I1-01.品川区役所 本庁舎前,10,0,10,35.609052,139.729825,2024-02-08 16:00:04
957,I1-02.品川区役所 第三庁舎前,9,0,9,35.608161,139.730048,2024-02-08 16:00:04
958,G4-08.ブオンサンヴァレンティーノ,3,0,3,35.691677,139.793857,2024-02-08 16:00:04
959,J1-13.洗足二丁目駐輪場,13,3,16,35.61061,139.693443,2024-02-08 16:00:04
960,J1-16.八雲橋自転車置場,3,2,5,35.617353,139.672256,2024-02-08 16:00:04
961,H1-189.MFLP新木場2,0,40,40,35.634453,139.824,2024-02-08 16:00:04
962,M6-09.ファミリーマート渋谷本町店,0,9,9,35.683756,139.684965,2024-02-08 16:00:04
963,H1-113.123+N東雲店,7,6,13,35.646366,139.801492,2024-02-08 16:00:04
964,J1-17.ファミリーマート原町二丁目店,1,5,6,35.613902,139.691476,2024-02-08 16:00:04
965,E5-21.動坂公園,6,0,6,35.73176,139.756669,2024-02-08 16:00:04
966,E5-20.本郷2丁目,0,9,9,35.704391,139.758575,2024-02-08 16:00:04
967,T2-48.武蔵関駅南第二自転車駐車場,3,1,4,35.726064,139.578015,2024-02-08 16:00:04
968,A6-26.相互半蔵門ビル,9,2,11,35.683378,139.743189,2024-02-08 16:00:04
969,J1-31.守屋図書館,14,6,20,35.634194,139.688833,2024-02-08 16:00:04
970,M3-19.渋谷キャスト,21,0,21,35.662146,139.702793,2024-02-08 16:00:04
971,N1-04.都立家政南駐輪場,0,8,8,35.721679,139.645265,2024-02-08 16:00:04
972,N2-02.江古田1丁目A,1,2,3,35.724988,139.672511,2024-02-08 16:00:04
973,C1-56.鈴与竹芝ビル,0,5,5,35.654873,139.762103,2024-02-08 16:00:04
974,D3-07.戸塚特別出張所,4,3,7,35.71429,139.70507,2024-02-08 16:00:04
975,G4-12.プレミアムキューブ両国,3,4,7,35.70103,139.803341,2024-02-08 16:00:04
976,A2-21.神田神保町3丁目,6,0,6,35.694578,139.754434,2024-02-08 16:00:04
977,B4-19.コーシャタワー佃,0,14,14,35.668044,139.785801,2024-02-08 16:00:04
978,I1-81.戸越6丁目,20,0,20,35.608127,139.717865,2024-02-08 16:00:04
979,A6-24.国立劇場,0,15,15,35.682218,139.743292,2024-02-08 16:00:04
980,E5-23.ビレッジ千駄木,1,5,6,35.722353,139.760966,2024-02-08 16:00:04
981,H1-119.榎戸材木店,0,22,22,35.638319,139.834741,2024-02-08 16:00:04
982,C5-29.Hi-NODE(ハイノード),7,1,8,35.651672,139.760549,2024-02-08 16:00:04
983,J1-22.NTTコミュニケーションズ唐ヶ崎ビル,0,2,2,35.627373,139.692044,2024-02-08 16:00:04
984,A2-18.猿楽町SSビル東,6,0,6,35.698654,139.759762,2024-02-08 16:00:04
985,A2-19.猿楽町SSビル西,0,1,1,35.698641,139.759306,2024-02-08 16:00:04
986,C1-55.アーバンネット内幸町ビル,17,2,19,35.669267,139.756018,2024-02-08 16:00:04
987,D4-06.グリーンフォート河田,0,8,8,35.697143,139.718739,2024-02-08 16:00:04
988,K1-134.東調布公園,6,3,9,35.588363,139.69042,2024-02-08 16:00:04
989,M5-18.Luxe初台,2,0,2,35.679182,139.68596,2024-02-08 16:00:04
990,D7-06.エムアイセミナーハウス,4,0,4,35.721064,139.677128,2024-02-08 16:00:04
991,A3-37.ポータル秋葉原,0,11,11,35.695737,139.78162,2024-02-08 16:00:04
992,M5-11.あおい通り,7,1,8,35.688154,139.698975,2024-02-08 16:00:04
993,E5-04.保健サービスセンター本郷支所,1,3,4,35.727046,139.760439,2024-02-08 16:00:04
994,E5-03.汐見地域活動センター（本郷図書館）,0,5,5,35.725538,139.76116,2024-02-08 16:00:04
995,E5-01.文京総合体育館,28,3,31,35.708121,139.763583,2024-02-08 16:00:04
996,E4-01.千石南自転車駐車場,11,14,25,35.72707,139.746112,2024-02-08 16:00:04
997,E3-03.大塚公園,6,15,21,35.724286,139.730954,2024-02-08 16:00:04
998,E3-02.教育の森公園,5,12,17,35.719345,139.736198,2024-02-08 16:00:04
999,I1-25.セブン-イレブン 品川旗の台2丁目店,1,2,3,35.607084,139.705007,2024-02-08 16:00:04
1000,B1-21.日本橋二丁目街角広場,1,10,11,35.680861,139.774493,2024-02-08 16:00:04
1001,C3-30.東京赤坂NKビル (ヴィアインプライム赤坂),9,0,9,35.672652,139.738908,2024-02-08 16:00:04
1002,A3-36.クロックカフェ東神田,0,5,5,35.694943,139.782718,2024-02-08 16:00:04
1003,E1-14.いきいき礫川,3,1,4,35.711147,139.747386,2024-02-08 16:00:04
1004,D4-09.トミンハイム仲之町,0,13,13,35.69617,139.722021,2024-02-08 16:00:04
1005,L1-08.NTT砧ビル,1,5,6,35.63534,139.601602,2024-02-08 16:00:04
1006,L1-09.コージーK・駒沢,3,0,3,35.632689,139.654804,2024-02-08 16:00:04
1007,L1-10.宮坂2-4-10,0,7,7,35.652913,139.644825,2024-02-08 16:00:04
1008,I1-22.ウィラ大井 (ショッピングモール),0,5,5,35.596579,139.745009,2024-02-08 16:00:04
1009,K1-76.グリーンベルト,6,0,6,35.585178,139.726339,2024-02-08 16:00:04
1010,H1-121.南砂5丁目,0,23,23,35.676603,139.829736,2024-02-08 16:00:04
1011,M3-02.文化総合センター大和田,3,2,5,35.65558,139.69966,2024-02-08 16:00:04
1012,D4-04.ジェノヴィア新宿早稲田グリーンヴェール,5,0,5,35.700033,139.71983,2024-02-08 16:00:04
1013,A3-20.神田ふれあい通り第２,1,1,2,35.695005,139.772747,2024-02-08 16:00:04
1014,H1-120.豊洲5丁目,16,0,16,35.650948,139.799711,2024-02-08 16:00:04
1015,C5-42.DHC芝浦2丁目ビル,7,0,7,35.644241,139.753834,2024-02-08 16:00:04
1016,I1-65.セブン-イレブン品川東大井1丁目店,6,0,6,35.605996,139.743037,2024-02-08 16:00:04
1017,M2-04.広尾東公園,5,1,6,35.653382,139.721059,2024-02-08 16:00:04
1018,M3-13.渋谷駅東口地下駐輪場,19,0,19,35.657682,139.703307,2024-02-08 16:00:04
1019,A3-19.神田ふれあい通り第１,1,4,5,35.694904,139.772712,2024-02-08 16:00:04
1020,O6-07.ローソン杉並宮前一丁目店,1,3,4,35.689639,139.613516,2024-02-08 16:00:04
1021,T3-10.貫井一丁目緑地,1,2,3,35.736378,139.632485,2024-02-08 16:00:04
1022,M2-05.日本赤十字医療センター,0,10,10,35.65519,139.718559,2024-02-08 16:00:04
1023,T2-20.パークサイド石神井,0,8,8,35.741769,139.591103,2024-02-08 16:00:04
1024,N4-06.ローソン中野本町新橋通り店,0,5,5,35.695819,139.674326,2024-02-08 16:00:04
1025,T3-07.徳殿公園,4,0,4,35.726728,139.65874,2024-02-08 16:00:04
1026,K1-35.セブン-イレブン 大田区西六郷2丁目店,0,2,2,35.549778,139.707362,2024-02-08 16:00:04
1027,A3-27.秋葉原駅中央口（ヨドバシカメラ前）,6,3,9,35.698986,139.774099,2024-02-08 16:00:04
1028,A3-28.秋葉原駅電気街口(西側交通広場),5,0,5,35.699173,139.772629,2024-02-08 16:00:04
1029,H1-57.新木場駅,54,0,54,35.64508,139.826456,2024-02-08 16:00:04
1030,H1-58.潮見駅,0,23,23,35.658703,139.817251,2024-02-08 16:00:04
1031,D7-02.セブン-イレブン 新宿中落合3丁目店,0,10,10,35.722202,139.691712,2024-02-08 16:00:04
1032,D2-06.飯田濠,7,4,11,35.70057,139.74301,2024-02-08 16:00:04
1033,C5-17.鈴与浜松町ビル,3,7,10,35.651103,139.759092,2024-02-08 16:00:04
1034,H1-59.LYURO 東京清澄,0,9,9,35.681316,139.792176,2024-02-08 16:00:04
1035,H1-60.荒川・砂町庭球場西,0,25,25,35.679678,139.844892,2024-02-08 16:00:04
1036,K1-44.中馬込貝塚公園,4,1,5,35.594795,139.704951,2024-02-08 16:00:04
1037,M6-11.京王サイクルパーク笹塚,1,4,5,35.674337,139.668801,2024-02-08 16:00:04
1038,J1-49.伊勢脇公園,3,1,4,35.638864,139.696568,2024-02-08 16:00:04
1039,K1-45.たぬき山公園,4,2,6,35.592801,139.715472,2024-02-08 16:00:04
1040,D2-01.あずさセンタービル,10,8,18,35.702286,139.741093,2024-02-08 16:00:04
1041,C1-02.西新橋1丁目（外堀通り）,4,1,5,35.668791,139.753582,2024-02-08 16:00:04
1042,O3-07.NTT井草ビル第1ポート,2,1,3,35.714044,139.61688,2024-02-08 16:00:04
1043,T2-41.ローソン 練馬東大泉五丁目店,0,4,4,35.74248,139.58715,2024-02-08 16:00:04
1044,H1-144.南砂住宅,0,8,8,35.674199,139.822018,2024-02-08 16:00:04
1045,C3-28.ヒューリックＪＰ赤坂ビル,6,4,10,35.672477,139.739743,2024-02-08 16:00:04
1046,H1-145.東雲都橋住宅,0,0,0,35.643131,139.797784,2024-02-08 16:00:04
1047,I1-58.品川区役所　第二庁舎前,18,0,18,35.609664,139.730006,2024-02-08 16:00:04
1048,K1-92.蒲田駅西口自転車駐車場,23,0,23,35.561101,139.715173,2024-02-08 16:00:04
1049,A2-24.水道橋駅西口前,6,0,6,35.702271,139.752619,2024-02-08 16:00:04
1050,K1-94.昭和島駅前,0,23,23,35.572188,139.749613,2024-02-08 16:00:04
1051,M5-15.新宿マインズタワー,14,6,20,35.686567,139.699355,2024-02-08 16:00:04
1052,D7-13.日本光電本社南側,13,1,14,35.71936,139.679083,2024-02-08 16:00:04
1053,N3-09.中野区役所(北側),0,5,5,35.708259,139.663829,2024-02-08 16:00:04
1054,H1-163.森下公園,3,0,3,35.68663,139.799529,2024-02-08 16:00:04
1055,B4-23.交通広場（豊海町）,0,9,9,35.653771,139.769295,2024-02-08 16:00:04
1056,D6-18.ヨドバシカメラ 新宿西口本店前,5,1,6,35.689689,139.698231,2024-02-08 16:00:04
1057,I1-47.NTT 東日本 関東病院(南側),4,3,7,35.630151,139.725215,2024-02-08 16:00:04
1058,H1-112.ファミリーマート江東塩浜二丁目店,2,0,2,35.66305,139.8087,2024-02-08 16:00:04
1059,K1-103.雪谷特別出張所,0,8,8,35.594515,139.691219,2024-02-08 16:00:04
1060,E5-17.Village藍染,0,3,3,35.720896,139.76422,2024-02-08 16:00:04
1061,I1-49.京急鮫洲バイク駐輪場,6,0,6,35.603815,139.741362,2024-02-08 16:00:04
1062,I1-50.京急立会川第2バイク駐輪場,5,0,5,35.599196,139.739158,2024-02-08 16:00:04
1063,E4-14.NTT東日本大塚ビル,0,16,16,35.726188,139.741375,2024-02-08 16:00:04
1064,M2-07.ファミリーマート恵比寿駅東店,7,0,7,35.6471,139.712818,2024-02-08 16:00:04
1065,M4-07.千駄ヶ谷駅前,2,0,2,35.68082,139.71188,2024-02-08 16:00:04
1066,O5-07.バーンホーフ キクチ,9,11,20,35.698169,139.655665,2024-02-08 16:00:04
1067,J1-11.コンフォリア目黒青葉台,0,6,6,35.649023,139.696086,2024-02-08 16:00:04
1068,L1-14.給田3丁目,0,13,13,35.664335,139.590114,2024-02-08 16:00:04
1069,B4-06.月島駅地下駐輪場,3,13,16,35.66291,139.782564,2024-02-08 16:00:04
1070,C5-09.グランパーク,19,0,19,35.643202,139.746244,2024-02-08 16:00:04
1071,C5-08.AQUACITY芝浦,3,0,3,35.637366,139.74844,2024-02-08 16:00:04
1072,C3-08.赤坂パークビルヂング,5,0,5,35.671792,139.733668,2024-02-08 16:00:04
1073,C3-07.新青山ビル,14,2,16,35.672659,139.725644,2024-02-08 16:00:04
1074,C3-06.ホテルアジア会館,2,7,9,35.67064,139.728166,2024-02-08 16:00:04
1075,C1-24.三田国際ビル,0,17,17,35.653159,139.744673,2024-02-08 16:00:04
1076,C5-07.港区立港南図書館,5,1,6,35.632842,139.7495,2024-02-08 16:00:04
1077,A3-04.秋葉原公園,0,14,14,35.697642,139.774867,2024-02-08 16:00:04
1078,A3-05.和泉公園（西側入口）,3,2,5,35.698817,139.778898,2024-02-08 16:00:04
1079,A3-02.絶滅メディア博物館（楓ビル）,7,1,8,35.689575,139.767848,2024-02-08 16:00:04
1080,O3-10.メゾンパークス,7,1,8,35.716265,139.618954,2024-02-08 16:00:04
1081,A2-05.神田橋公園,0,3,3,35.689665,139.764091,2024-02-08 16:00:04
1082,A3-01.神田児童公園（西側交番横）,5,1,6,35.692983,139.76773,2024-02-08 16:00:04
1083,A2-03.西神田公園（西側）,4,0,4,35.698338,139.754876,2024-02-08 16:00:04
1084,M6-03.十三号通り公園,0,8,8,35.675198,139.663587,2024-02-08 16:00:04
1085,M6-02.サイカパーク笹塚,1,6,7,35.673444,139.666553,2024-02-08 16:00:04
1086,H1-165.亀戸梅屋敷,0,8,8,35.701318,139.825916,2024-02-08 16:00:04
1087,H1-166.亀戸クロック,12,6,18,35.696574,139.82972,2024-02-08 16:00:04
1088,M5-02.あいおいニッセイ同和損保新宿ビル,3,2,5,35.684423,139.692262,2024-02-08 16:00:04
1089,M6-01.幡ヶ谷駅高架下第一,23,14,37,35.677175,139.676769,2024-02-08 16:00:04
1090,A5-02.山王パークタワー,0,5,5,35.673555,139.741293,2024-02-08 16:00:04
1091,K1-116.旧呑川緑地（大森東五丁目）,9,2,11,35.567176,139.742345,2024-02-08 16:00:04
1092,K1-115.旧呑川緑地（大森中三丁目）,0,5,5,35.565685,139.736195,2024-02-08 16:00:04
1093,K1-114.下丸子公園,8,0,8,35.568722,139.680736,2024-02-08 16:00:04
1094,T3-05.東武練馬駅南,2,7,9,35.767129,139.664365,2024-02-08 16:00:04
1095,T1-14.ファミリーマート 練馬高松五丁目北店,4,0,4,35.761038,139.623148,2024-02-08 16:00:04
1096,C3-29.高橋是清翁記念公園,5,1,6,35.674094,139.728895,2024-02-08 16:00:04
1097,K1-141.蒲田駅西口歩道,3,0,3,35.561291,139.715076,2024-02-08 16:00:04
1098,C3-35.ワールド北青山ビル,17,0,17,35.667069,139.713423,2024-02-08 16:00:04
1099,M5-03.代々木大山公園,15,0,15,35.671282,139.675307,2024-02-08 16:00:04
1100,E5-13.弥生二丁目,4,0,4,35.715592,139.76192,2024-02-08 16:00:04
1101,E5-12.NK本郷ビル,0,4,4,35.704475,139.763041,2024-02-08 16:00:04
1102,B3-18.銀座松竹スクエア,8,2,10,35.668395,139.769849,2024-02-08 16:00:04
1103,C1-44.三田Avanti,4,0,4,35.64115,139.741471,2024-02-08 16:00:04
1104,T2-31.ファミリーマート 石神井台二丁目店,0,4,4,35.739488,139.590273,2024-02-08 16:00:04
1105,H1-150.ホテルヴィラフォンテーヌ南側,8,1,9,35.636978,139.791858,2024-02-08 16:00:04
1106,H1-149.有明ガーデン 公園口,6,0,6,35.639132,139.793047,2024-02-08 16:00:04
1107,H1-148.大島七丁目団地,0,15,15,35.694104,139.840278,2024-02-08 16:00:04
1108,B4-26.東武ストア晴海三丁目店,10,1,11,35.654371,139.779545,2024-02-08 16:00:04
1109,J1-26.田向公園,6,0,6,35.623459,139.687128,2024-02-08 16:00:04
1110,J1-25.碑文谷公園,3,3,6,35.625081,139.682632,2024-02-08 16:00:04
1111,H1-195.東京アクアティクスセンター,7,12,19,35.65238,139.815613,2024-02-08 16:00:04
1112,T1-13.ファミリーマート 練馬土支田二丁目店,0,9,9,35.761613,139.61349,2024-02-08 16:00:04
1113,T2-34.ファミリーマート 練馬富士見台店,0,5,5,35.73969,139.62125,2024-02-08 16:00:04
1114,T2-35.ファミリーマート 石神井台六丁目店,0,4,4,35.738607,139.585331,2024-02-08 16:00:04
1115,C1-81.田町タワー,19,1,20,35.646534,139.748913,2024-02-08 16:00:04
1116,J1-07.目黒川船入場,13,2,15,35.641992,139.701588,2024-02-08 16:00:04
1117,J1-08.目黒区民センター公園,14,2,16,35.634533,139.708868,2024-02-08 16:00:04
1118,D4-01.市谷仲之町,4,0,4,35.695102,139.723345,2024-02-08 16:00:04
1119,M2-11.鉢山町,15,1,16,35.652151,139.698426,2024-02-08 16:00:04
1120,E4-08.ドコモ・バイクシェア向丘ポート,0,9,9,35.720546,139.756685,2024-02-08 16:00:04
1121,D4-03.市谷加賀町2丁目,0,0,0,35.695636,139.727882,2024-02-08 16:00:04
1122,N1-01.BeGood野方,0,10,10,35.719717,139.64785,2024-02-08 16:00:04
1123,C2-03.アークヒルズサウスタワー,7,3,10,35.666357,139.73923,2024-02-08 16:00:04
1124,C2-01.アークヒルズ（アーク森ビル）,7,4,11,35.667107,139.739565,2024-02-08 16:00:04
1125,C2-02.六本木ヒルズ,17,3,20,35.661158,139.728533,2024-02-08 16:00:04
1126,C5-03.港南公園C,0,29,29,35.624966,139.746657,2024-02-08 16:00:04
1127,C5-04.みなとパーク芝浦,10,0,10,35.646801,139.751208,2024-02-08 16:00:04
1128,C1-16.機械振興会館,3,3,6,35.659442,139.745549,2024-02-08 16:00:04
1129,C1-14.新橋プラザビル,3,0,3,35.664461,139.756082,2024-02-08 16:00:04
1130,H1-73.イシマビル,1,1,2,35.67386,139.79976,2024-02-08 16:00:04
1131,O7-01.西永福公園,4,1,5,35.67753,139.63667,2024-02-08 16:00:04
1132,O6-02.富士見ヶ丘南自転車駐車場,6,2,8,35.68296,139.60861,2024-02-08 16:00:04
1133,K1-50.テクノポートカマタ 第1,5,1,6,35.556199,139.721476,2024-02-08 16:00:04
1134,J1-14.二の橋自転車置場1,39,0,39,35.614856,139.678208,2024-02-08 16:00:04
1135,O3-08.NTT井草ビル第２ポート,2,1,3,35.714077,139.61694,2024-02-08 16:00:04
1136,H1-124.セブン-イレブン 江東海辺店,7,3,10,35.680636,139.817977,2024-02-08 16:00:04
1137,D1-11.三井ガーデンホテル神宮外苑の杜プレミア,3,2,5,35.679807,139.715931,2024-02-08 16:00:04
1138,O7-07.ハレ永福,2,6,8,35.678913,139.639944,2024-02-08 16:00:04
1139,C5-32.トレードピアお台場,1,3,4,35.627891,139.776896,2024-02-08 16:00:04
1140,B4-18.豊海センタービル,0,5,5,35.653531,139.769431,2024-02-08 16:00:04
1141,D5-04.西戸山公園野球場,2,5,7,35.707388,139.700204,2024-02-08 16:00:04
1142,D5-03.北新宿公園,0,12,12,35.702288,139.68862,2024-02-08 16:00:04
1143,D3-04.鶴巻南公園,0,18,18,35.706182,139.723394,2024-02-08 16:00:04
1144,D3-03.甘泉園公園,0,7,7,35.712431,139.715418,2024-02-08 16:00:04
1145,K1-03.池上会館,0,7,7,35.576593,139.706597,2024-02-08 16:00:04
1146,K1-02.平和の森公園,12,2,14,35.579049,139.739878,2024-02-08 16:00:04
1147,K1-01.大森海苔のふるさと館,0,11,11,35.57685,139.742496,2024-02-08 16:00:04
1148,D6-13.新宿中央公園（ジャブジャブ池下）,5,4,9,35.687652,139.689254,2024-02-08 16:00:04
1149,T2-28.ファミリーマート 南大泉六丁目店,3,2,5,35.752217,139.571095,2024-02-08 16:00:04
1150,K1-05.平和島公園プール,9,8,17,35.581832,139.741581,2024-02-08 16:00:04
1151,K1-04.京急蒲田駅東口,15,1,16,35.559483,139.724273,2024-02-08 16:00:04
1152,E2-10.音羽パークロード（北入口）,13,0,13,35.716586,139.727705,2024-02-08 16:00:04
1153,E2-11.音羽パークロード（キャッチボール場横）,17,1,18,35.715382,139.728533,2024-02-08 16:00:04
1154,I1-21.大井競馬場(正門前),10,0,10,35.593887,139.741204,2024-02-08 16:00:04
1155,J1-27.衾町公園,1,0,1,35.623215,139.668472,2024-02-08 16:00:04
1156,T2-44.中島橋自転車駐車場,5,2,7,35.75372,139.584332,2024-02-08 16:00:04
1157,B3-15.ACホテル・バイ・マリオット東京銀座,4,3,7,35.668845,139.765144,2024-02-08 16:00:04
1158,D5-07.百人町1丁目,3,2,5,35.699252,139.697606,2024-02-08 16:00:04
1159,C4-04.ショパン高輪,0,2,2,35.632128,139.732097,2024-02-08 16:00:04
1160,B1-18.セブン-イレブン 日本橋小網町店,2,1,3,35.681352,139.781436,2024-02-08 16:00:04
1161,T2-71.わかば児童公園,4,3,7,35.7211,139.574669,2024-02-08 16:00:04
1162,M3-15.co-ba ebisu,2,4,6,35.647076,139.703964,2024-02-08 16:00:04
1163,C2-20.三井ガーデンホテル六本木プレミア,3,0,3,35.66206,139.735501,2024-02-08 16:00:04
1164,I1-70.五反田リバーステーション,2,5,7,35.624566,139.72448,2024-02-08 16:00:04
1165,E5-25.ジェノヴィア東大前グリーンヴェール,10,0,10,35.711875,139.759306,2024-02-08 16:00:04
1166,D1-12.ジェノヴィア新宿御苑グリーンヴェール,3,3,6,35.689017,139.714755,2024-02-08 16:00:04
1167,C5-33.msb Tamachi,24,8,32,35.645682,139.748768,2024-02-08 16:00:04
1168,G4-09.SYFORME MORISHITA Ⅱ 1,1,0,1,35.690348,139.796133,2024-02-08 16:00:04
1169,G4-10.SYFORME MORISHITA Ⅱ 2,4,0,4,35.690307,139.796128,2024-02-08 16:00:04
1170,N3-19.上高田パーキング,0,17,17,35.715878,139.673669,2024-02-08 16:00:04
1171,F6-01.松坂屋上野店,3,2,5,35.707305,139.773657,2024-02-08 16:00:04
1172,F4-01.SYFORME ASAKUSA,2,2,4,35.718832,139.791133,2024-02-08 16:00:04
1173,F2-02.アップルパーク浅草6丁目第3,0,3,3,35.716062,139.799552,2024-02-08 16:00:04
1174,F2-01.松が谷2丁目2,1,19,20,35.71283,139.787754,2024-02-08 16:00:04
1175,F1-02.台東デザイナーズビレッジ,2,5,7,35.706023,139.783751,2024-02-08 16:00:04
1176,F2-03.台東区生涯学習センター,1,5,6,35.717497,139.790055,2024-02-08 16:00:04
1177,K1-146.南馬込6丁目25-11,2,0,2,35.582743,139.710561,2024-02-08 16:00:04
1178,F3-01.清川1丁目18-11,0,17,17,35.724944,139.801684,2024-02-08 16:00:04
1179,F1-03.新御徒町駅自転車駐車場,3,12,15,35.706793,139.782985,2024-02-08 16:00:04
1180,F3-02.台東区リバーサイドスポーツセンター,0,7,7,35.717571,139.804216,2024-02-08 16:00:04
1181,I1-45.セブン-イレブン品川西五反田3丁目店,3,2,5,35.62541,139.718135,2024-02-08 16:00:04
1182,H1-135.北砂5丁目団地,0,26,26,35.684218,139.832843,2024-02-08 16:00:04
1183,C3-16.赤坂ガーデンシティ,0,6,6,35.6738,139.731525,2024-02-08 16:00:04
1184,J1-34.田道広場公園,8,0,8,35.636269,139.709073,2024-02-08 16:00:04
1185,O5-08.セシオン杉並,0,3,3,35.69714,139.65432,2024-02-08 16:00:04
1186,A2-04.ちよだプラットフォームスクウェア,6,4,10,35.691456,139.762228,2024-02-08 16:00:04
1187,I1-102.J.GRAN Court 品川西大井 EAST,4,1,5,35.598244,139.722447,2024-02-08 16:00:04
1188,H1-196.フットサルクラブ東京東陽町,5,1,6,35.665288,139.824294,2024-02-08 16:00:04
1189,F2-04.コンフォラス浅草マンション,1,2,3,35.717241,139.801674,2024-02-08 16:00:04
1190,G5-03.京成リッチモンドホテル東京錦糸町,3,0,3,35.693492,139.81506,2024-02-08 16:00:04
1191,K1-27.六郷文化センター,3,0,3,35.544715,139.707623,2024-02-08 16:00:04
1192,K1-147.トヨタモビリティ東京GRGarage東京蒲田店,2,0,2,35.552741,139.718404,2024-02-08 16:00:04
1193,K1-148.トヨタモビリティ東京 蒲田仲六郷店,5,1,6,35.552068,139.71747,2024-02-08 16:00:04
1194,K1-150.トヨタモビリティ東京 池上第二京浜店,1,4,5,35.568019,139.696379,2024-02-08 16:00:04
1195,K1-149.トヨタモビリティ東京 大田店,4,0,4,35.59336,139.715879,2024-02-08 16:00:04
1196,C1-82.トヨタモビリティ東京 港三田店,5,0,5,35.647831,139.739048,2024-02-08 16:00:04
1197,D4-11.トヨタモビリティ東京 新宿明治通り南店,2,0,2,35.699835,139.70808,2024-02-08 16:00:04
1198,C3-31.赤坂一丁目,12,5,17,35.670239,139.744285,2024-02-08 16:00:04
1199,E1-04.礫川公園,26,15,41,35.707853,139.751518,2024-02-08 16:00:04
1200,M3-23.円山町7-1,2,6,8,35.658229,139.694885,2024-02-08 16:00:04
1201,M3-24.渋谷道玄坂２丁目駐輪場,3,15,18,35.66026,139.69684,2024-02-08 16:00:04
1202,T3-32.練馬北町1丁目,1,4,5,35.764452,139.666299,2024-02-08 16:00:04
1203,H1-197.セブン-イレブン江東南砂葛西橋通り店,3,0,3,35.675361,139.825034,2024-02-08 16:00:04
1204,T2-84.石神井町二丁目緑地,0,3,3,35.748395,139.605958,2024-02-08 16:00:04
1205,T2-82.梅の木児童遊園,0,5,5,35.737899,139.576584,2024-02-08 16:00:04
1206,T2-83.西大泉さくら緑地,5,3,8,35.760442,139.573145,2024-02-08 16:00:04
1207,D7-05.西落合図書館,7,1,8,35.725818,139.678976,2024-02-08 16:00:04
1208,D6-28.東急ステイ新宿,0,4,4,35.690899,139.706348,2024-02-08 16:00:04
1209,T2-85.泉新公園,3,1,4,35.7547,139.601497,2024-02-08 16:00:04
1210,T2-86.石神井町八丁目緑地,2,1,3,35.746956,139.600798,2024-02-08 16:00:04
1211,T2-87.南大泉四丁目児童遊園,0,4,4,35.745607,139.573947,2024-02-08 16:00:04
1212,T2-88.南大泉かたまち緑地,0,4,4,35.739633,139.570457,2024-02-08 16:00:04
1213,T2-89.南大泉三丁目児童遊園,0,3,3,35.742755,139.568335,2024-02-08 16:00:04
1214,E2-05.護国寺駅西自転車駐車場,21,2,23,35.719421,139.725584,2024-02-08 16:00:04
1215,J1-59.第44興和ビル,3,0,3,35.647704,139.693671,2024-02-08 16:00:04
1216,C1-15.東京タワー,10,6,16,35.65928,139.744767,2024-02-08 16:00:04
1217,C5-20.ローソン芝浦二丁目店,4,0,4,35.645254,139.754765,2024-02-08 16:00:04
1218,C2-27.有栖川宮記念公園第一,17,0,17,35.651382,139.724392,2024-02-08 16:00:04
1219,C2-28.有栖川宮記念公園第二,4,4,8,35.651129,139.726003,2024-02-08 16:00:04
1220,C2-29.狸穴公園,4,0,4,35.658204,139.738935,2024-02-08 16:00:04
1221,T2-90.南田中四丁目緑地,2,2,4,35.733195,139.612327,2024-02-08 16:00:04
1222,T2-91.石神井町四丁目緑地,4,1,5,35.745272,139.604579,2024-02-08 16:00:04
1223,A3-41.秋葉原ダイビル,4,2,6,35.698917,139.771856,2024-02-08 16:00:04
1224,J1-54.田道住区センター三田分室,2,3,5,35.638904,139.712518,2024-02-08 16:00:04
1225,H1-140.キャナルパレス住吉,12,2,14,35.689896,139.815116,2024-02-08 16:00:04
1226,C1-57.虎ノ門ツインビルディング,0,14,14,35.667259,139.745643,2024-02-08 16:00:04
1227,K1-54.ファミリーマート大田久が原五丁目店,1,4,5,35.579435,139.698552,2024-02-08 16:00:04
1228,B1-29.ASTILE日本橋浜町,4,1,5,35.685504,139.790817,2024-02-08 16:00:04
1229,N3-20.SYFORME NAKANO-SAKAUE,3,2,5,35.701157,139.679617,2024-02-08 16:00:04
1230,D6-31.東急歌舞伎町タワー駐輪場,6,3,9,35.696207,139.700521,2024-02-08 16:00:04
1231,I1-30.ローソン 大井三丁目店,6,0,6,35.603327,139.729006,2024-02-08 16:00:04
1232,K1-151.PATH仲六郷,10,0,10,35.549465,139.711157,2024-02-08 16:00:04
1233,H1-198.Br Tower 有明 MID CROSS,2,4,6,35.63464,139.783445,2024-02-08 16:00:04
1234,H1-04.石と光の広場（国際展示場駅）,39,22,61,35.63363,139.79082,2024-02-08 16:00:04
1235,B4-24.ミュプレ月島,6,1,7,35.66288,139.78329,2024-02-08 16:00:04
1236,H1-199.ラ・ヴェール東陽町,6,1,7,35.664244,139.814506,2024-02-08 16:00:04
1237,H1-200.ヴェッセル木場南,0,5,5,35.662414,139.813333,2024-02-08 16:00:04
1238,F1-04.台東2丁目21,0,5,5,35.703465,139.780325,2024-02-08 16:00:04
1239,F3-03.ヴェルステージ南千住,0,5,5,35.728704,139.801867,2024-02-08 16:00:04
1240,J1-46.五本木西みどり街かど公園,0,5,5,35.632735,139.683899,2024-02-08 16:00:04
1241,K1-131.東急武蔵新田駅駐輪場,11,3,14,35.567146,139.693344,2024-02-08 16:00:04
1242,K1-152.アットホームスクエア前,0,9,9,35.543327,139.703223,2024-02-08 16:00:04
1243,B2-04.清水建設本社（都営地下鉄宝町駅 Ａ８出口）,7,9,16,35.676119,139.772895,2024-02-08 16:00:04
1244,H1-202.辰巳の森海浜公園,6,6,12,35.648107,139.813572,2024-02-08 16:00:04
1245,H1-201.ウエリスアーバン水天宮前2,4,1,5,35.678099,139.791831,2024-02-08 16:00:04
1246,I1-103.五反田ＪＰビルディング,3,0,3,35.622389,139.721552,2024-02-08 16:00:04
1247,L1-16.上祖師谷7丁目,13,1,14,35.65838,139.59231,2024-02-08 16:00:04
1248,O5-09.AppCruise中野,1,1,2,35.700772,139.66063,2024-02-08 16:00:04
1249,H1-203.セブン-イレブン江東木場３丁目店,0,0,0,35.67517,139.804087,2024-02-08 16:00:04
1250,H1-44.テプコ豊洲ビル,16,0,16,35.648726,139.790877,2024-02-08 16:00:04
1251,L1-17.赤堤3丁目,3,4,7,35.659787,139.636696,2024-02-08 16:00:04
1252,L1-18.上北沢1丁目,21,9,30,35.662796,139.626795,2024-02-08 16:00:04
1253,B3-16.明石町区民館,0,17,17,35.666001,139.778102,2024-02-08 16:00:04
1254,I1-104.源氏前ビル,5,0,5,35.603521,139.712345,2024-02-08 16:00:04
1255,J1-28.宮前公園,0,2,2,35.617699,139.664826,2024-02-08 16:00:04
1256,M6-18.セブン-イレブン渋谷本町3丁目店,2,1,3,35.686521,139.685017,2024-02-08 16:00:04
1257,O7-08.杉並区和泉2-3-17,0,4,4,35.67187,139.65474,2024-02-08 16:00:04
1258,T1-17.セブン-イレブン練馬田柄通店,6,1,7,35.75987,139.640474,2024-02-08 16:00:04
1259,H1-18.東京ビッグサイト,7,9,16,35.631192,139.79401,2024-02-08 16:00:04
1260,M3-01.渋谷マークシティ,10,2,12,35.657726,139.697802,2024-02-08 16:00:04
1261,H1-70.有明スポーツセンター,13,4,17,35.63403,139.784319,2024-02-08 16:00:04
1262,H1-41.深川北スポーツセンター,1,12,13,35.676475,139.804741,2024-02-08 16:00:04
1263,H1-55.深川江戸資料館,3,5,8,35.681089,139.800777,2024-02-08 16:00:04
1264,I1-61.五反田文化センター,2,5,7,35.622588,139.716159,2024-02-08 16:00:04
1265,N3-13.中部すこやか福祉センター,3,2,5,35.700052,139.673715,2024-02-08 16:00:04
1266,A4-02.東京サンケイビル,1,9,10,35.686847,139.765151,2024-02-08 16:00:04
1267,M3-09.ティップ.クロス TOKYO 渋谷,10,9,19,35.661475,139.699296,2024-02-08 16:00:04
1268,B3-02.サンクンガーデン,2,4,6,35.670336,139.771911,2024-02-08 16:00:04
1269,T2-10.勤労福祉会館,5,0,5,35.748153,139.58765,2024-02-08 16:00:04
1270,K1-133.東京港野鳥公園,13,0,13,35.584217,139.759232,2024-02-08 16:00:04
1271,K1-21.六郷特別出張所,0,5,5,35.55079,139.716517,2024-02-08 16:00:04
1272,H1-54.砂町文化センター,3,17,20,35.680052,139.831874,2024-02-08 16:00:04
1273,D1-08.新宿歴史博物館,3,1,4,35.689984,139.725261,2024-02-08 16:00:04
1274,E1-05.春日地下自転車駐車場,22,4,26,35.708291,139.753335,2024-02-08 16:00:04
1275,E1-15.播磨坂事業所,4,0,4,35.71724,139.74289,2024-02-08 16:00:04
1276,E5-02.不忍通りふれあい館,0,12,12,35.719356,139.764308,2024-02-08 16:00:04
1277,E4-02.向丘地域活動センター,8,5,13,35.717357,139.757817,2024-02-08 16:00:04
1278,C3-18.明治記念館,5,0,5,35.678509,139.721207,2024-02-08 16:00:04
1279,D5-05.中央図書館,13,2,15,35.705018,139.706841,2024-02-08 16:00:04
1280,E2-07.肥後細川庭園,10,3,13,35.713223,139.721699,2024-02-08 16:00:04
1281,A1-05.富士見出張所,0,5,5,35.699187,139.746348,2024-02-08 16:00:04
1282,E5-07.湯島三丁目児童遊園,3,5,8,35.707296,139.769393,2024-02-08 16:00:04
1283,D5-10.桜美林大学 新宿キャンパス,2,4,6,35.705154,139.697562,2024-02-08 16:00:04
1284,A3-08.神田明神（神田神社）,11,2,13,35.702029,139.768245,2024-02-08 16:00:04
1285,E2-14.永青文庫 ミュージアム,5,0,5,35.713145,139.723342,2024-02-08 16:00:04
1286,M5-17.小田急サザンタワー,8,0,8,35.6866,139.70014,2024-02-08 16:00:04
1287,K1-16.ファミリーマート 矢口二丁目店,6,0,6,35.563092,139.693548,2024-02-08 16:00:04
1288,H1-206.北砂5丁目団地2,0,8,8,35.683866,139.831809,2024-02-08 16:00:04
1289,G1-02.八広駅高架下,4,10,14,35.727495,139.828499,2024-02-08 16:00:04
1290,F4-02.Risingplace浅草四番館,0,4,4,35.717963,139.791025,2024-02-08 16:00:04
1291,H1-204.大島四丁目団地2,5,1,6,35.68832,139.828829,2024-02-08 16:00:04
1292,H1-205.大島四丁目団地3,7,2,9,35.688236,139.827711,2024-02-08 16:00:04
1293,H1-106.亀戸中央公園,11,7,18,35.699874,139.834263,2024-02-08 16:00:04
1294,E5-30.湯島3丁目15,1,9,10,35.705148,139.769314,2024-02-08 16:00:04
1295,B4-38.HARUMI FLAG SUN VILLAGE,0,22,22,35.650347,139.771785,2024-02-08 16:00:04
1296,B4-32.HARUMI FLAG SEA VILLAGE,1,10,11,35.648731,139.774995,2024-02-08 16:00:04
1297,B4-31.HARUMI FLAG PORT VILLAGE,0,19,19,35.650604,139.77724,2024-02-08 16:00:04
1298,B4-33.HARUMI FLAG SEA VILLAGE,0,15,15,35.649552,139.776369,2024-02-08 16:00:04
1299,B4-36.HARUMI FLAG SEA VILLAGE,3,9,12,35.650742,139.778097,2024-02-08 16:00:04
1300,B4-35.HARUMI FLAG SEA VILLAGE,2,10,12,35.650573,139.777908,2024-02-08 16:00:04
1301,B4-37.HARUMI FLAG SUN VILLAGE,0,16,16,35.649419,139.771447,2024-02-08 16:00:04
1302,B4-34.HARUMI FLAG SEA VILLAGE,3,9,12,35.649932,139.776958,2024-02-08 16:00:04
1303,B4-39.HARUMI FLAG SUN VILLAGE,0,17,17,35.650863,139.772549,2024-02-08 16:00:04
1304,B4-40.HARUMI FLAG SUN VILLAGE,0,19,19,35.651305,139.773379,2024-02-08 16:00:04
1305,B4-41.HARUMI FLAG SUN VILLAGE,0,17,17,35.649854,139.77334,2024-02-08 16:00:04
1306,B4-42.HARUMI FLAG SUN VILLAGE,0,12,12,35.649329,139.772656,2024-02-08 16:00:04
1307,B4-28.HARUMI FLAG PORT VILLAGE,0,12,12,35.651183,139.776119,2024-02-08 16:00:04
1308,B4-50.HARUMI FLAG PARK VILLAGE,1,8,9,35.648295,139.773973,2024-02-08 16:00:04
1309,B4-49.HARUMI FLAG PARK VILLAGE,6,10,16,35.648636,139.774251,2024-02-08 16:00:04
1310,B4-48.HARUMI FLAG PARK VILLAGE,0,4,4,35.649513,139.775287,2024-02-08 16:00:04
1311,B4-47.HARUMI FLAG PARK VILLAGE,2,4,6,35.649119,139.775138,2024-02-08 16:00:04
1312,B4-46.HARUMI FLAG PARK VILLAGE,0,26,26,35.649642,139.773859,2024-02-08 16:00:04
1313,B4-45.HARUMI FLAG PARK VILLAGE,0,27,27,35.649002,139.772764,2024-02-08 16:00:04
1314,B4-44.HARUMI FLAG PARK VILLAGE,3,10,13,35.648221,139.772666,2024-02-08 16:00:04
1315,B4-30.HARUMI FLAG PORT VILLAGE,2,9,11,35.651136,139.778218,2024-02-08 16:00:04
1316,B4-29.HARUMI FLAG PORT VILLAGE,0,11,11,35.651907,139.777391,2024-02-08 16:00:04
1317,L1-19.三軒茶屋1丁目駐輪場,1,3,4,35.639302,139.674744,2024-02-08 16:00:04
1318,O7-09.方南月極パーキング,8,9,17,35.678921,139.658289,2024-02-08 16:00:04
1319,O5-10.ローソン ツルハドラッグ杉並和田店,1,3,4,35.68942,139.662118,2024-02-08 16:00:04
1320,O2-04.西荻北1丁目,2,3,5,35.708082,139.607543,2024-02-08 16:00:04
1321,K1-75.三井不動産インダストリアルパーク羽田,3,7,10,35.556231,139.751408,2024-02-08 16:00:04
1322,F1-05.ホウエイコート秋葉原,0,1,1,35.703024,139.78052,2024-02-08 16:00:04
1323,C3-36.第35興和ビル,2,1,3,35.666349,139.741781,2024-02-08 16:00:04
1324,B4-53.晴海五丁目ターミナル,27,79,106,35.651627,139.773103,2024-02-08 16:00:04
1325,C5-44.ブランズタワー芝浦,9,0,9,35.643105,139.753039,2024-02-08 16:00:04
1326,A3-47.ホテルヴィラフォンテーヌ東京大手町,13,0,13,35.690602,139.766916,2024-02-08 16:00:04
1327,A1-20.菱和パレス九段,5,0,5,35.693021,139.740317,2024-02-08 16:00:04
0,E5-26.本郷4丁目,2,1,3,35.708596,139.758269,2024-02-08 17:31:03
1,A3-42.内神田3丁目,15,19,34,35.692599,139.770109,2024-02-08 17:31:03
2,T2-76.東中前の森緑地,3,2,5,35.748736,139.574839,2024-02-08 17:31:03
3,A2-20.神田スクエア,10,7,17,35.693408,139.762809,2024-02-08 17:31:03
4,K1-79.Tマークシティホテル東京大森,7,0,7,35.586993,139.736491,2024-02-08 17:31:03
5,K1-80.大森北6丁目,3,1,4,35.579849,139.731241,2024-02-08 17:31:03
6,H1-130.トヨタモビリティ東京 深川店,7,2,9,35.676643,139.816054,2024-02-08 17:31:03
7,H1-131.セブン-イレブン 江東佐賀2丁目店,3,0,3,35.679029,139.793535,2024-02-08 17:31:03
8,H1-132.セブン-イレブン 江東三好4丁目店,0,5,5,35.681418,139.809287,2024-02-08 17:31:03
9,A6-22.半蔵門PREX South,7,6,13,35.683433,139.740756,2024-02-08 17:31:03
10,I1-74.セブン-イレブン西五反田6丁目店,0,2,2,35.622403,139.71771,2024-02-08 17:31:03
11,G2-01.東京ソラマチ,5,1,6,35.709777,139.810189,2024-02-08 17:31:03
12,T2-59.平成公園,2,1,3,35.722917,139.587864,2024-02-08 17:31:03
13,Z15.ファミリーマート藤崎一丁目店,4,2,6,35.52928,139.722762,2024-02-08 17:31:03
14,I1-26.大崎西口公園,0,21,21,35.617475,139.729221,2024-02-08 17:31:03
15,I1-96.西五反田２丁目,10,0,10,35.627599,139.720463,2024-02-08 17:31:03
16,H1-172.サンヨーパシフィックマンション,0,4,4,35.668856,139.794069,2024-02-08 17:31:03
17,J1-56.青葉台四丁目街かど公園,3,0,3,35.654009,139.692727,2024-02-08 17:31:03
18,H1-173.森下駅前,39,0,39,35.687837,139.79654,2024-02-08 17:31:03
19,E3-01.大塚地域活動センター跡地,5,5,10,35.718656,139.734556,2024-02-08 17:31:03
20,E2-03.目白台運動公園,39,1,40,35.715556,139.721988,2024-02-08 17:31:03
21,T2-77.大泉なかよし緑地,4,0,4,35.759861,139.581682,2024-02-08 17:31:03
22,E2-01.江戸川橋Ｂ自転車駐車場,52,27,79,35.710381,139.732137,2024-02-08 17:31:03
23,E2-02.江戸川公園,18,1,19,35.710958,139.731165,2024-02-08 17:31:03
24,D7-14.大栄パーク西落合１丁目,6,0,6,35.720028,139.678936,2024-02-08 17:31:03
25,E1-07.礫川地域活動センター,8,0,8,35.712015,139.750284,2024-02-08 17:31:03
26,M6-05.七号通り公園,2,5,7,35.67917,139.67493,2024-02-08 17:31:03
27,H1-138.HW.HILLS新大橋,9,1,10,35.687416,139.795588,2024-02-08 17:31:03
28,B4-21.月島駅前第一駐輪場,8,19,27,35.663681,139.785651,2024-02-08 17:31:03
29,N2-03.野方1丁目,6,1,7,35.712179,139.65603,2024-02-08 17:31:03
30,C5-52.港南四丁目第3アパート駐車場,11,0,11,35.630109,139.747094,2024-02-08 17:31:03
31,E5-27.真正館駐車場,1,2,3,35.714875,139.76394,2024-02-08 17:31:03
32,C5-35.品川駅港南口,6,0,6,35.62822,139.741135,2024-02-08 17:31:03
33,N2-01.NTT野方ビル,3,2,5,35.710285,139.66173,2024-02-08 17:31:03
34,D6-27.新宿三井ビルディング二号館,1,8,9,35.686334,139.692881,2024-02-08 17:31:03
35,D1-10.曙橋駐輪場,14,1,15,35.691888,139.724365,2024-02-08 17:31:03
36,I1-39.MID POINT 目黒不動前,2,1,3,35.628116,139.713149,2024-02-08 17:31:03
37,E3-07.小日向1丁目,5,0,5,35.713388,139.737009,2024-02-08 17:31:03
38,C1-47.パークプレイス三田,9,0,9,35.641791,139.740734,2024-02-08 17:31:03
39,I1-38.ローソン 八潮三丁目店,6,38,44,35.594544,139.760423,2024-02-08 17:31:03
40,C2-24.Dash Living HigashiAzabu,6,0,6,35.655135,139.744449,2024-02-08 17:31:03
41,J1-04.菅刈公園,4,4,8,35.650351,139.692853,2024-02-08 17:31:03
42,O4-09.ローソン杉並本天沼一丁目店,1,2,3,35.712496,139.632778,2024-02-08 17:31:03
43,T3-29.平和台もものき緑地,1,2,3,35.755773,139.661913,2024-02-08 17:31:03
44,D2-10.市谷砂土原町3丁目,10,0,10,35.696242,139.735776,2024-02-08 17:31:03
45,C1-48.竹芝客船ターミナル,0,15,15,35.655139,139.762812,2024-02-08 17:31:03
46,B1-06.伊場仙ビル,0,4,4,35.687624,139.777125,2024-02-08 17:31:03
47,B2-01.鉄砲洲児童公園（西側）,2,3,5,35.67224,139.779348,2024-02-08 17:31:03
48,B1-04.産業会館,3,0,3,35.694164,139.787057,2024-02-08 17:31:03
49,B1-05.日本橋保健センター,0,8,8,35.687419,139.779053,2024-02-08 17:31:03
50,B2-05.ＮＴＴ東日本築地ビル,0,1,1,35.670674,139.775993,2024-02-08 17:31:03
51,B2-02.柳通り（東京スクエアガーデン前）,0,19,19,35.676393,139.768319,2024-02-08 17:31:03
52,B2-03.男女平等センター（ブーケ21）,7,2,9,35.673923,139.778671,2024-02-08 17:31:03
53,C2-13.麻布運動場,6,0,6,35.651718,139.728165,2024-02-08 17:31:03
54,D2-08.旧市ヶ谷商業高校,1,4,5,35.70074,139.731363,2024-02-08 17:31:03
55,C1-35.セブン-イレブン 三田駅北店,4,1,5,35.649032,139.750147,2024-02-08 17:31:03
56,B4-12.THE TOKYO TOWERS,0,4,4,35.655497,139.774556,2024-02-08 17:31:03
57,C5-21.セブン-イレブン 芝浦3丁目店,3,0,3,35.642399,139.746992,2024-02-08 17:31:03
58,H1-67.セブン-イレブン 江東亀戸9丁目店,5,9,14,35.69766,139.843408,2024-02-08 17:31:03
59,C2-15.住友不動産六本木グランドタワー,0,32,32,35.664367,139.737185,2024-02-08 17:31:03
60,C2-14.元麻布ヒルズ,3,7,10,35.653608,139.73138,2024-02-08 17:31:03
61,M6-14.ドコモショップ笹塚店,1,2,3,35.67323,139.66393,2024-02-08 17:31:03
62,N4-07.南台2丁目,11,0,11,35.68509,139.671102,2024-02-08 17:31:03
63,K1-68.ART FACTORY 城南島,0,13,13,35.580511,139.775957,2024-02-08 17:31:03
64,H1-178.北砂7丁目団地(第二),1,3,4,35.678031,139.837193,2024-02-08 17:31:03
65,H1-179.北砂7丁目団地(第三),5,6,11,35.678246,139.8366,2024-02-08 17:31:03
66,A1-17.雉子橋集積所,6,0,6,35.692605,139.755761,2024-02-08 17:31:03
67,H1-177.北砂7丁目団地(第一),1,4,5,35.678537,139.837391,2024-02-08 17:31:03
68,K1-95.城南島海浜公園,10,6,16,35.578259,139.783505,2024-02-08 17:31:03
69,B3-17.銀座6丁目-SQUARE,0,20,20,35.66711,139.76643,2024-02-08 17:31:03
70,J1-33.芳窪街かど公園,13,0,13,35.629861,139.666293,2024-02-08 17:31:03
71,N3-07.なかのZERO,4,1,5,35.70442,139.67141,2024-02-08 17:31:03
72,N4-04.弥生町5丁目,8,4,12,35.690897,139.668345,2024-02-08 17:31:03
73,A3-44.THE WAVES AKIHABARA,2,0,2,35.694679,139.779504,2024-02-08 17:31:03
74,K1-138.羽田エアポートガーデン,0,10,10,35.544534,139.763244,2024-02-08 17:31:03
75,C3-26.ホテルリブマックス赤坂,0,3,3,35.67011,139.733375,2024-02-08 17:31:03
76,C1-52.NTT三田ビル,3,3,6,35.652549,139.747789,2024-02-08 17:31:03
77,D1-07.Dash Living Shinjuku,0,0,0,35.689757,139.710091,2024-02-08 17:31:03
78,O4-07.ローソン成田西三丁目店,1,4,5,35.690311,139.62178,2024-02-08 17:31:03
79,H1-152.コンポジット亀戸ウエスト,0,5,5,35.699187,139.82429,2024-02-08 17:31:03
80,E1-13.エルアージュ小石川,6,1,7,35.71399,139.75137,2024-02-08 17:31:03
81,B4-22.リビオレゾン勝どきNEX,3,2,5,35.65554,139.77102,2024-02-08 17:31:03
82,H1-176.JMFビル東陽町02,0,11,11,35.667677,139.823552,2024-02-08 17:31:03
83,H1-102.ファミリーマート東砂七丁目店,6,1,7,35.672714,139.837914,2024-02-08 17:31:03
84,H1-101.ファミリーマート新木場一丁目店,0,13,13,35.642571,139.836766,2024-02-08 17:31:03
85,K1-67.京浜島防災広場,0,36,36,35.570508,139.764013,2024-02-08 17:31:03
86,K1-66.昭和島二丁目公園,0,16,16,35.575097,139.751446,2024-02-08 17:31:03
87,Z11.ファミリーマートＭＧ川崎昭和店,1,3,4,35.528868,139.737762,2024-02-08 17:31:03
88,I1-80.リバーサイド品川港南ビル,8,2,10,35.622714,139.74471,2024-02-08 17:31:03
89,J1-10.NTTデータ駒場研修センター,11,0,11,35.655779,139.680948,2024-02-08 17:31:03
90,A2-17.竹橋ビル,0,9,9,35.692396,139.75639,2024-02-08 17:31:03
91,H1-91.亀戸駅北口第三自転車駐車場,16,2,18,35.696913,139.823911,2024-02-08 17:31:03
92,H1-92.亀戸駅東口第二自転車駐車場,5,9,14,35.69788,139.830559,2024-02-08 17:31:03
93,K1-59.京急梅屋敷第1駐車場,7,0,7,35.565768,139.727396,2024-02-08 17:31:03
94,K1-60.京急平和島第1駐車場,9,0,9,35.576336,139.733691,2024-02-08 17:31:03
95,I1-42.京急青横駐車場,2,1,3,35.611582,139.742528,2024-02-08 17:31:03
96,I1-43.京急南大井駐車場,8,0,8,35.594722,139.737101,2024-02-08 17:31:03
97,Z01.NTTドコモ川崎ビル,0,8,8,35.528801,139.694661,2024-02-08 17:31:03
98,O7-05.ジーベック方南町,1,1,2,35.680849,139.65626,2024-02-08 17:31:03
99,H1-100.URアーバンライフ亀戸,27,2,29,35.697935,139.821855,2024-02-08 17:31:03
100,A6-10.紀尾井町ビル（西側）,6,6,12,35.682516,139.736494,2024-02-08 17:31:03
101,C3-02.赤坂地区総合支所,0,6,6,35.674788,139.731423,2024-02-08 17:31:03
102,C2-08.ファミリーマート西麻布霞町店,0,2,2,35.661673,139.721118,2024-02-08 17:31:03
103,A6-09.紀尾井町ビル（北側）,2,4,6,35.682902,139.736494,2024-02-08 17:31:03
104,H1-28.有明客船ターミナル,5,6,11,35.630063,139.792209,2024-02-08 17:31:03
105,B1-12.ファミリーマート堀留町二丁目店,0,14,14,35.687786,139.78205,2024-02-08 17:31:03
106,H1-26.青海客船ターミナル,0,18,18,35.619234,139.774485,2024-02-08 17:31:03
107,H1-27.パレットタウン乗船場,10,0,10,35.624467,139.781305,2024-02-08 17:31:03
108,K1-121.東京広域ポート（川崎LiSE）,3,7,10,35.540579,139.754506,2024-02-08 17:31:03
109,K1-122.東急新丸子駅駐輪場,8,5,13,35.581347,139.662265,2024-02-08 17:31:03
110,K1-123.東急新丸子駅（東）駐輪場,9,3,12,35.577794,139.660751,2024-02-08 17:31:03
111,O1-04.井草1-34,9,6,15,35.72758,139.62432,2024-02-08 17:31:03
112,C1-76.浜松町駅北口交通広場(ハマサイト前),10,3,13,35.656647,139.758301,2024-02-08 17:31:03
113,J1-52.駒沢一丁目公園前,8,1,9,35.629807,139.662398,2024-02-08 17:31:03
114,C1-75.虎ノ門PFビル,0,13,13,35.665466,139.748014,2024-02-08 17:31:03
115,B2-18.旭ビルディング,6,5,11,35.678291,139.78157,2024-02-08 17:31:03
116,N2-09.松山駐車場No.1,2,4,6,35.722991,139.673048,2024-02-08 17:31:03
117,I1-82.トミンハイム西五反田四丁目,4,2,6,35.627386,139.711182,2024-02-08 17:31:03
118,O4-03.ザ・ハウス,0,12,12,35.707035,139.633066,2024-02-08 17:31:03
119,O4-04.阿佐谷南3-43,14,2,16,35.704147,139.631955,2024-02-08 17:31:03
120,K1-83.北千束北児童公園,5,1,6,35.611085,139.68599,2024-02-08 17:31:03
121,I1-95.東京レールゲート EAST,0,17,17,35.584998,139.761055,2024-02-08 17:31:03
122,M5-19.グランリヴィエール代々木,1,5,6,35.68285,139.698528,2024-02-08 17:31:03
123,Z14.ファミリーマート川崎中瀬店,7,2,9,35.537163,139.729625,2024-02-08 17:31:03
124,H1-192.ウエリスアーバン水天宮前,4,0,4,35.678296,139.791949,2024-02-08 17:31:03
125,N2-08.江古田区民活動センター,2,2,4,35.728893,139.670119,2024-02-08 17:31:03
126,D7-04.セブン-イレブン 新宿下落合3丁目店,3,0,3,35.722645,139.701982,2024-02-08 17:31:03
127,Z16.ファミリーマート川崎浜町四丁目店,3,4,7,35.515344,139.722229,2024-02-08 17:31:03
128,K1-82.西蒲田公園,5,2,7,35.561499,139.71123,2024-02-08 17:31:03
129,H1-68.芝浦工業大学附属中学高等学校,12,0,12,35.649274,139.792213,2024-02-08 17:31:03
130,K1-24.東糀谷防災公園,0,30,30,35.557074,139.74575,2024-02-08 17:31:03
131,H1-03.東雲駅,0,28,28,35.640736,139.804331,2024-02-08 17:31:03
132,K1-26.大森諏訪公園,0,3,3,35.574785,139.730762,2024-02-08 17:31:03
133,K1-25.鶴渡公園,2,1,3,35.56892,139.725082,2024-02-08 17:31:03
134,N3-10.エーエスホームズⅡ駐車場,2,4,6,35.702659,139.662563,2024-02-08 17:31:03
135,J1-37.中目黒公園,15,3,18,35.640398,139.704069,2024-02-08 17:31:03
136,A1-10.ヒューリック九段ビル,0,7,7,35.696449,139.750784,2024-02-08 17:31:03
137,K1-93.六間堀仲羽公園,1,3,4,35.548864,139.74484,2024-02-08 17:31:03
138,T2-53.上練馬公園,2,2,4,35.772863,139.626969,2024-02-08 17:31:03
139,M5-01.初台駅南口,8,4,12,35.680154,139.685937,2024-02-08 17:31:03
140,C1-60.専売ビル,11,2,13,35.647659,139.745055,2024-02-08 17:31:03
141,K1-85.大田区青少年交流センター ゆいっつ,0,8,8,35.583555,139.743381,2024-02-08 17:31:03
142,I1-64.株式会社ユアス ゆうパック取扱所：ポストのうしろ,1,9,10,35.622965,139.731014,2024-02-08 17:31:03
143,C4-09.ケーヨーデイツー三田店,3,0,3,35.646375,139.740061,2024-02-08 17:31:03
144,C1-61.環三浜松町駅南,17,21,38,35.653096,139.75739,2024-02-08 17:31:03
145,K1-84.佐伯山緑地,7,6,13,35.581698,139.71491,2024-02-08 17:31:03
146,C1-59.セレスティン芝三井ビルディング,7,1,8,35.650845,139.748346,2024-02-08 17:31:03
147,G2-07.レオーネ押上cube,3,1,4,35.706167,139.815955,2024-02-08 17:31:03
148,E1-06.文京シビックセンター,9,10,19,35.708265,139.751983,2024-02-08 17:31:03
149,D2-13.THE CENTER TOKYO,5,0,5,35.695646,139.725722,2024-02-08 17:31:03
150,E5-22.千駄木2丁目,2,3,5,35.724828,139.762583,2024-02-08 17:31:03
151,C4-07.品川プリンスホテル,10,0,10,35.628266,139.734171,2024-02-08 17:31:03
152,A3-43.unito CHIYODA,2,1,3,35.69474,139.77929,2024-02-08 17:31:03
153,C4-06.白金プラチナレジデンス,0,8,8,35.644134,139.723432,2024-02-08 17:31:03
154,I1-63.セブン-イレブン西五反田店,0,3,3,35.62765,139.719212,2024-02-08 17:31:03
155,H1-53.豊洲シビックセンター,4,12,16,35.653991,139.795513,2024-02-08 17:31:03
156,T3-16.練馬区役所東庁舎(第一),8,2,10,35.735428,139.652379,2024-02-08 17:31:03
157,T2-68.さくら原っぱ緑地,2,3,5,35.731372,139.619164,2024-02-08 17:31:03
158,T2-69.久保新田さくら公園,1,3,4,35.76525,139.575978,2024-02-08 17:31:03
159,H1-187.森下文化センター,5,0,5,35.685344,139.80234,2024-02-08 17:31:03
160,E4-04.セブン-イレブン 文京本駒込１丁目店,5,0,5,35.724707,139.750469,2024-02-08 17:31:03
161,M2-13.恵比寿プライムスクエアタワー南,7,1,8,35.649257,139.713272,2024-02-08 17:31:03
162,H1-48.セブン-イレブン 江東潮見２丁目店,0,9,9,35.658249,139.815775,2024-02-08 17:31:03
163,H1-51.豊洲交通広場　東,0,32,32,35.654958,139.795718,2024-02-08 17:31:03
164,H1-52.辰巳駅,0,82,82,35.646756,139.809295,2024-02-08 17:31:03
165,D7-01.下落合図書館,10,4,14,35.715894,139.698578,2024-02-08 17:31:03
166,H1-50.豊洲交通広場　北,0,51,51,35.655457,139.795161,2024-02-08 17:31:03
167,A6-14.MG市ヶ谷ビルディング,0,4,4,35.690861,139.736393,2024-02-08 17:31:03
168,T2-21.ファミリーマート 練馬大泉町一丁目店,2,2,4,35.768448,139.601679,2024-02-08 17:31:03
169,A6-15.東急番町ビル,2,3,5,35.688929,139.7358,2024-02-08 17:31:03
170,A1-18.東京区政会館別館(特別区研修所),1,4,5,35.696202,139.752351,2024-02-08 17:31:03
171,T3-18.練馬駅北,6,13,19,35.738585,139.653396,2024-02-08 17:31:03
172,C1-43.KDX浜松町プレイス,0,6,6,35.658169,139.752509,2024-02-08 17:31:03
173,C5-27.プレミア海岸ビル,16,0,16,35.648948,139.757895,2024-02-08 17:31:03
174,I1-29.ローソン 勝島一丁目店,0,14,14,35.599987,139.745195,2024-02-08 17:31:03
175,H1-72.ネクストサイト深川ビル,18,0,18,35.674578,139.797396,2024-02-08 17:31:03
176,T1-11.むつみ台,0,6,6,35.768528,139.639807,2024-02-08 17:31:03
177,T1-10.月見大橋下,2,2,4,35.758366,139.628982,2024-02-08 17:31:03
178,H1-167.大島八丁目公園,10,0,10,35.688074,139.838932,2024-02-08 17:31:03
179,K1-36.セブン-イレブン 大田区南雪谷5丁目店,4,1,5,35.587815,139.691748,2024-02-08 17:31:03
180,L1-01.羽根木公園,6,6,12,35.66088,139.654546,2024-02-08 17:31:03
181,P1-02.雑司ヶ谷一丁目,8,0,8,35.721738,139.723103,2024-02-08 17:31:03
182,I1-66.南大井文化センター駐車場,5,0,5,35.596733,139.73804,2024-02-08 17:31:03
183,L1-05.NTT烏山ビル,0,4,4,35.669285,139.597931,2024-02-08 17:31:03
184,L1-04.下馬中央公園,4,1,5,35.63367,139.678139,2024-02-08 17:31:03
185,L1-03.世田谷城阯公園,2,4,6,35.645838,139.647799,2024-02-08 17:31:03
186,L1-02.若林公園,6,1,7,35.647075,139.654472,2024-02-08 17:31:03
187,T2-30.ファミリーマート 練馬東大泉四丁目店,3,1,4,35.750804,139.58243,2024-02-08 17:31:03
188,L1-07.NTT成城ビル,2,1,3,35.648021,139.606529,2024-02-08 17:31:03
189,L1-06.NTT瀬田ビル,0,11,11,35.618357,139.626191,2024-02-08 17:31:03
190,T3-12.春日町西公園,4,0,4,35.748092,139.636587,2024-02-08 17:31:03
191,T3-13.平和台児童公園,2,2,4,35.757298,139.664139,2024-02-08 17:31:03
192,T2-38.ファミリーマート 練馬上石神井四丁目店,4,5,9,35.727195,139.590179,2024-02-08 17:31:03
193,B1-28.アイルイムーブル日本橋,6,3,9,35.684502,139.77906,2024-02-08 17:31:03
194,A2-28.NTTコミュニケーションズ一ツ橋ビル駐車場,3,5,8,35.6915,139.75685,2024-02-08 17:31:03
195,C3-32.乃木公園,3,2,5,35.667936,139.72745,2024-02-08 17:31:03
196,T3-14.わらべ児童遊園,2,2,4,35.759774,139.654529,2024-02-08 17:31:03
197,T2-52.田柄中央児童公園,4,1,5,35.762395,139.641522,2024-02-08 17:31:03
198,M4-06.THE SHARE 原宿,8,2,10,35.671823,139.708158,2024-02-08 17:31:03
199,K1-10.セブン‐イレブン 大田区西糀谷１丁目店,4,0,4,35.559647,139.730098,2024-02-08 17:31:03
200,K1-09.セブン‐イレブン 大田区西蒲田２丁目店,0,17,17,35.570763,139.705895,2024-02-08 17:31:03
201,H1-63.東京スイソミル,8,0,8,35.65637,139.811765,2024-02-08 17:31:03
202,B1-16.小網町児童遊園,0,5,5,35.683695,139.780043,2024-02-08 17:31:03
203,H1-61.Brilliaランニングスタジアムマギーズ東京前,0,11,11,35.648281,139.786112,2024-02-08 17:31:03
204,K1-08.セブン‐イレブン 大田区東蒲田キネマ通り店,5,0,5,35.562368,139.730143,2024-02-08 17:31:03
205,C1-34.城山ガーデン,0,13,13,35.664479,139.743731,2024-02-08 17:31:03
206,H1-62.扇橋一丁目公園南,13,5,18,35.683343,139.812161,2024-02-08 17:31:03
207,J1-23.清水池公園,22,0,22,35.623756,139.692517,2024-02-08 17:31:03
208,C5-18.パークタワー品川ベイワード,19,0,19,35.634529,139.748378,2024-02-08 17:31:03
209,E4-07.ファミリーマート 本駒込二丁目店,3,1,4,35.727279,139.74627,2024-02-08 17:31:03
210,C5-45.パークアクシス芝浦キャナル,9,0,9,35.644794,139.755688,2024-02-08 17:31:03
211,A2-02.西神田公園（北側）,5,3,8,35.698591,139.755113,2024-02-08 17:31:03
212,T2-49.善福寺公園テニスクラブ,5,4,9,35.719674,139.593696,2024-02-08 17:31:03
213,H1-193.ライフ豊洲店,26,0,26,35.651833,139.79962,2024-02-08 17:31:03
214,A2-01.神田駿河台下,51,2,53,35.695762,139.761585,2024-02-08 17:31:03
215,I1-51.京急鈴ヶ森駐車場,8,1,9,35.589573,139.735585,2024-02-08 17:31:03
216,T2-36.サントピア テニスパーク,6,4,10,35.75195,139.616028,2024-02-08 17:31:03
217,G4-13. Parking in 両国駅前第2,1,2,3,35.696492,139.791591,2024-02-08 17:31:03
218,K1-120.蒲田駅消費者生活センター横自転車駐車場 屋上部,6,0,6,35.560125,139.71569,2024-02-08 17:31:03
219,N3-18.藤和シティコープ新中野3,6,0,6,35.69942,139.673964,2024-02-08 17:31:03
220,K1-145.トヨタモビリティ東京馬込テクニカル研修センター,12,1,13,35.58209,139.701362,2024-02-08 17:31:03
221,K1-100.多摩川台公園,5,0,5,35.589794,139.666955,2024-02-08 17:31:03
222,C1-54.ニッセイ虎ノ門ビル,2,9,11,35.664344,139.746662,2024-02-08 17:31:03
223,I1-52.カスタリアタワー品川シーサイド,8,0,8,35.607557,139.746866,2024-02-08 17:31:03
224,I1-53.天王洲公園,0,8,8,35.620355,139.749339,2024-02-08 17:31:03
225,C2-18.ブランシェ東麻布,2,0,2,35.656769,139.743224,2024-02-08 17:31:03
226,A3-45.鍛冶町2丁目,16,0,16,35.691578,139.77138,2024-02-08 17:31:03
227,H1-87.パークアクシス木場キャナルウエスト,3,2,5,35.662514,139.803694,2024-02-08 17:31:03
228,D6-20.淀橋けやき橋公園,5,10,15,35.693544,139.685806,2024-02-08 17:31:03
229,A3-46.神田須田町2丁目,0,0,0,35.695457,139.772972,2024-02-08 17:31:03
230,B3-13.国立がん研究センター,9,2,11,35.664871,139.767188,2024-02-08 17:31:03
231,I1-35.シーフォートスクエア,0,16,16,35.622954,139.750593,2024-02-08 17:31:03
232,K1-55.カバヤビル,16,1,17,35.576275,139.713704,2024-02-08 17:31:03
233,C3-24.SHARE GREEN 南青山 西エントランス,0,7,7,35.668419,139.724676,2024-02-08 17:31:03
234,A5-06.APA HOTEL PRIDE〈国会議事堂前〉,9,1,10,35.674468,139.741328,2024-02-08 17:31:03
235,A6-17.東京ガーデンテラス紀尾井町（プリンス通り側）,8,3,11,35.680431,139.738203,2024-02-08 17:31:03
236,B4-07.勝どき駅地下駐輪場,52,8,60,35.658135,139.776131,2024-02-08 17:31:03
237,B4-08.東京ミッドベイ勝どき（西仲通り）,15,1,16,35.656449,139.771302,2024-02-08 17:31:03
238,B3-04.築地市場駅地下駐輪場,17,0,17,35.664265,139.767426,2024-02-08 17:31:03
239,C5-10.シーバンス,0,18,18,35.649959,139.756068,2024-02-08 17:31:03
240,H1-34.門前仲町駅,48,2,50,35.67391,139.796165,2024-02-08 17:31:03
241,C3-10.ファミリーマート特許庁前店,0,19,19,35.670364,139.744684,2024-02-08 17:31:03
242,A1-01.千代田区役所,2,4,6,35.693799,139.753281,2024-02-08 17:31:03
243,A1-03.東京区政会館（メトロA5出口）,0,8,8,35.701073,139.747525,2024-02-08 17:31:03
244,B3-06.朝日新聞東京本社,0,17,17,35.664457,139.767214,2024-02-08 17:31:03
245,A1-04.東京区政会館（西側駐輪場）,3,4,7,35.701347,139.746951,2024-02-08 17:31:03
246,T1-03.四季の香公園,5,0,5,35.760585,139.626284,2024-02-08 17:31:03
247,T1-04.春の風公園,3,0,3,35.75731,139.624922,2024-02-08 17:31:03
248,T1-05.夏の雲公園,4,1,5,35.753964,139.629116,2024-02-08 17:31:03
249,H1-194.セブン-イレブン江東北砂5丁目店,4,0,4,35.68268,139.8353,2024-02-08 17:31:03
250,O5-03.新高円寺地下自転車駐輪場,6,7,13,35.697265,139.649397,2024-02-08 17:31:03
251,O3-06.アミーズ荻窪,3,1,4,35.714616,139.625116,2024-02-08 17:31:03
252,T2-03.リヴィンオズ大泉店,7,1,8,35.752383,139.594855,2024-02-08 17:31:03
253,O6-06.上高井戸1丁目,1,6,7,35.673055,139.611293,2024-02-08 17:31:03
254,T2-05.石神井図書館,4,0,4,35.736076,139.599676,2024-02-08 17:31:03
255,T2-06.総合体育館,3,0,3,35.748957,139.621385,2024-02-08 17:31:03
256,O5-02.馬橋ハイツ,5,1,6,35.705686,139.642587,2024-02-08 17:31:03
257,N1-07.プランドール上鷺宮,2,5,7,35.733292,139.630369,2024-02-08 17:31:03
258,E1-18.アーバネックス小石川春日,8,0,8,35.709261,139.746374,2024-02-08 17:31:03
259,T3-03.新桜台駅自転車駐車場,5,2,7,35.740378,139.667502,2024-02-08 17:31:03
260,O3-05.Nちゃりパーク,10,13,23,35.70389,139.6185,2024-02-08 17:31:03
261,O5-01.朝霞ハイツ,10,1,11,35.71038,139.64519,2024-02-08 17:31:03
262,L1-11.アイムタウン上祖師谷,2,1,3,35.656849,139.594422,2024-02-08 17:31:03
263,L1-12.鈴木リースホーム駐車場,13,1,14,35.646648,139.633038,2024-02-08 17:31:03
264,L1-13.わびさびホステル,3,0,3,35.647393,139.667085,2024-02-08 17:31:03
265,G2-05.リアナスカイパーク押上,6,0,6,35.715733,139.815451,2024-02-08 17:31:03
266,T3-02.早宮第二自転車駐車場,6,5,11,35.756846,139.652154,2024-02-08 17:31:03
267,I1-37.ガーデンシティ品川御殿山,5,4,9,35.623466,139.734359,2024-02-08 17:31:03
268,T2-47.上石神井駅北第二自転車駐車場,6,4,10,35.726523,139.5905,2024-02-08 17:31:03
269,C1-51.環二新橋四丁目,9,0,9,35.663843,139.757697,2024-02-08 17:31:03
270,M6-07.笹塚東,20,0,20,35.675436,139.670594,2024-02-08 17:31:03
271,M3-10.ウノサワ東急ビル,5,3,8,35.647757,139.712981,2024-02-08 17:31:03
272,C2-26.一の橋公園,6,1,7,35.655367,139.738075,2024-02-08 17:31:03
273,H1-14.ホテルリブマックス東京潮見駅前,4,1,5,35.658351,139.818229,2024-02-08 17:31:03
274,D2-12.ヴィアイン飯田橋後楽園,3,1,4,35.705774,139.743366,2024-02-08 17:31:03
275,D3-08.ホテルリブマックス高田馬場駅前,6,2,8,35.712952,139.701356,2024-02-08 17:31:03
276,H1-103.清澄庭園,10,0,10,35.680948,139.796917,2024-02-08 17:31:03
277,H1-104.木場公園,15,0,15,35.676488,139.809616,2024-02-08 17:31:03
278,H1-105.猿江恩賜公園,6,2,8,35.692277,139.817491,2024-02-08 17:31:03
279,G4-07.ディアレイシャス両国,3,1,4,35.69955,139.803204,2024-02-08 17:31:03
280,T2-46.大泉郵便局バス停自転車駐車場,1,8,9,35.766491,139.587232,2024-02-08 17:31:03
281,I1-18.東品川公園,6,0,6,35.61379,139.746617,2024-02-08 17:31:03
282,J1-03.西郷山公園,6,0,6,35.650688,139.696696,2024-02-08 17:31:03
283,J1-02.駒場野公園,11,3,14,35.657718,139.681043,2024-02-08 17:31:03
284,D2-14.ローソン 神楽坂駅北店,0,6,6,35.704201,139.735815,2024-02-08 17:31:03
285,K1-65.下丸子3丁目,5,7,12,35.571711,139.685337,2024-02-08 17:31:03
286,T2-43.学園通り自転車駐車場,8,0,8,35.7547,139.5871,2024-02-08 17:31:03
287,I1-46.セブン-イレブン 品川東中延2丁目店,1,0,1,35.608721,139.714158,2024-02-08 17:31:03
288,T2-04.石神井公園駅南口,0,10,10,35.743354,139.606592,2024-02-08 17:31:03
289,J1-06.観音橋自転車置場,16,29,45,35.642251,139.69692,2024-02-08 17:31:03
290,J1-05.東山公園　北,0,9,9,35.64853,139.686309,2024-02-08 17:31:03
291,J1-45.プラウド中目黒,2,0,2,35.63767,139.7045,2024-02-08 17:31:03
292,H1-168.大島五丁目公園,13,0,13,35.68642,139.836151,2024-02-08 17:31:03
293,J1-47.本町みなみ街かど公園,12,5,17,35.61847,139.70019,2024-02-08 17:31:03
294,J1-48.グランドエクセル祐天寺,0,12,12,35.64372,139.68777,2024-02-08 17:31:03
295,K1-101.小池公園,2,3,5,35.599541,139.697962,2024-02-08 17:31:03
296,H1-171.LOGI’Q南砂町,7,2,9,35.672877,139.842339,2024-02-08 17:31:03
297,H1-153.三井リンクラボ新木場1,0,27,27,35.63851,139.823534,2024-02-08 17:31:03
298,H1-154.やぐら橋下,2,18,20,35.631132,139.792726,2024-02-08 17:31:03
299,Z21.コーナン川崎小田栄店,0,8,8,35.514643,139.706285,2024-02-08 17:31:03
300,D5-11.NTTコミュニケーションズ新宿ビル,0,10,10,35.699312,139.696468,2024-02-08 17:31:03
301,C5-31.ヒルトン東京お台場,0,10,10,35.626267,139.771438,2024-02-08 17:31:03
302,K1-78.城南鋳物団地協同組合,0,17,17,35.567562,139.766854,2024-02-08 17:31:03
303,Z05.ローソン川崎小田二丁目店,5,0,5,35.513548,139.697176,2024-02-08 17:31:03
304,I1-68.八潮公園第二,4,0,4,35.600003,139.754288,2024-02-08 17:31:03
305,I1-67.八潮公園第一,4,0,4,35.601149,139.754284,2024-02-08 17:31:03
306,H1-123.ダイワロイネットホテル東京有明,0,21,21,35.634316,139.793199,2024-02-08 17:31:03
307,J1-24.ボヌールREIWA,4,1,5,35.612389,139.676238,2024-02-08 17:31:03
308,B2-12.東京ダイヤビルディング（東側）,0,24,24,35.674835,139.785656,2024-02-08 17:31:03
309,J1-15.二の橋自転車置場2,16,0,16,35.614391,139.678396,2024-02-08 17:31:03
310,H1-77.ライフ東砂店,3,6,9,35.684641,139.844243,2024-02-08 17:31:03
311,D1-09.NTT四谷ビル,3,0,3,35.691188,139.712079,2024-02-08 17:31:03
312,E4-11.プライマル千石,0,4,4,35.727519,139.742815,2024-02-08 17:31:03
313,I1-23.東海橋防災船着場,12,0,12,35.616114,139.74033,2024-02-08 17:31:03
314,A4-12.東京ミッドタウン日比谷,0,27,27,35.674274,139.759111,2024-02-08 17:31:03
315,K1-46.池上駅前自転車駐車場,7,5,12,35.571478,139.702779,2024-02-08 17:31:03
316,I1-24.しながわ区民公園(中央口),12,2,14,35.593611,139.738056,2024-02-08 17:31:03
317,T2-13.セブン-イレブン 練馬石神井町8丁目店,3,1,4,35.750414,139.600011,2024-02-08 17:31:03
318,O3-04.アヴァンセ阿佐ヶ谷,1,1,2,35.712,139.62816,2024-02-08 17:31:03
319,B4-01.黎明橋公園（駐輪場）,1,9,10,35.656071,139.780068,2024-02-08 17:31:03
320,T2-32.セブン-イレブン 練馬東大泉NTTビル店,7,1,8,35.750761,139.594457,2024-02-08 17:31:03
321,K1-142.コーラル洗足池,10,0,10,35.604567,139.689096,2024-02-08 17:31:03
322,K1-28.鵜の木特別出張所,3,1,4,35.574886,139.685122,2024-02-08 17:31:03
323,T1-02.ホテルカデンツァ東京,5,7,12,35.755106,139.621675,2024-02-08 17:31:03
324,C2-16.ザ・ベルグレイヴィア麻布,2,0,2,35.657264,139.743821,2024-02-08 17:31:03
325,N3-11.上高田区民活動センター,4,1,5,35.711501,139.672761,2024-02-08 17:31:03
326,T3-30.北西大松公園,2,2,4,35.765979,139.64931,2024-02-08 17:31:03
327,D6-05.新宿中央公園（水の広場）,4,2,6,35.690474,139.690219,2024-02-08 17:31:03
328,D6-07.新宿フロントタワー,0,14,14,35.696387,139.689924,2024-02-08 17:31:03
329,T2-73.早実グラウンド記念公園,2,2,4,35.734615,139.576214,2024-02-08 17:31:03
330,O7-03.永福町西幸モータープール東,3,8,11,35.67156,139.64609,2024-02-08 17:31:03
331,D1-03.新左門児童遊園,3,0,3,35.684523,139.720519,2024-02-08 17:31:03
332,D1-04.四谷見附公園,7,7,14,35.683448,139.728425,2024-02-08 17:31:03
333,I1-54.天王洲オーシャンスクエア,0,48,48,35.622356,139.749468,2024-02-08 17:31:03
334,D6-01.新宿区役所本庁舎,31,18,49,35.693602,139.703229,2024-02-08 17:31:03
335,D6-02.新宿区役所第二分庁舎,32,3,35,35.693976,139.706134,2024-02-08 17:31:03
336,D6-03.新宿中央公園（ポケットパーク）,0,13,13,35.691559,139.690029,2024-02-08 17:31:03
337,D6-04.新宿中央公園（ちびっこ広場）,7,2,9,35.686649,139.689821,2024-02-08 17:31:03
338,A6-21.日本工営ビル,3,2,5,35.684584,139.734442,2024-02-08 17:31:03
339,I1-77.セブン-イレブン品川西中延1丁目店,3,0,3,35.612217,139.708164,2024-02-08 17:31:03
340,T1-01.光が丘駅前広場,0,13,13,35.759164,139.629466,2024-02-08 17:31:03
341,T2-37.上石神井2丁目,5,3,8,35.729615,139.59532,2024-02-08 17:31:03
342,I1-75.セブン-イレブン品川二葉4丁目店,3,2,5,35.603275,139.713428,2024-02-08 17:31:03
343,M5-13.セブン-イレブン初台店,2,2,4,35.675049,139.68444,2024-02-08 17:31:03
344,D6-24.ＮＴＴ東日本 本社ビル,8,3,11,35.683102,139.688852,2024-02-08 17:31:03
345,H1-134.豊洲ぐるり公園,5,17,22,35.643141,139.777821,2024-02-08 17:31:03
346,H1-133.北砂2丁目公園,14,4,18,35.679001,139.825809,2024-02-08 17:31:03
347,E3-08.サガラマンション,2,3,5,35.722833,139.734662,2024-02-08 17:31:03
348,O4-05.阿佐ヶ谷南1-30,1,1,2,35.700703,139.639985,2024-02-08 17:31:03
349,O5-06.EXAM高円寺南,5,0,5,35.70273,139.65864,2024-02-08 17:31:03
350,G2-03.押上１丁目２６-４,3,2,5,35.710323,139.815215,2024-02-08 17:31:03
351,K1-132.多摩川駅前自転車等駐車場,10,5,15,35.587232,139.669519,2024-02-08 17:31:03
352,C5-47.oak港南品川,19,5,24,35.62413,139.744831,2024-02-08 17:31:03
353,D3-15.カースルいずみ,11,1,12,35.711324,139.711976,2024-02-08 17:31:03
354,C5-15.セブン-イレブン 港区芝浦ふ頭店,1,0,1,35.640215,139.755971,2024-02-08 17:31:03
355,C5-14.セブン-イレブン 港区汐彩橋店,4,0,4,35.640481,139.753659,2024-02-08 17:31:03
356,D5-01.新宿コズミックセンター,0,8,8,35.705244,139.70841,2024-02-08 17:31:03
357,H1-45.夢の島競技場,18,2,20,35.648596,139.824936,2024-02-08 17:31:03
358,E1-01.後楽橋横,22,3,25,35.702746,139.752009,2024-02-08 17:31:03
359,B1-15.ロイヤルパークホテル,3,2,5,35.682332,139.78722,2024-02-08 17:31:03
360,C4-05.白金台駅自転車駐車場,13,2,15,35.638927,139.727083,2024-02-08 17:31:03
361,E1-02.東京ドーム（ミーツポート）,0,13,13,35.70311,139.754951,2024-02-08 17:31:03
362,M2-06.あいおいニッセイ同和損保恵比寿ビル,4,3,7,35.647237,139.71512,2024-02-08 17:31:03
363,J1-12.工大橋下流自転車置場,3,1,4,35.605828,139.680265,2024-02-08 17:31:03
364,C5-25.NEX-TEC芝浦,37,1,38,35.639571,139.755551,2024-02-08 17:31:03
365,H1-175.ダイアパレス大島駅前,1,1,2,35.689543,139.836394,2024-02-08 17:31:03
366,C1-65.東京ポートシティ竹芝,0,14,14,35.654757,139.761516,2024-02-08 17:31:03
367,O2-03.西荻北5-8-17,2,3,5,35.709712,139.601846,2024-02-08 17:31:03
368,B2-21.八重洲二丁目北地区広場,0,29,29,35.67942,139.77004,2024-02-08 17:31:03
369,I1-101.下神明駅前,25,0,25,35.60838,139.726587,2024-02-08 17:31:03
370,N2-04.野方2丁目,6,0,6,35.713018,139.656768,2024-02-08 17:31:03
371,N2-05.野方3丁目,8,4,12,35.717877,139.654732,2024-02-08 17:31:03
372,K1-88.大田久が原西郵便局,4,0,4,35.582756,139.6925,2024-02-08 17:31:03
373,C5-51.トミンタワー台場一番街,11,0,11,35.634627,139.77663,2024-02-08 17:31:03
374,C4-10.亀塚公園,9,1,10,35.642764,139.741174,2024-02-08 17:31:03
375,H1-190.福山通運 東京支店,8,9,17,35.664845,139.796643,2024-02-08 17:31:03
376,C1-80.浜松町262ビル,9,2,11,35.654289,139.75557,2024-02-08 17:31:03
377,B2-19.リエトコートアルクスタワー,7,1,8,35.670506,139.77854,2024-02-08 17:31:03
378,C1-79.髙松コンストラクショングループ 東京本社ビル,5,0,5,35.648765,139.753363,2024-02-08 17:31:03
379,C5-43.オアーゼ芝浦MJビル,8,0,8,35.644798,139.752697,2024-02-08 17:31:03
380,J1-44.五本木2丁目,1,7,8,35.634441,139.687186,2024-02-08 17:31:03
381,B2-17.アーバネックス八丁堀,2,1,3,35.67518,139.77364,2024-02-08 17:31:03
382,M6-16.パールマンション,2,0,2,35.67464,139.67876,2024-02-08 17:31:03
383,G4-06.ドムス・スタイル両国,7,0,7,35.700453,139.798978,2024-02-08 17:31:03
384,G2-04.ラ　ステュディオ押上,4,1,5,35.712157,139.815298,2024-02-08 17:31:03
385,T3-15.セブン-イレブン練馬北町8丁目店,4,2,6,35.768105,139.646049,2024-02-08 17:31:03
386,C1-77.芝公園,16,2,18,35.65513,139.749645,2024-02-08 17:31:03
387,I1-27.小関橋公園,0,25,25,35.620699,139.730904,2024-02-08 17:31:03
388,B3-01.中央区役所,0,16,16,35.670855,139.772052,2024-02-08 17:31:03
389,A6-08.二番町ガーデン,3,1,4,35.685489,139.734562,2024-02-08 17:31:03
390,B1-01.十思公園,0,9,9,35.691058,139.777915,2024-02-08 17:31:03
391,B4-02.月島特別出張所,16,10,26,35.662197,139.782719,2024-02-08 17:31:03
392,A4-05.大手町タワー,0,29,29,35.685938,139.764886,2024-02-08 17:31:03
393,H1-22.豊洲市場（7街区）,17,52,69,35.6447,139.784512,2024-02-08 17:31:03
394,A6-07.二番町センタービル,0,7,7,35.685966,139.736328,2024-02-08 17:31:03
395,A2-12.神保町三井ビルディング,0,12,12,35.694532,139.760695,2024-02-08 17:31:03
396,E2-06.oto no ha Cafe,0,3,3,35.713991,139.725665,2024-02-08 17:31:03
397,B4-10.リバーシティ,9,0,9,35.668795,139.784784,2024-02-08 17:31:03
398,B1-03.常盤公園（北側）,3,6,9,35.688405,139.770068,2024-02-08 17:31:03
399,C5-19.グランドメゾン田町,7,0,7,35.645537,139.754899,2024-02-08 17:31:03
400,K1-11.ファミリーマート かわだ多摩川２丁目店,0,2,2,35.558289,139.697403,2024-02-08 17:31:03
401,J1-43.アルコタワー・ホテル雅叙園東京,0,10,10,35.63237,139.712681,2024-02-08 17:31:03
402,N1-03.鷺宮南駐輪場,5,4,9,35.721827,139.635949,2024-02-08 17:31:03
403,N2-06.江古田1丁目B,6,0,6,35.72515,139.672614,2024-02-08 17:31:03
404,D7-12.プラウド高田馬場,4,1,5,35.715538,139.701683,2024-02-08 17:31:03
405,K1-118.久が原3丁目,1,8,9,35.580741,139.687152,2024-02-08 17:31:03
406,K1-125.池上駅南口第1,0,2,2,35.571866,139.703214,2024-02-08 17:31:03
407,K1-117.安詳寺,11,8,19,35.581798,139.695222,2024-02-08 17:31:03
408,I1-91.アクロス目黒タワー,10,0,10,35.634019,139.719749,2024-02-08 17:31:03
409,K1-126.池上駅南口第2,2,1,3,35.571815,139.702387,2024-02-08 17:31:03
410,C5-50.お台場レインボー公園,12,0,12,35.633133,139.777315,2024-02-08 17:31:03
411,T3-26.富士見ランド公園,0,8,8,35.73701,139.627244,2024-02-08 17:31:03
412,T1-15.つのの山緑地,1,3,4,35.765144,139.636606,2024-02-08 17:31:03
413,T1-16.ゆりの木通り南公園,3,1,4,35.767582,139.636304,2024-02-08 17:31:03
414,H1-185.UR大島六丁目団地(第二),4,0,4,35.690038,139.833252,2024-02-08 17:31:03
415,H1-186.セブン-イレブン亀戸昭和橋通り店,0,7,7,35.694804,139.831357,2024-02-08 17:31:03
416,K1-96.西馬込駅前自転車駐車場,1,13,14,35.586408,139.705425,2024-02-08 17:31:03
417,H1-184.UR大島六丁目団地(第一),4,0,4,35.689913,139.833279,2024-02-08 17:31:03
418,A6-25.麹町仮住宅,0,4,4,35.679192,139.74019,2024-02-08 17:31:03
419,C1-69.塩釜公園,1,2,3,35.662908,139.755014,2024-02-08 17:31:03
420,C1-68.桜田公園,26,1,27,35.665214,139.757008,2024-02-08 17:31:03
421,A2-14.興和一橋ビル,4,11,15,35.6927,139.759311,2024-02-08 17:31:03
422,C5-41.トヨタモビリティ東京 芝浦店,3,0,3,35.639644,139.745532,2024-02-08 17:31:03
423,T2-22.ファミリーマート 石神井台7丁目店,5,0,5,35.731909,139.579685,2024-02-08 17:31:03
424,A6-20.紀尾井町PREX,0,9,9,35.68369,139.736936,2024-02-08 17:31:03
425,C5-24.GLOBAL FRONT TOWER,15,0,15,35.647713,139.755534,2024-02-08 17:31:03
426,E5-09.文京区 男女平等センター,12,2,14,35.70861,139.75768,2024-02-08 17:31:03
427,K1-37.東京サーハウス前,4,17,21,35.563874,139.685011,2024-02-08 17:31:03
428,B4-15.リバーシティ　イーストタワーズ,4,3,7,35.669188,139.785301,2024-02-08 17:31:03
429,M6-08.Be Good 幡ヶ谷,11,0,11,35.682453,139.677687,2024-02-08 17:31:03
430,D5-09.ハウジングステージ新宿,15,0,15,35.702277,139.701214,2024-02-08 17:31:03
431,D6-21.新宿5丁目,6,1,7,35.691613,139.711233,2024-02-08 17:31:03
432,K1-39.東京モノレール 流通センター駅前,0,28,28,35.581752,139.748705,2024-02-08 17:31:03
433,K1-38.ネクストサイト蒲田ビル,8,0,8,35.558916,139.717253,2024-02-08 17:31:03
434,T3-17.練馬区役所東庁舎(第二),4,1,5,35.735585,139.652544,2024-02-08 17:31:03
435,H1-107.大島小松川公園,6,21,27,35.692641,139.846346,2024-02-08 17:31:03
436,B1-11.浜町川緑道,28,19,47,35.684158,139.787649,2024-02-08 17:31:03
437,A6-19.番町麹町ビルディング,11,1,12,35.685578,139.732078,2024-02-08 17:31:03
438,B3-12.築地場外市場,10,8,18,35.665254,139.769301,2024-02-08 17:31:03
439,I1-40.御殿山トラストタワー,19,7,26,35.622371,139.737457,2024-02-08 17:31:03
440,M5-08.古賀政男音楽博物館,2,0,2,35.668091,139.680243,2024-02-08 17:31:03
441,H1-90.富士倉庫運輸(株) FACE-1前,1,3,4,35.655102,139.805205,2024-02-08 17:31:03
442,A3-38.パークホームズ千代田淡路町,0,5,5,35.695163,139.769566,2024-02-08 17:31:03
443,D2-11.神楽坂アインスタワー,4,2,6,35.702833,139.739,2024-02-08 17:31:03
444,C2-04.飯倉いきいきプラザ,2,0,2,35.656991,139.740739,2024-02-08 17:31:03
445,B1-09.スマイルホテル日本橋三越前,4,9,13,35.686101,139.776089,2024-02-08 17:31:03
446,E5-15.文京千駄木の郷,9,2,11,35.726499,139.759884,2024-02-08 17:31:03
447,C2-05.ありすいきいきプラザ,12,0,12,35.651046,139.727745,2024-02-08 17:31:03
448,C5-06.品川シーズンテラス,9,10,19,35.632303,139.742393,2024-02-08 17:31:03
449,B1-10.箱崎川第二公園,7,1,8,35.680833,139.784267,2024-02-08 17:31:03
450,L1-15.ソフィア,0,3,3,35.663222,139.587803,2024-02-08 17:31:03
451,A3-12.秋葉原UDX北側駐輪場前,0,15,15,35.70111,139.772855,2024-02-08 17:31:03
452,A2-08.KDX御茶ノ水ビル,2,7,9,35.700568,139.76013,2024-02-08 17:31:03
453,A3-07.淡路公園,0,13,13,35.696942,139.767302,2024-02-08 17:31:03
454,A1-08.飯田橋サクラテラス（早稲田通り）,0,12,12,35.699132,139.74462,2024-02-08 17:31:03
455,A3-13.富士ソフトビル（駐車場入口横）,3,16,19,35.700486,139.774254,2024-02-08 17:31:03
456,A2-09.テラススクエア,0,8,8,35.6931,139.7599,2024-02-08 17:31:03
457,A6-11.東京ガーデンテラス紀尾井町,0,23,23,35.67962,139.7364,2024-02-08 17:31:03
458,K1-124.矢口2丁目,6,0,6,35.564161,139.695187,2024-02-08 17:31:03
459,N3-15.ライオンズマンション中野東,0,3,3,35.71046,139.6855,2024-02-08 17:31:03
460,M3-11.渋谷道玄坂東急ビル,9,1,10,35.65718,139.698687,2024-02-08 17:31:03
461,H1-180.シティコート大島,7,1,8,35.691954,139.836462,2024-02-08 17:31:03
462,B1-27.日本橋本町4丁目,22,3,25,35.68973,139.77598,2024-02-08 17:31:03
463,M3-22.森谷ビル,15,0,15,35.64514,139.71686,2024-02-08 17:31:03
464,N3-17.東中野3丁目,10,0,10,35.70862,139.680679,2024-02-08 17:31:03
465,N2-10.関根ビル,1,4,5,35.733432,139.671241,2024-02-08 17:31:03
466,T1-06.秋の陽公園,2,3,5,35.762326,139.635226,2024-02-08 17:31:03
467,N1-02.鷺宮東駐輪場,0,12,12,35.721556,139.640397,2024-02-08 17:31:03
468,K1-140.西馬込駅前自転車駐車場(奥),1,12,13,35.586382,139.705116,2024-02-08 17:31:03
469,H1-182.錦糸町プライムタワー,10,4,14,35.695695,139.820507,2024-02-08 17:31:03
470,E5-05.駒込地域活動センター,9,0,9,35.728644,139.752183,2024-02-08 17:31:03
471,M3-06.渋谷第一生命ビル,0,7,7,35.657556,139.704129,2024-02-08 17:31:03
472,T2-42.石神井公園駅北第二自転車駐車場,1,4,5,35.74553,139.608939,2024-02-08 17:31:03
473,K1-144.蒲田五丁目44番自転車駐車場,8,2,10,35.559809,139.716993,2024-02-08 17:31:03
474,M3-07.渋谷ファーストプレイス,5,4,9,35.65506,139.69384,2024-02-08 17:31:03
475,H1-74.タダノ教習センター,3,7,10,35.63848,139.832305,2024-02-08 17:31:03
476,Z22.みんちゅう京急川崎駅前駐輪場内ラックスペース,1,2,3,35.532615,139.700332,2024-02-08 17:31:03
477,H1-151.コスモリード錦糸町,6,1,7,35.701347,139.819973,2024-02-08 17:31:03
478,T2-23.セブン-イレブン 練馬南大泉5丁目店,6,0,6,35.750185,139.579216,2024-02-08 17:31:03
479,M4-13.J-cube,1,2,3,35.66616,139.70458,2024-02-08 17:31:03
480,T2-65.さくらの辻公園,5,0,5,35.734805,139.599906,2024-02-08 17:31:03
481,T2-24.セブン-イレブン 練馬インター店,0,23,23,35.754586,139.606409,2024-02-08 17:31:03
482,O5-05.モンテ・ベルテ,0,2,2,35.701454,139.650518,2024-02-08 17:31:03
483,J1-42.都立大学駅北口バス停前,7,1,8,35.618622,139.67596,2024-02-08 17:31:03
484,K1-97.トミンタワー多摩川二丁目,12,0,12,35.555561,139.704345,2024-02-08 17:31:03
485,D1-14.コモレ四谷,4,1,5,35.68752,139.72818,2024-02-08 17:31:03
486,K1-106.ファミリーマート上池台夫婦坂店,6,3,9,35.599329,139.703343,2024-02-08 17:31:03
487,J1-39.松見坂公園,1,5,6,35.655483,139.687325,2024-02-08 17:31:03
488,J1-40.西小山公園,6,2,8,35.616541,139.697369,2024-02-08 17:31:03
489,J1-38.林試の森公園 北,12,0,12,35.626355,139.700153,2024-02-08 17:31:03
490,I1-84.セブン-イレブン西品川2丁目店,0,1,1,35.613819,139.728418,2024-02-08 17:31:03
491,D6-26.セブン-イレブン新宿６丁目文化センター通り店,8,1,9,35.694951,139.708219,2024-02-08 17:31:03
492,T2-25.ファミリーマート 高野台二丁目店,0,5,5,35.746045,139.620087,2024-02-08 17:31:03
493,I1-85.GOODOFFICE品川,4,0,4,35.621081,139.741178,2024-02-08 17:31:03
494,K1-74.大田スタジアム,0,8,8,35.587423,139.753871,2024-02-08 17:31:03
495,C1-64.東京虎ノ門グローバルスクエア,1,4,5,35.669941,139.749261,2024-02-08 17:31:03
496,K1-72.ファミリーマート大森西四丁目店,4,0,4,35.573358,139.723105,2024-02-08 17:31:03
497,H1-118.ファミリーマート亀戸駅前店,8,3,11,35.69839,139.825484,2024-02-08 17:31:03
498,I1-62.天王洲Rim,3,0,3,35.622277,139.745638,2024-02-08 17:31:03
499,H1-40.深川東京モダン館,0,4,4,35.674076,139.795008,2024-02-08 17:31:03
500,H1-117.東京パークサイドビル,6,4,10,35.671225,139.808561,2024-02-08 17:31:03
501,J1-01.目黒区総合庁舎,7,2,9,35.640675,139.698088,2024-02-08 17:31:03
502,C5-16.品川インターシティ,0,27,27,35.626704,139.742174,2024-02-08 17:31:03
503,A1-12.北の丸スクエア,7,0,7,35.695515,139.750213,2024-02-08 17:31:03
504,H1-46.セブン-イレブン 江東枝川2丁目店,0,1,1,35.659287,139.807358,2024-02-08 17:31:03
505,A2-25.プラウド神田駿河台,4,9,13,35.698991,139.76091,2024-02-08 17:31:03
506,C5-49.プラウドタワー芝浦,7,0,7,35.638912,139.747422,2024-02-08 17:31:03
507,T3-25.北町みのり公園,2,2,4,35.767627,139.65243,2024-02-08 17:31:03
508,H1-75.ジオ深川住吉,10,0,10,35.684247,139.815638,2024-02-08 17:31:03
509,T1-09.ローソン練馬旭町一丁目店,4,1,5,35.765704,139.625178,2024-02-08 17:31:03
510,T2-26.ファミリーマート 大泉学園町四丁目店,0,6,6,35.767388,139.587625,2024-02-08 17:31:03
511,T2-27.ファミリーマート 大泉長久保通り店,4,1,5,35.773841,139.591456,2024-02-08 17:31:03
512,C3-19.明治記念館西,3,1,4,35.678179,139.720809,2024-02-08 17:31:03
513,I1-11.鮫洲入江広場,14,0,14,35.603984,139.744504,2024-02-08 17:31:03
514,I1-10.品川シーサイド公園第1,11,7,18,35.607717,139.749478,2024-02-08 17:31:03
515,I1-09.東品川海上公園第1,7,0,7,35.616633,139.748945,2024-02-08 17:31:03
516,D3-06.セブン-イレブン高田馬場3丁目中央店,1,5,6,35.713872,139.698301,2024-02-08 17:31:03
517,K1-40.大田文化の森,3,2,5,35.579649,139.720263,2024-02-08 17:31:03
518,C1-41.港区立エコプラザ,3,5,8,35.658709,139.757036,2024-02-08 17:31:03
519,I1-13.八潮北公園,0,13,13,35.613421,139.75375,2024-02-08 17:31:03
520,I1-12.しながわ区民公園（北側）,3,2,5,35.596091,139.740884,2024-02-08 17:31:03
521,T2-09.こぐれの森緑地,7,3,10,35.763741,139.588847,2024-02-08 17:31:03
522,T3-31.パークサイド関口,6,2,8,35.74097,139.63836,2024-02-08 17:31:03
523,H1-183.MFLP新木場1,0,7,7,35.643958,139.838358,2024-02-08 17:31:03
524,T2-33.ウインドヒルズ189,2,4,6,35.74642,139.581204,2024-02-08 17:31:03
525,T2-67.陽和病院,1,6,7,35.761211,139.603316,2024-02-08 17:31:03
526,H1-82.セブンｰイレブン 北砂3丁目明治通り店,0,6,6,35.683514,139.827081,2024-02-08 17:31:03
527,T2-60.武蔵関公園（第一）,9,0,9,35.724747,139.565817,2024-02-08 17:31:03
528,I1-48.NTT 東日本 関東病院(北側),5,4,9,35.632191,139.725002,2024-02-08 17:31:03
529,T2-58.立野公園,3,2,5,35.716776,139.577975,2024-02-08 17:31:03
530,I1-100.東急荏原中延駅駐輪場,7,0,7,35.610444,139.712333,2024-02-08 17:31:03
531,T2-56.大泉公園（第一）,2,2,4,35.77228,139.58325,2024-02-08 17:31:03
532,T2-55.大泉町もみじやま公園,1,2,3,35.767296,139.602321,2024-02-08 17:31:03
533,T2-54.土支田農業公園,4,5,9,35.760939,139.609264,2024-02-08 17:31:03
534,I1-44.大井三ツ又商店街入口,6,0,6,35.604606,139.734483,2024-02-08 17:31:03
535,T2-62.大泉井頭公園,6,4,10,35.746681,139.57754,2024-02-08 17:31:03
536,T2-61.武蔵関公園（第二）,4,0,4,35.727826,139.570056,2024-02-08 17:31:03
537,T3-09.学田公園,5,0,5,35.730428,139.648704,2024-02-08 17:31:03
538,K1-105.東糀谷二丁目児童公園,0,8,8,35.555702,139.740802,2024-02-08 17:31:03
539,Z02.NTT渡田ビル,4,2,6,35.513644,139.712594,2024-02-08 17:31:03
540,T3-04.サンパレス平和台,8,4,12,35.759827,139.659121,2024-02-08 17:31:03
541,K1-104.六郷BASE,4,2,6,35.543573,139.714393,2024-02-08 17:31:03
542,M4-16.神宮前6丁目,1,2,3,35.668673,139.702816,2024-02-08 17:31:03
543,K1-69.京急平和島第2Bバイク駐輪場,4,0,4,35.585747,139.735242,2024-02-08 17:31:03
544,H1-155.メブクス豊洲,0,51,51,35.645726,139.784496,2024-02-08 17:31:03
545,C2-11.一の橋,29,22,51,35.654726,139.737491,2024-02-08 17:31:03
546,C4-11.ザ・パークハウス 三田ガーデン,14,0,14,35.64816,139.737991,2024-02-08 17:31:03
547,H1-161.昭文社制作本部ビル,5,0,5,35.684003,139.794983,2024-02-08 17:31:03
548,N2-07.新井区民活動センター,2,2,4,35.714292,139.663327,2024-02-08 17:31:03
549,K1-87.羽田イノベーションシティ,0,11,11,35.547061,139.756277,2024-02-08 17:31:03
550,N3-16.COURT 5,5,0,5,35.699743,139.664608,2024-02-08 17:31:03
551,C4-01.高輪地区総合支所(5F),5,6,11,35.641833,139.734519,2024-02-08 17:31:03
552,C5-48.セブンイレブン港区海岸三丁目店,8,0,8,35.636808,139.752517,2024-02-08 17:31:03
553,H1-42.江東区スポーツ会館,16,2,18,35.683961,139.821559,2024-02-08 17:31:03
554,B2-10.東京ダイヤビルディング（北側）,0,13,13,35.675702,139.785229,2024-02-08 17:31:03
555,H1-43.東京イースト21,0,11,11,35.675639,139.815255,2024-02-08 17:31:03
556,B3-20.歌舞伎座タワー駐輪場2F,0,8,8,35.670106,139.768041,2024-02-08 17:31:03
557,B3-21.歌舞伎座タワー駐輪場3F,7,3,10,35.6701,139.76801,2024-02-08 17:31:03
558,Z06.ローソン川崎殿町店,5,8,13,35.537434,139.744509,2024-02-08 17:31:03
559,K1-139.プラットホステル京急 羽田ホーム,8,2,10,35.548104,139.748889,2024-02-08 17:31:03
560,J1-58.目黒女子会館前,3,0,3,35.629011,139.69716,2024-02-08 17:31:03
561,T2-18.ファミリーマート練馬西税務署前店,4,0,4,35.745505,139.580878,2024-02-08 17:31:03
562,C3-23.LIFORK 南青山 北エントランス,13,16,29,35.669916,139.725701,2024-02-08 17:31:03
563,C1-46.新虎通りCORE,12,4,16,35.665124,139.754054,2024-02-08 17:31:03
564,C1-45.浜松町クレアタワー,15,0,15,35.656324,139.755927,2024-02-08 17:31:03
565,K1-53.セブン-イレブン 田園調布郵便局前店,20,0,20,35.589309,139.678587,2024-02-08 17:31:03
566,K1-52.大田区総合体育館,7,0,7,35.564152,139.727422,2024-02-08 17:31:03
567,T1-12.ファミリーマート 高松六丁目店,2,2,4,35.756873,139.616612,2024-02-08 17:31:03
568,D7-07.ローソン 新宿西落合三丁目店,5,0,5,35.725171,139.675897,2024-02-08 17:31:03
569,A6-16.一番町第二TGビル,5,0,5,35.688351,139.744321,2024-02-08 17:31:03
570,C3-33.PASONA SQUARE,12,1,13,35.667462,139.716058,2024-02-08 17:31:03
571,A3-24.岩本町ほほえみプラザ,0,2,2,35.69441,139.777715,2024-02-08 17:31:03
572,H1-35.ヒューリック豊洲プライムスクエア,1,3,4,35.652376,139.797724,2024-02-08 17:31:03
573,C5-11.フェイバリッチタワー品川,9,0,9,35.631729,139.749767,2024-02-08 17:31:03
574,E2-13.デルックス文京神楽坂,3,2,5,35.70781,139.732227,2024-02-08 17:31:03
575,C5-01.こうなん星の公園,0,54,54,35.629697,139.742167,2024-02-08 17:31:03
576,C5-02.港南緑水公園,38,0,38,35.628955,139.750731,2024-02-08 17:31:03
577,A3-22.龍閑児童公園,8,0,8,35.693234,139.779702,2024-02-08 17:31:03
578,A3-21.神田ふれあい通り第３,8,4,12,35.695176,139.772832,2024-02-08 17:31:03
579,H1-30.江東区役所（北側）,0,13,13,35.67338,139.8164,2024-02-08 17:31:03
580,C1-17.港区役所,0,4,4,35.657866,139.751068,2024-02-08 17:31:03
581,H1-31.江東区役所（南側）,13,4,17,35.67214,139.8166,2024-02-08 17:31:03
582,C1-09.愛宕グリーンヒルズ,0,23,23,35.662051,139.748132,2024-02-08 17:31:03
583,D1-02.四谷特別出張所（新宿御苑大木戸門前）,12,5,17,35.687435,139.714169,2024-02-08 17:31:03
584,D1-01.花園西公園,0,5,5,35.690612,139.711631,2024-02-08 17:31:03
585,C1-04.虎ノ門ヒルズ,0,27,27,35.666527,139.748804,2024-02-08 17:31:03
586,C1-05.西新橋2丁目（新虎通り）,10,3,13,35.665593,139.752617,2024-02-08 17:31:03
587,C1-73.日比谷フォートタワー,1,11,12,35.669871,139.753147,2024-02-08 17:31:03
588,K1-102.上池台四丁目公園,5,1,6,35.595119,139.6996,2024-02-08 17:31:03
589,M2-01.恵比寿保健相談所（恵比寿社会教育館）,6,0,6,35.64524,139.71946,2024-02-08 17:31:03
590,I1-98.コーポ荏原,6,0,6,35.60411,139.709784,2024-02-08 17:31:03
591,C3-17.セブン-イレブン 港区溜池山王店,0,42,42,35.670308,139.743242,2024-02-08 17:31:03
592,T2-11.石神井松の風文化公園,3,0,3,35.739471,139.595578,2024-02-08 17:31:03
593,M2-03.サイカパーク恵比寿,10,5,15,35.646581,139.710613,2024-02-08 17:31:03
594,M2-02.アメリカ橋公園,4,4,8,35.643606,139.713099,2024-02-08 17:31:03
595,T2-50.North Ridge 吉祥寺,7,2,9,35.72305,139.579555,2024-02-08 17:31:03
596,J1-35.目黒川田道街かど公園,5,0,5,35.634574,139.710332,2024-02-08 17:31:03
597,H1-174.ジュネス(エントランス側),2,0,2,35.682712,139.823961,2024-02-08 17:31:03
598,M6-17.笹塚一丁目駐輪場,7,0,7,35.672922,139.668729,2024-02-08 17:31:03
599,C4-14.神応ほっとプラザ,5,5,10,35.643711,139.724753,2024-02-08 17:31:03
600,K1-107.馬込駅A2出口,5,4,9,35.596854,139.712139,2024-02-08 17:31:03
601,T3-11.ガラクタ公園,2,1,3,35.740321,139.631256,2024-02-08 17:31:03
602,T2-80.みその緑地,3,2,5,35.756825,139.590528,2024-02-08 17:31:03
603,T3-24.AZEST新桜台,5,2,7,35.743962,139.670315,2024-02-08 17:31:03
604,D4-07.新宿余丁町ビル,2,0,2,35.698512,139.716482,2024-02-08 17:31:03
605,Z23.NA川崎南町,0,5,5,35.524976,139.697495,2024-02-08 17:31:03
606,T3-01.練馬春日町駅自転車駐車場,4,3,7,35.751438,139.641265,2024-02-08 17:31:03
607,H1-89.BUDDY スポーツアリーナ,0,24,24,35.637041,139.781088,2024-02-08 17:31:03
608,E5-14.上野広小路駅（湯島側）,0,18,18,35.707313,139.771857,2024-02-08 17:31:03
609,H1-109.Brillia ist 東雲キャナルコート東側,5,0,5,35.648008,139.803487,2024-02-08 17:31:03
610,H1-108.Brillia ist 東雲キャナルコート北側,6,0,6,35.648431,139.803125,2024-02-08 17:31:03
611,C1-53.ホテルリブマックス新橋,1,3,4,35.661149,139.754612,2024-02-08 17:31:03
612,D7-10.染の里 おちあい,5,1,6,35.715211,139.689788,2024-02-08 17:31:03
613,A1-15.富士見みらい館,3,0,3,35.697167,139.745629,2024-02-08 17:31:03
614,E4-15.千石4丁目,5,0,5,35.729153,139.741368,2024-02-08 17:31:03
615,H1-111.ファミリーマート木場六丁目店,0,1,1,35.66688,139.80779,2024-02-08 17:31:03
616,C5-36.お台場海浜公園駅,1,2,3,35.62974,139.778178,2024-02-08 17:31:03
617,H1-10.出会い橋,13,2,15,35.625029,139.777344,2024-02-08 17:31:03
618,H1-11.テレコムセンター駅,0,30,30,35.61813,139.778698,2024-02-08 17:31:03
619,H1-47.トピレックプラザ,0,17,17,35.672481,139.835877,2024-02-08 17:31:03
620,H1-13.アーバンドック ららぽーと豊洲,7,12,19,35.654067,139.792376,2024-02-08 17:31:03
621,T2-66.大泉学園町希望ヶ丘公園,0,4,4,35.778605,139.588883,2024-02-08 17:31:03
622,C5-37.台場駅,0,30,30,35.626388,139.772453,2024-02-08 17:31:03
623,H1-16.豊洲三丁目公園,0,70,70,35.657477,139.796629,2024-02-08 17:31:03
624,H1-17.東雲水辺公園,17,0,17,35.64704,139.80469,2024-02-08 17:31:03
625,C1-72.新田町ビル,8,1,9,35.646307,139.746428,2024-02-08 17:31:03
626,K1-98.鵜の木松山公園,3,4,7,35.577433,139.680752,2024-02-08 17:31:03
627,C1-71.芝商業高校前交差点,0,11,11,35.65583,139.759896,2024-02-08 17:31:03
628,H1-122.東砂スポーツセンター,4,7,11,35.679167,139.839746,2024-02-08 17:31:03
629,O6-05.コージーコート久我山,0,5,5,35.687531,139.60439,2024-02-08 17:31:03
630,T2-39.ローソン 練馬大泉町五丁目店,3,5,8,35.758929,139.597548,2024-02-08 17:31:03
631,J1-50.大岡山公園,4,0,4,35.609958,139.684087,2024-02-08 17:31:03
632,J1-51.池尻大橋駅東口駐輪場,1,4,5,35.650627,139.687228,2024-02-08 17:31:03
633,K1-99.東原くすのき公園,7,1,8,35.584086,139.67898,2024-02-08 17:31:03
634,N3-12.桃園区民活動センター,2,1,3,35.702414,139.667327,2024-02-08 17:31:03
635,H1-191.三井リンクラボ新木場2,13,1,14,35.644863,139.831107,2024-02-08 17:31:03
636,M5-09.代々木上原駅前,0,5,5,35.66865,139.679251,2024-02-08 17:31:03
637,O3-09.NTT井草ビル第3ポート,6,1,7,35.714151,139.61693,2024-02-08 17:31:03
638,T1-07.土支田一丁目（笹目通り）,6,4,10,35.765913,139.619285,2024-02-08 17:31:03
639,K1-22.矢口特別出張所,5,0,5,35.562324,139.690486,2024-02-08 17:31:03
640,T3-08.中新井川児童遊園,6,1,7,35.728268,139.649188,2024-02-08 17:31:03
641,H1-78.ローソン新木場一丁目店,11,3,14,35.645604,139.834941,2024-02-08 17:31:03
642,A6-13.番町会館,3,3,6,35.689131,139.733071,2024-02-08 17:31:03
643,H1-71.セブン-イレブン 江東東陽4丁目,0,12,12,35.670906,139.819386,2024-02-08 17:31:03
644,D2-09.セブン-イレブン 新宿岩戸町店,2,0,2,35.700993,139.736355,2024-02-08 17:31:03
645,I1-08.天王洲アイル第一水辺広場,1,29,30,35.622294,139.751644,2024-02-08 17:31:03
646,I1-07.しながわ水族館,15,0,15,35.590641,139.736354,2024-02-08 17:31:03
647,D3-09.西早稲田3丁目,4,0,4,35.712545,139.713319,2024-02-08 17:31:03
648,E1-16.小石川3丁目緑地,21,0,21,35.714338,139.746346,2024-02-08 17:31:03
649,C5-28.芝浦ルネサイトタワー,7,0,7,35.643683,139.7506,2024-02-08 17:31:03
650,I1-59.文庫の森第一,21,0,21,35.612357,139.721484,2024-02-08 17:31:03
651,I1-60.文庫の森第二,5,0,5,35.611368,139.720424,2024-02-08 17:31:03
652,C1-38.KDX西新橋ビル（西側）,3,1,4,35.66495,139.750459,2024-02-08 17:31:03
653,C1-37.KDX西新橋ビル（北側）,0,6,6,35.665218,139.750827,2024-02-08 17:31:03
654,T2-14.NPC24H東大泉第6パーキング,1,5,6,35.747807,139.593599,2024-02-08 17:31:03
655,C3-12.赤坂センタービルディング前（青山通り）,0,11,11,35.676732,139.733905,2024-02-08 17:31:03
656,H1-36.フジゴルフセンター,12,5,17,35.66605,139.806699,2024-02-08 17:31:03
657,C1-27.虎ノ門2丁目タワー,0,21,21,35.668547,139.747175,2024-02-08 17:31:03
658,C5-12.第2東運ビル,4,0,4,35.633742,139.748281,2024-02-08 17:31:03
659,D6-08.新宿イーストサイドスクエア,0,11,11,35.697158,139.707887,2024-02-08 17:31:03
660,A4-08.永代通り（大手町駅B2c出口前）,3,20,23,35.684349,139.766958,2024-02-08 17:31:03
661,H1-37.東雲駅（東京湾岸道路）,30,2,32,35.640618,139.802455,2024-02-08 17:31:03
662,C3-11.赤坂見附南,0,11,11,35.676566,139.737083,2024-02-08 17:31:03
663,M6-04.本町東べんてん橋公園,0,5,5,35.687126,139.680702,2024-02-08 17:31:03
664,I1-79.品川浦第二,13,1,14,35.621904,139.741429,2024-02-08 17:31:03
665,K1-81.コーナン本羽田萩中店,13,0,13,35.549568,139.731093,2024-02-08 17:31:03
666,D6-25.新宿駅東南口自転車駐輪場,28,4,32,35.689755,139.701323,2024-02-08 17:31:03
667,I1-78.セブン-イレブン西大井店,11,0,11,35.601431,139.718659,2024-02-08 17:31:03
668,H1-136.東砂一丁目公園,10,7,17,35.683542,139.839763,2024-02-08 17:31:03
669,A6-23.セブン-イレブン 千代田三番町店,0,6,6,35.689466,139.745316,2024-02-08 17:31:03
670,C5-34.五色橋ビル,0,0,0,35.636644,139.751798,2024-02-08 17:31:03
671,K1-41.郷土博物館,0,9,9,35.588644,139.710413,2024-02-08 17:31:03
672,G2-06.ディアレイシャス押上スカイヴィレッジ,3,2,5,35.71408,139.810588,2024-02-08 17:31:03
673,O3-11.ハイリビング関根,3,5,8,35.707877,139.618926,2024-02-08 17:31:03
674,O7-02.永福中央公園,6,0,6,35.67121,139.64145,2024-02-08 17:31:03
675,K1-29.萩中文化センター,5,4,9,35.55017,139.728146,2024-02-08 17:31:03
676,K1-30.テクノFRONT森ケ崎,0,5,5,35.567922,139.746181,2024-02-08 17:31:03
677,K1-130.COCOONひろば平和島,18,1,19,35.578728,139.735238,2024-02-08 17:31:03
678,H1-81.豊洲IHIビル（北側）,14,8,22,35.659829,139.793243,2024-02-08 17:31:03
679,E4-03.昭和小学校北側（不忍通り）,29,1,30,35.73166,139.748625,2024-02-08 17:31:03
680,C2-12.六本木ファーストビル,0,15,15,35.66249,139.741397,2024-02-08 17:31:03
681,D3-16.セジョリ江戸川橋,12,1,13,35.708734,139.730509,2024-02-08 17:31:03
682,A5-04.日比谷パークフロント前　日比谷公園南面向い歩道上,0,22,22,35.671514,139.753952,2024-02-08 17:31:03
683,C3-22.OMO3東京赤坂 by 星野リゾート,7,1,8,35.674929,139.736053,2024-02-08 17:31:03
684,B1-20.竜閑さくら橋際街角広場,0,30,30,35.688301,139.768958,2024-02-08 17:31:03
685,H1-83.ローソン江東東雲店,9,1,10,35.642165,139.800439,2024-02-08 17:31:03
686,H1-84.NTT東日本辰巳ビル,0,21,21,35.647091,139.817333,2024-02-08 17:31:03
687,C5-26.ピアシティ芝浦ビル,13,0,13,35.644155,139.756216,2024-02-08 17:31:03
688,T3-28.ほしぞら緑地,1,2,3,35.755137,139.661208,2024-02-08 17:31:03
689,I1-88.セブン-イレブン品川南大井3丁目店,1,1,2,35.58768,139.734515,2024-02-08 17:31:03
690,I1-87.セブン-イレブン西大井滝王子通り店,4,0,4,35.599774,139.723467,2024-02-08 17:31:03
691,Z20.川崎キングスカイフロント 東急 REI ホテル,0,10,10,35.540589,139.752918,2024-02-08 17:31:03
692,G4-11.ホテルマイステイズ浅草,21,1,22,35.703972,139.797327,2024-02-08 17:31:03
693,C5-30.フェイム芝浦インターウェーブ,11,0,11,35.647872,139.75391,2024-02-08 17:31:03
694,M6-13.JICA東京,12,0,12,35.673409,139.675203,2024-02-08 17:31:03
695,A4-13.アーバンネット大手町ビル,0,11,11,35.68557,139.766929,2024-02-08 17:31:03
696,B4-27.リバーシティ西ブロック,16,1,17,35.670491,139.784447,2024-02-08 17:31:03
697,K1-143.大森北1丁目,58,2,60,35.584914,139.730504,2024-02-08 17:31:03
698,E5-24.本郷6丁目,5,0,5,35.712445,139.758157,2024-02-08 17:31:03
699,D2-17.genten市ヶ谷店,10,0,10,35.690657,139.73255,2024-02-08 17:31:03
700,A4-14.東京国際フォーラム（有楽町駅ガード側）,2,6,8,35.675739,139.763712,2024-02-08 17:31:03
701,A2-27.丸紅ビル,0,18,18,35.690958,139.759876,2024-02-08 17:31:03
702,K1-135.北千束2丁目,2,4,6,35.608633,139.693653,2024-02-08 17:31:03
703,A1-19.九段会館テラス,0,5,5,35.694065,139.751801,2024-02-08 17:31:03
704,K1-136.BIG FUN 平和島,0,12,12,35.585489,139.740194,2024-02-08 17:31:03
705,K1-137.京浜島つばさ公園,0,16,16,35.571578,139.770532,2024-02-08 17:31:03
706,D1-16.ルネ新宿御苑タワー,1,6,7,35.690155,139.713377,2024-02-08 17:31:03
707,G6-01.オーキッドレジデンス森下,5,0,5,35.692547,139.799231,2024-02-08 17:31:03
708,T2-63.三原台公園,2,5,7,35.751471,139.599835,2024-02-08 17:31:03
709,O4-01.阿佐ヶ谷南公園,2,0,2,35.70328,139.62981,2024-02-08 17:31:03
710,B4-11.ダンスキューブ勝どき,0,6,6,35.656565,139.775073,2024-02-08 17:31:03
711,D1-06.四谷第六小学校北,10,0,10,35.681754,139.715256,2024-02-08 17:31:03
712,T2-64.高野台中央公園,3,0,3,35.746768,139.613885,2024-02-08 17:31:03
713,H1-169.セブンイレブン江東亀戸7丁目東店,7,3,10,35.697157,139.839835,2024-02-08 17:31:03
714,H1-170.セブンイレブン江東亀戸7丁目南店,0,19,19,35.695937,139.838017,2024-02-08 17:31:03
715,B2-16.ホテルサードニクス東京,0,10,10,35.67684,139.77876,2024-02-08 17:31:03
716,I1-93.中央海浜公園前交差点（南側）,5,0,5,35.595498,139.750654,2024-02-08 17:31:03
717,I1-92.中央海浜公園前交差点（北側）,10,0,10,35.595873,139.75134,2024-02-08 17:31:03
718,B1-26.Dash Living Nihonbashi,3,1,4,35.68802,139.78112,2024-02-08 17:31:03
719,H1-158.東京国際交流館,9,3,12,35.621845,139.776833,2024-02-08 17:31:03
720,J1-32.緑が丘駅前高架下,4,3,7,35.606793,139.678372,2024-02-08 17:31:03
721,K1-90.ファミリーマート大田仲池上一丁目店,4,2,6,35.5873,139.701644,2024-02-08 17:31:03
722,K1-91.穴守稲荷神社,0,12,12,35.550027,139.74973,2024-02-08 17:31:03
723,C1-67.京阪神 虎ノ門ビル,0,21,21,35.669228,139.751668,2024-02-08 17:31:03
724,K1-89.ファミリーマート大田千鳥三丁目店,5,0,5,35.572086,139.68708,2024-02-08 17:31:03
725,I1-97.トミンハイム東品川三丁目第二,17,0,17,35.613387,139.749307,2024-02-08 17:31:03
726,T2-51.練馬区役所石神井庁舎,2,8,10,35.743772,139.603317,2024-02-08 17:31:03
727,T2-75.石神井台二丁目緑地,3,0,3,35.734684,139.593628,2024-02-08 17:31:03
728,E5-19.千駄木公園,7,0,7,35.728333,139.757629,2024-02-08 17:31:03
729,E5-18.団子坂上広場,6,4,10,35.724921,139.75903,2024-02-08 17:31:03
730,A5-07.富国生命ビル,0,14,14,35.670452,139.75557,2024-02-08 17:31:03
731,H1-156.つどい橋下,0,11,11,35.630791,139.787396,2024-02-08 17:31:03
732,H1-159.夢の大橋西,14,2,16,35.627599,139.782953,2024-02-08 17:31:03
733,H1-143.ダイバーシティ東京 プラザ,9,1,10,35.624619,139.776006,2024-02-08 17:31:03
734,I1-57.大井水神公園,32,39,71,35.589972,139.729368,2024-02-08 17:31:03
735,B2-15.KABUTO ONE,0,27,27,35.68168,139.77825,2024-02-08 17:31:03
736,K1-64.多摩川グリーンスクエア,7,2,9,35.545459,139.719489,2024-02-08 17:31:03
737,Z07.ローソン川崎渡田三丁目店,2,2,4,35.519137,139.705791,2024-02-08 17:31:03
738,T2-57.大泉公園（第二）,5,1,6,35.771708,139.583551,2024-02-08 17:31:03
739,A4-06.大手町ファーストスクエア,0,33,33,35.686037,139.764472,2024-02-08 17:31:03
740,C1-50.NTT虎ノ門ビル,3,11,14,35.666075,139.748008,2024-02-08 17:31:03
741,C1-23.三田いきいきプラザ,8,2,10,35.648637,139.749834,2024-02-08 17:31:03
742,H1-29.スカイズタワー＆ガーデン,2,0,2,35.647618,139.792152,2024-02-08 17:31:03
743,C1-21.汐留ビルディング,0,11,11,35.657363,139.75918,2024-02-08 17:31:03
744,A3-16.地蔵橋東児童遊園,5,1,6,35.691069,139.775376,2024-02-08 17:31:03
745,Z08.ファミリーマート観音二丁目店,0,7,7,35.526238,139.72907,2024-02-08 17:31:03
746,A3-18.美倉橋北児童遊園,2,2,4,35.69703,139.779928,2024-02-08 17:31:03
747,A4-01.丸ビル（南側駐輪場）,2,9,11,35.680514,139.764002,2024-02-08 17:31:03
748,A3-11.練成公園,3,6,9,35.703735,139.770629,2024-02-08 17:31:03
749,A3-10.芳林公園（北側）,0,6,6,35.701978,139.7698,2024-02-08 17:31:03
750,A6-02.いきいきプラザ一番町（西側駐輪場）,6,1,7,35.687031,139.739327,2024-02-08 17:31:03
751,A6-01.東郷元帥記念公園（南側）,4,0,4,35.689879,139.740178,2024-02-08 17:31:03
752,A5-03.参議院第二別館（永田町駅2番出口）,6,9,15,35.677763,139.74271,2024-02-08 17:31:03
753,A4-03.東京国際フォーラム（メトロD5出口）,5,1,6,35.675843,139.763329,2024-02-08 17:31:03
754,K1-15.セブン‐イレブン 大田区西蒲田店,0,3,3,35.56694,139.716331,2024-02-08 17:31:03
755,K1-49.ローソン仲池上一丁目店,10,0,10,35.586585,139.698552,2024-02-08 17:31:03
756,A2-06.東光電気工事 別館（屋内駐輪場）,3,4,7,35.69919,139.75701,2024-02-08 17:31:03
757,M4-01.新宿タカシマヤ,4,1,5,35.68714,139.702775,2024-02-08 17:31:03
758,M4-03.NTTドコモ代々木ビル,5,3,8,35.684451,139.702884,2024-02-08 17:31:03
759,M3-03.代官山 T-SITE,0,8,8,35.649823,139.700139,2024-02-08 17:31:03
760,K1-14.大森地域庁舎,5,0,5,35.578239,139.723262,2024-02-08 17:31:03
761,C5-46.ウエリスアーバン品川タワー,12,0,12,35.630961,139.746875,2024-02-08 17:31:03
762,C4-13.コシダコネクトビル,7,6,13,35.637765,139.739128,2024-02-08 17:31:03
763,K1-127.第二石井ビル,0,5,5,35.559286,139.722611,2024-02-08 17:31:03
764,C1-74.札の辻スクエア,2,5,7,35.645155,139.744543,2024-02-08 17:31:03
765,H1-164.森下三丁目第三児童遊園,19,0,19,35.68546,139.80244,2024-02-08 17:31:03
766,C1-78.CIRCLES新橋,3,6,9,35.66646,139.752138,2024-02-08 17:31:03
767,C3-34.3rd MINAMI AOYAMA,0,4,4,35.668622,139.715957,2024-02-08 17:31:03
768,O4-06.杉並区役所本庁舎,2,3,5,35.699328,139.636343,2024-02-08 17:31:03
769,D3-14.コーシャハイム高田馬場,6,0,6,35.712413,139.70168,2024-02-08 17:31:03
770,D7-11.新宿清掃事務所,4,1,5,35.716359,139.704377,2024-02-08 17:31:03
771,D5-08.ウエリス新宿早稲田の森,0,9,9,35.704597,139.708397,2024-02-08 17:31:03
772,E2-12.水道2丁目,7,0,7,35.709147,139.739183,2024-02-08 17:31:03
773,M6-10.京王コインパーク幡ヶ谷,5,0,5,35.6772,139.678117,2024-02-08 17:31:03
774,E3-05.文京スポーツセンター,44,16,60,35.721045,139.735687,2024-02-08 17:31:03
775,J1-36.WJ Haus,2,2,4,35.629067,139.711779,2024-02-08 17:31:03
776,K1-51.テクノポートカマタ 第2,3,7,10,35.555808,139.722791,2024-02-08 17:31:03
777,D1-13.新宿御苑新宿門【西側】,0,22,22,35.688945,139.706536,2024-02-08 17:31:03
778,I1-31.セブン-イレブン 品川戸越5丁目店,6,0,6,35.608193,139.719139,2024-02-08 17:31:03
779,T3-27.貫井川緑地,1,3,4,35.738427,139.632251,2024-02-08 17:31:03
780,H1-147.大島四丁目団地,13,0,13,35.68744,139.827075,2024-02-08 17:31:03
781,O4-02.成宗さくら公園,2,0,2,35.69638,139.63482,2024-02-08 17:31:03
782,O1-01.上瀬戸公園,2,2,4,35.72077,139.6045,2024-02-08 17:31:03
783,T2-15.NPC24H大泉学園南口パーキング,0,10,10,35.748611,139.584251,2024-02-08 17:31:03
784,O3-03.桃井1丁目5番地,7,0,7,35.71013,139.61194,2024-02-08 17:31:03
785,H1-08.東京テレポート駅,22,16,38,35.627087,139.779779,2024-02-08 17:31:03
786,H1-05.相鉄グランドフレッサ 東京ベイ有明,4,10,14,35.632148,139.79017,2024-02-08 17:31:03
787,H1-06.武蔵野大学,0,19,19,35.630185,139.786618,2024-02-08 17:31:03
788,A4-15.TOKIWAブリッジ,0,28,28,35.686389,139.769237,2024-02-08 17:31:03
789,H1-160.花の広場,2,15,17,35.633908,139.793322,2024-02-08 17:31:03
790,H1-01.豊洲ＩＨＩビル前（晴海通り）,0,10,10,35.658911,139.792531,2024-02-08 17:31:03
791,H1-02.豊洲駅,0,52,52,35.654196,139.79626,2024-02-08 17:31:03
792,J1-19.NTT東日本自由が丘ビル,3,1,4,35.615098,139.675954,2024-02-08 17:31:03
793,C2-19.広尾駅,0,5,5,35.650732,139.72256,2024-02-08 17:31:03
794,H1-114.東京夢の島マリーナ,4,10,14,35.651987,139.830691,2024-02-08 17:31:03
795,K1-71.ファミリーマート大田大森南店,5,0,5,35.562769,139.74327,2024-02-08 17:31:03
796,J1-20.すずめのお宿緑地公園,7,2,9,35.617773,139.685351,2024-02-08 17:31:03
797,H1-115.東京夢の島マリーナ 第4駐車場,2,12,14,35.650235,139.835993,2024-02-08 17:31:03
798,M5-10.富ヶ谷2丁目,16,1,17,35.665961,139.686491,2024-02-08 17:31:03
799,J1-21.中央緑地公園,5,0,5,35.630694,139.690482,2024-02-08 17:31:03
800,H1-116.出会い橋高架下,26,23,49,35.625037,139.777646,2024-02-08 17:31:03
801,M3-12.渋谷南東急ビル,3,4,7,35.656228,139.706284,2024-02-08 17:31:03
802,T2-01.大泉学園駅北口,0,5,5,35.749918,139.58618,2024-02-08 17:31:03
803,K1-06.大森駅入新井自転車駐車場,4,2,6,35.585269,139.726279,2024-02-08 17:31:03
804,D6-06.新宿中央公園（エコギャラリー下）,0,19,19,35.691199,139.687966,2024-02-08 17:31:03
805,D6-14.新宿ファーストウエスト,5,9,14,35.689529,139.695995,2024-02-08 17:31:03
806,D6-15.住友不動産西新宿ビル,4,7,11,35.69465,139.695911,2024-02-08 17:31:03
807,H1-56.南砂三丁目緑地公園西,0,18,18,35.672361,139.829825,2024-02-08 17:31:03
808,T2-74.扇橋公園,3,2,5,35.731791,139.588844,2024-02-08 17:31:03
809,B2-20.SHビル,3,0,3,35.675398,139.779962,2024-02-08 17:31:03
810,I1-17.東品川海上公園第2,11,0,11,35.616364,139.749171,2024-02-08 17:31:03
811,I1-16.品川浦,14,0,14,35.6214,139.741958,2024-02-08 17:31:03
812,A4-11.二重橋前駅(メトロ4番出口),0,13,13,35.680753,139.762069,2024-02-08 17:31:03
813,H1-76.有明物流センター,4,15,19,35.638571,139.78829,2024-02-08 17:31:03
814,K1-43.北馬込わくわく公園,0,5,5,35.600707,139.703216,2024-02-08 17:31:03
815,K1-42.馬込西公園,12,2,14,35.58849,139.70376,2024-02-08 17:31:03
816,T1-08.セブン-イレブン 練馬高松6丁目店,0,2,2,35.756506,139.620347,2024-02-08 17:31:03
817,T2-17.ファミリーマート 練馬石神井町八丁目店,0,4,4,35.74755,139.597968,2024-02-08 17:31:03
818,K1-31.テクノWING,0,9,9,35.546252,139.731708,2024-02-08 17:31:03
819,K1-32.石川町文化センター,5,0,5,35.601958,139.682876,2024-02-08 17:31:03
820,I1-20.しおじ公園,19,0,19,35.59632,139.751279,2024-02-08 17:31:03
821,I1-19.品川シーサイド公園第2,1,6,7,35.607571,139.749108,2024-02-08 17:31:03
822,J1-29.カスタリア目黒鷹番,4,1,5,35.626121,139.688576,2024-02-08 17:31:03
823,H1-127.古石場川親水公園,15,7,22,35.669291,139.795364,2024-02-08 17:31:03
824,D4-05.カスタリア新宿7丁目,0,9,9,35.700732,139.711472,2024-02-08 17:31:03
825,I1-71.セブン-イレブン南大井浜川店,3,0,3,35.596483,139.7355,2024-02-08 17:31:03
826,I1-72.セブン-イレブン大井店,6,0,6,35.600081,139.728193,2024-02-08 17:31:03
827,T3-21.くまのやま緑地,4,1,5,35.747038,139.667965,2024-02-08 17:31:03
828,K1-110.萩中集会所裏,12,2,14,35.550479,139.739538,2024-02-08 17:31:03
829,O2-02.シエール荻窪,30,0,30,35.708265,139.612703,2024-02-08 17:31:03
830,H1-128.豊洲市場（5街区）,16,18,34,35.645162,139.785386,2024-02-08 17:31:03
831,N1-09.若宮レジデンス,2,3,5,35.716184,139.643905,2024-02-08 17:31:03
832,M6-12.LIVART SEASON 幡ヶ谷,5,0,5,35.683156,139.67338,2024-02-08 17:31:03
833,H1-142.東京ベイ潮見プリンスホテル,11,0,11,35.660632,139.817294,2024-02-08 17:31:03
834,G1-01.鐘ヶ淵駅南自転車駐車場,2,7,9,35.732291,139.82012,2024-02-08 17:31:03
835,M1-01.渋谷区役所,0,17,17,35.66362,139.69801,2024-02-08 17:31:03
836,I1-83.かもめ歩道橋,0,11,11,35.600161,139.749902,2024-02-08 17:31:03
837,N4-05.セブン-イレブン中野鍋横店,2,3,5,35.693815,139.668571,2024-02-08 17:31:03
838,D4-02.JICA市ヶ谷ビル（地球ひろば／研究所）,6,1,7,35.694927,139.731328,2024-02-08 17:31:03
839,T3-19.なかみや児童遊園,1,4,5,35.749388,139.651824,2024-02-08 17:31:03
840,N1-08.上鷺自転車保管場所,2,5,7,35.729056,139.627864,2024-02-08 17:31:03
841,O7-06.松木1丁目,1,12,13,35.686015,139.642784,2024-02-08 17:31:03
842,E4-16.ビレッジワン,7,0,7,35.723723,139.740143,2024-02-08 17:31:03
843,D1-15.フロンティア四谷,5,3,8,35.68768,139.71937,2024-02-08 17:31:03
844,K1-128.大森西3丁目,12,2,14,35.571975,139.732137,2024-02-08 17:31:03
845,N1-06.大和区民活動センター,3,1,4,35.713562,139.649075,2024-02-08 17:31:03
846,G4-01.両国ビューホテル1,1,6,7,35.69566,139.79214,2024-02-08 17:31:03
847,G4-02.両国ビューホテル2,5,3,8,35.69562,139.79206,2024-02-08 17:31:03
848,G4-05.両国駅西口臨時自転車駐車場,17,3,20,35.698588,139.792946,2024-02-08 17:31:03
849,G4-03.本所1-6-5,10,3,13,35.702525,139.796632,2024-02-08 17:31:03
850,G5-01.牡丹橋自転車駐車場,15,3,18,35.693059,139.813417,2024-02-08 17:31:03
851,G5-02.横川3-7-10,19,17,36,35.70378,139.814298,2024-02-08 17:31:03
852,G4-04.NTTドコモ墨田ビル,17,4,21,35.697898,139.795345,2024-02-08 17:31:03
853,G2-02.押上1-23-8,5,3,8,35.710111,139.81488,2024-02-08 17:31:03
854,C5-13.区立芝浦西運河沿緑地,40,0,40,35.638245,139.749754,2024-02-08 17:31:03
855,D6-12.東京ビジネスホテル,0,1,1,35.69342,139.710568,2024-02-08 17:31:03
856,D6-11.ホテルリステル新宿,0,3,3,35.693029,139.711327,2024-02-08 17:31:03
857,D6-10.ホテルサンライト新宿,0,4,4,35.694201,139.707047,2024-02-08 17:31:03
858,H1-39.辰巳駅東口自転車駐車場,15,10,25,35.645823,139.812178,2024-02-08 17:31:03
859,H1-38.辰巳駅西口自転車駐車場,89,0,89,35.646857,139.808912,2024-02-08 17:31:03
860,C2-10.元麻布三丁目,3,4,7,35.655865,139.730566,2024-02-08 17:31:03
861,C2-09.麻布地区総合支所,1,1,2,35.660614,139.734771,2024-02-08 17:31:03
862,M3-20.東急ステイ渋谷新南口,7,1,8,35.65494,139.70534,2024-02-08 17:31:03
863,I1-86.ファミリーマート二葉三丁目店,0,2,2,35.601694,139.719778,2024-02-08 17:31:03
864,A2-23.axle御茶ノ水,4,3,7,35.696126,139.763297,2024-02-08 17:31:03
865,C4-02.白金台いきいきプラザ,2,3,5,35.63756,139.724981,2024-02-08 17:31:03
866,N3-04.東中野駅地下駐輪場,0,22,22,35.707883,139.683284,2024-02-08 17:31:03
867,N3-05.中野坂上駅地下駐輪場,0,8,8,35.698068,139.682781,2024-02-08 17:31:03
868,N3-03.青桐公園,0,8,8,35.697024,139.677846,2024-02-08 17:31:03
869,N3-01.中野四季の森公園,0,16,16,35.708487,139.662135,2024-02-08 17:31:03
870,N4-01.本四公園,8,2,10,35.69693,139.672721,2024-02-08 17:31:03
871,N4-02.栄町公園,7,0,7,35.686474,139.671383,2024-02-08 17:31:03
872,K1-57.池上本門寺,6,0,6,35.579585,139.705377,2024-02-08 17:31:03
873,C1-49.汐留シティセンター,0,15,15,35.666213,139.760907,2024-02-08 17:31:03
874,C4-15.クロスレジデンス白金高輪,1,10,11,35.642771,139.733046,2024-02-08 17:31:03
875,K1-56.NTT馬込ビル,3,1,4,35.588106,139.718852,2024-02-08 17:31:03
876,J1-41.CASSIA目黒,8,1,9,35.631319,139.70237,2024-02-08 17:31:03
877,A2-22.専修大学,1,3,4,35.696147,139.753709,2024-02-08 17:31:03
878,T3-20.はやいち公園,1,3,4,35.75312,139.65661,2024-02-08 17:31:03
879,B3-19.本の森ちゅうおう,1,6,7,35.67363,139.77623,2024-02-08 17:31:03
880,K1-86.IMPREST STAY TOKYO 蒲田,20,2,22,35.556267,139.727246,2024-02-08 17:31:03
881,T3-23.氷川台二丁目緑地,3,1,4,35.756575,139.669689,2024-02-08 17:31:03
882,T3-22.氷川台三丁目ちびっこ公園,2,1,3,35.750547,139.66707,2024-02-08 17:31:03
883,B1-23.NANAEI日本橋,2,3,5,35.679616,139.784341,2024-02-08 17:31:03
884,B2-11.京橋エドグラン,0,27,27,35.677576,139.769822,2024-02-08 17:31:03
885,N1-05.大野ハイツ,2,3,5,35.7266,139.62948,2024-02-08 17:31:03
886,B2-09.茅場町一丁目平和ビル,0,10,10,35.680203,139.778679,2024-02-08 17:31:03
887,B2-08.共同ビル（茅場町交差点前）,3,6,9,35.681012,139.778569,2024-02-08 17:31:03
888,B2-07.東京証券会館（北側）,0,5,5,35.680864,139.779331,2024-02-08 17:31:03
889,O3-12.大宮前体育館,1,2,3,35.696567,139.610517,2024-02-08 17:31:03
890,B1-08.明治座,0,10,10,35.688038,139.786561,2024-02-08 17:31:03
891,B4-05.ドコモ・バイクシェア晴海ポート,0,43,43,35.654165,139.781568,2024-02-08 17:31:03
892,B4-04.ＫＤＸ晴海ビル,0,0,0,35.65443,139.77843,2024-02-08 17:31:03
893,B4-03.桜の散歩道（晴海トリトンスクエア前）,0,25,25,35.658665,139.782553,2024-02-08 17:31:03
894,E5-08.セブン-イレブン 文京動坂上店,5,0,5,35.727778,139.756296,2024-02-08 17:31:03
895,H1-65.ローソン南砂日曹橋店,12,2,14,35.669507,139.825553,2024-02-08 17:31:03
896,H1-66.中川船番所資料館,6,2,8,35.687732,139.846383,2024-02-08 17:31:03
897,K1-113.ファミリーマート大田上池台四丁目店,5,2,7,35.594658,139.700133,2024-02-08 17:31:03
898,H1-64.ローソン東雲駅前店,3,7,10,35.640228,139.804267,2024-02-08 17:31:03
899,E1-11.小石川運動場前,4,9,13,35.703914,139.747061,2024-02-08 17:31:03
900,T2-70.三ツ塚けやき緑地,2,2,4,35.720318,139.570762,2024-02-08 17:31:03
901,H1-137.住友不動産ショッピングシティ有明ガーデン,17,4,21,35.638985,139.793653,2024-02-08 17:31:03
902,C5-40.芝浦ふ頭駅前暫定自転車駐車場,0,6,6,35.64096,139.75754,2024-02-08 17:31:03
903,M3-21.渋谷ソラスタ,7,5,12,35.65618,139.69612,2024-02-08 17:31:03
904,D7-03.中井駅北,25,5,30,35.715645,139.687486,2024-02-08 17:31:03
905,K1-119.シーンズ大森パークサイド,2,0,2,35.58223,139.72763,2024-02-08 17:31:03
906,M6-15.cova Hatagaya,1,1,2,35.67741,139.67383,2024-02-08 17:31:03
907,C2-25.アパホテル＆リゾート＜六本木駅東＞,19,24,43,35.661783,139.737242,2024-02-08 17:31:03
908,D4-10.東新宿ポート(余丁町6番),6,0,6,35.696585,139.713081,2024-02-08 17:31:03
909,O1-02.井荻南地下自転車駐車場,5,9,14,35.72424,139.61431,2024-02-08 17:31:03
910,O1-03.LUCKY HOUSE,1,3,4,35.72489,139.62383,2024-02-08 17:31:03
911,D6-30.京王プラザホテル,4,3,7,35.6897,139.694823,2024-02-08 17:31:03
912,D6-29.都庁第二本庁舎前,9,5,14,35.688735,139.692249,2024-02-08 17:31:03
913,O3-02.アートメゾン荻窪,6,2,8,35.71355,139.6199,2024-02-08 17:31:03
914,J1-57.トレインチ自由が丘,5,0,5,35.606667,139.667324,2024-02-08 17:31:03
915,O2-01.サカエフラット荻窪,10,1,11,35.70535,139.61497,2024-02-08 17:31:03
916,O3-01.西田公園,6,1,7,35.69575,139.62065,2024-02-08 17:31:03
917,K1-47.NTT雪ヶ谷ビル,11,0,11,35.598601,139.684747,2024-02-08 17:31:03
918,Z17.NTT川崎ビル,9,0,9,35.529519,139.704845,2024-02-08 17:31:03
919,O7-04.永福町西幸モータープール西,7,1,8,35.67161,139.64527,2024-02-08 17:31:03
920,K1-48.ファミリーマート大田上池台三丁目店,0,5,5,35.590934,139.696915,2024-02-08 17:31:03
921,K1-111.本羽田公園,6,1,7,35.546499,139.736761,2024-02-08 17:31:03
922,C1-58.ウォーターズ竹芝,0,9,9,35.655937,139.763251,2024-02-08 17:31:03
923,K1-109.萩中公園プール駐輪場,8,0,8,35.549323,139.737091,2024-02-08 17:31:03
924,K1-108.仲江名公園,2,2,4,35.557999,139.732564,2024-02-08 17:31:03
925,E1-17.小石川パークスクエア,10,0,10,35.713913,139.745416,2024-02-08 17:31:03
926,D6-23.アパホテル 東新宿 歌舞伎町西,0,3,3,35.697535,139.703633,2024-02-08 17:31:03
927,H1-98.洲崎川緑道公園,8,1,9,35.668705,139.810549,2024-02-08 17:31:03
928,H1-99.南砂三丁目公園,16,8,24,35.669695,139.831874,2024-02-08 17:31:03
929,H1-96.越中島公園,0,16,16,35.668757,139.790156,2024-02-08 17:31:03
930,H1-97.浜園公園,6,1,7,35.661852,139.802224,2024-02-08 17:31:03
931,H1-94.新木場一丁目緑地公園,1,8,9,35.64423,139.835823,2024-02-08 17:31:03
932,H1-95.若洲公園,6,18,24,35.619451,139.834429,2024-02-08 17:31:03
933,J1-09.ファミリーマート佐野久下目黒店,4,0,4,35.629252,139.712716,2024-02-08 17:31:03
934,H1-93.新木場一丁目公園,0,20,20,35.64143,139.835455,2024-02-08 17:31:03
935,I1-55.鈴ヶ森公園,8,0,8,35.593559,139.734704,2024-02-08 17:31:03
936,O6-04.柏の宮公園,1,4,5,35.67834,139.62711,2024-02-08 17:31:03
937,B4-14.Brillia ist Tower 勝どき,10,0,10,35.660526,139.776816,2024-02-08 17:31:03
938,D7-08.上落合3丁目,0,15,15,35.71115,139.68232,2024-02-08 17:31:03
939,H1-21.UR東雲キャナルコート,9,0,9,35.646041,139.804495,2024-02-08 17:31:03
940,H1-20.日本科学未来館,14,15,29,35.619377,139.777582,2024-02-08 17:31:03
941,H1-19.UR豊洲四丁目団地,20,0,20,35.653603,139.80144,2024-02-08 17:31:03
942,T2-45.風致地区バス停第三自転車駐車場,3,4,7,35.771068,139.586798,2024-02-08 17:31:03
943,H1-33.深川ギャザリア（ウエストスクエア）,0,9,9,35.66789,139.803,2024-02-08 17:31:03
944,H1-32.区営塩浜住宅前,5,15,20,35.664591,139.813954,2024-02-08 17:31:03
945,H1-23.KDX豊洲グランスクエア,0,12,12,35.648085,139.798986,2024-02-08 17:31:03
946,C2-22.飯倉公園,10,0,10,35.655649,139.74427,2024-02-08 17:31:03
947,I1-89.下神明駅自転車駐車場,5,0,5,35.608402,139.726118,2024-02-08 17:31:03
948,C5-39.お台場海浜公園東,13,0,13,35.631021,139.778109,2024-02-08 17:31:03
949,C5-38.お台場海浜公園乗船場,0,18,18,35.628743,139.773915,2024-02-08 17:31:03
950,O4-08.ローソン阿佐ヶ谷青梅街道店,0,5,5,35.703203,139.62804,2024-02-08 17:31:03
951,T2-72.高塚南緑地,5,1,6,35.733132,139.570311,2024-02-08 17:31:03
952,O6-03.みなみ荘,5,5,10,35.68073,139.62803,2024-02-08 17:31:03
953,K1-129.ローソン東糀谷一丁目店,0,7,7,35.557427,139.739126,2024-02-08 17:31:03
954,E1-03.東京ドーム（黄色いビル横）,6,1,7,35.70319,139.751888,2024-02-08 17:31:03
955,K1-23.大田区役所本庁舎前,6,1,7,35.561183,139.716339,2024-02-08 17:31:03
956,T2-78.北大泉くれはし公園,2,1,3,35.761474,139.592735,2024-02-08 17:31:03
957,J1-53.ボヌールAllamanda,2,3,5,35.612833,139.675047,2024-02-08 17:31:03
958,A3-39.トーシン東神田ビル,3,1,4,35.694834,139.780333,2024-02-08 17:31:03
959,O6-01.高井戸みどり公園,5,4,9,35.67912,139.61074,2024-02-08 17:31:03
960,T2-79.大泉学園町八丁目緑地,5,1,6,35.774457,139.596182,2024-02-08 17:31:03
961,O5-04.リヴィエール,18,2,20,35.70104,139.65839,2024-02-08 17:31:03
962,N3-08.中野区役所(西側),1,5,6,35.707968,139.663519,2024-02-08 17:31:03
963,I1-99.北品川２丁目,6,0,6,35.61663,139.74192,2024-02-08 17:31:03
964,P1-01.サンシャインシティ,5,2,7,35.728846,139.718577,2024-02-08 17:31:03
965,N3-14.ヴィラソンサ落合,0,6,6,35.713227,139.680966,2024-02-08 17:31:03
966,H1-49.セブン-イレブン 江東新砂３丁目店,0,20,20,35.667892,139.8311,2024-02-08 17:31:03
967,I1-06.大森貝塚遺跡庭園,8,1,9,35.593489,139.72967,2024-02-08 17:31:03
968,M2-12.恵比寿プライムスクエアタワー北,8,0,8,35.650541,139.713361,2024-02-08 17:31:03
969,H1-69.ファミリーマート 江東石島店,8,1,9,35.680474,139.812316,2024-02-08 17:31:03
970,B3-09.築地永谷コーポラス,9,4,13,35.66523,139.776313,2024-02-08 17:31:03
971,E4-10.白山四丁目第二児童遊園横,8,0,8,35.720349,139.746924,2024-02-08 17:31:03
972,I1-03.大井町駅中央口（西側）,1,1,2,35.605617,139.73472,2024-02-08 17:31:03
973,I1-04.大井町歩道橋,4,0,4,35.605146,139.734694,2024-02-08 17:31:03
974,I1-01.品川区役所 本庁舎前,9,1,10,35.609052,139.729825,2024-02-08 17:31:03
975,I1-02.品川区役所 第三庁舎前,9,0,9,35.608161,139.730048,2024-02-08 17:31:03
976,G4-08.ブオンサンヴァレンティーノ,6,0,6,35.691677,139.793857,2024-02-08 17:31:03
977,J1-13.洗足二丁目駐輪場,13,4,17,35.61061,139.693443,2024-02-08 17:31:03
978,J1-16.八雲橋自転車置場,4,0,4,35.617353,139.672256,2024-02-08 17:31:03
979,H1-189.MFLP新木場2,4,25,29,35.634453,139.824,2024-02-08 17:31:03
980,M6-09.ファミリーマート渋谷本町店,3,1,4,35.683756,139.684965,2024-02-08 17:31:03
981,H1-113.123+N東雲店,24,0,24,35.646366,139.801492,2024-02-08 17:31:03
982,J1-17.ファミリーマート原町二丁目店,5,1,6,35.613902,139.691476,2024-02-08 17:31:03
983,E5-21.動坂公園,11,0,11,35.73176,139.756669,2024-02-08 17:31:03
984,E5-20.本郷2丁目,0,4,4,35.704391,139.758575,2024-02-08 17:31:03
985,T2-48.武蔵関駅南第二自転車駐車場,2,2,4,35.726064,139.578015,2024-02-08 17:31:03
986,A6-26.相互半蔵門ビル,7,4,11,35.683378,139.743189,2024-02-08 17:31:03
987,J1-31.守屋図書館,16,3,19,35.634194,139.688833,2024-02-08 17:31:03
988,M3-19.渋谷キャスト,11,9,20,35.662146,139.702793,2024-02-08 17:31:03
989,N1-04.都立家政南駐輪場,2,5,7,35.721679,139.645265,2024-02-08 17:31:03
990,Z09.ファミリーマート川崎川中島二丁目店,0,10,10,35.529781,139.727511,2024-02-08 17:31:03
991,N2-02.江古田1丁目A,1,2,3,35.724988,139.672511,2024-02-08 17:31:03
992,C1-56.鈴与竹芝ビル,0,10,10,35.654873,139.762103,2024-02-08 17:31:03
993,D3-07.戸塚特別出張所,1,5,6,35.71429,139.70507,2024-02-08 17:31:03
994,G4-12.プレミアムキューブ両国,7,0,7,35.70103,139.803341,2024-02-08 17:31:03
995,A2-21.神田神保町3丁目,4,2,6,35.694578,139.754434,2024-02-08 17:31:03
996,B4-19.コーシャタワー佃,0,4,4,35.668044,139.785801,2024-02-08 17:31:03
997,I1-81.戸越6丁目,20,0,20,35.608127,139.717865,2024-02-08 17:31:03
998,A6-24.国立劇場,0,15,15,35.682218,139.743292,2024-02-08 17:31:03
999,E5-23.ビレッジ千駄木,2,4,6,35.722353,139.760966,2024-02-08 17:31:03
1000,H1-119.榎戸材木店,0,24,24,35.638319,139.834741,2024-02-08 17:31:03
1001,C5-29.Hi-NODE(ハイノード),7,1,8,35.651672,139.760549,2024-02-08 17:31:03
1002,J1-22.NTTコミュニケーションズ唐ヶ崎ビル,4,0,4,35.627373,139.692044,2024-02-08 17:31:03
1003,A2-18.猿楽町SSビル東,3,1,4,35.698654,139.759762,2024-02-08 17:31:03
1004,A2-19.猿楽町SSビル西,0,4,4,35.698641,139.759306,2024-02-08 17:31:03
1005,C1-55.アーバンネット内幸町ビル,15,4,19,35.669267,139.756018,2024-02-08 17:31:03
1006,D4-06.グリーンフォート河田,0,7,7,35.697143,139.718739,2024-02-08 17:31:03
1007,K1-134.東調布公園,10,0,10,35.588363,139.69042,2024-02-08 17:31:03
1008,Z12.京急川崎西口駐輪場B,21,0,21,35.533627,139.700527,2024-02-08 17:31:03
1009,M5-18.Luxe初台,5,0,5,35.679182,139.68596,2024-02-08 17:31:03
1010,D7-06.エムアイセミナーハウス,5,0,5,35.721064,139.677128,2024-02-08 17:31:03
1011,A3-37.ポータル秋葉原,2,0,2,35.695737,139.78162,2024-02-08 17:31:03
1012,M5-11.あおい通り,5,3,8,35.688154,139.698975,2024-02-08 17:31:03
1013,E5-04.保健サービスセンター本郷支所,5,0,5,35.727046,139.760439,2024-02-08 17:31:03
1014,E5-03.汐見地域活動センター（本郷図書館）,2,3,5,35.725538,139.76116,2024-02-08 17:31:03
1015,E5-01.文京総合体育館,23,8,31,35.708121,139.763583,2024-02-08 17:31:03
1016,E4-01.千石南自転車駐車場,15,9,24,35.72707,139.746112,2024-02-08 17:31:03
1017,E3-03.大塚公園,11,10,21,35.724286,139.730954,2024-02-08 17:31:03
1018,E3-02.教育の森公園,9,7,16,35.719345,139.736198,2024-02-08 17:31:03
1019,I1-25.セブン-イレブン 品川旗の台2丁目店,1,2,3,35.607084,139.705007,2024-02-08 17:31:03
1020,B1-21.日本橋二丁目街角広場,0,10,10,35.680861,139.774493,2024-02-08 17:31:03
1021,C3-30.東京赤坂NKビル (ヴィアインプライム赤坂),6,2,8,35.672652,139.738908,2024-02-08 17:31:03
1022,A3-36.クロックカフェ東神田,0,5,5,35.694943,139.782718,2024-02-08 17:31:03
1023,E1-14.いきいき礫川,8,1,9,35.711147,139.747386,2024-02-08 17:31:03
1024,D4-09.トミンハイム仲之町,0,2,2,35.69617,139.722021,2024-02-08 17:31:03
1025,L1-08.NTT砧ビル,1,5,6,35.63534,139.601602,2024-02-08 17:31:03
1026,L1-09.コージーK・駒沢,2,1,3,35.632689,139.654804,2024-02-08 17:31:03
1027,L1-10.宮坂2-4-10,0,7,7,35.652913,139.644825,2024-02-08 17:31:03
1028,I1-22.ウィラ大井 (ショッピングモール),0,3,3,35.596579,139.745009,2024-02-08 17:31:03
1029,K1-76.グリーンベルト,6,3,9,35.585178,139.726339,2024-02-08 17:31:03
1030,H1-121.南砂5丁目,1,15,16,35.676603,139.829736,2024-02-08 17:31:03
1031,M3-02.文化総合センター大和田,4,1,5,35.65558,139.69966,2024-02-08 17:31:03
1032,D4-04.ジェノヴィア新宿早稲田グリーンヴェール,6,0,6,35.700033,139.71983,2024-02-08 17:31:03
1033,A3-20.神田ふれあい通り第２,0,2,2,35.695005,139.772747,2024-02-08 17:31:03
1034,H1-120.豊洲5丁目,16,1,17,35.650948,139.799711,2024-02-08 17:31:03
1035,C5-42.DHC芝浦2丁目ビル,8,0,8,35.644241,139.753834,2024-02-08 17:31:03
1036,I1-65.セブン-イレブン品川東大井1丁目店,7,0,7,35.605996,139.743037,2024-02-08 17:31:03
1037,M2-04.広尾東公園,3,0,3,35.653382,139.721059,2024-02-08 17:31:03
1038,M3-13.渋谷駅東口地下駐輪場,17,2,19,35.657682,139.703307,2024-02-08 17:31:03
1039,A3-19.神田ふれあい通り第１,0,5,5,35.694904,139.772712,2024-02-08 17:31:03
1040,O6-07.ローソン杉並宮前一丁目店,2,3,5,35.689639,139.613516,2024-02-08 17:31:03
1041,T3-10.貫井一丁目緑地,3,0,3,35.736378,139.632485,2024-02-08 17:31:03
1042,M2-05.日本赤十字医療センター,0,9,9,35.65519,139.718559,2024-02-08 17:31:03
1043,T2-20.パークサイド石神井,0,4,4,35.741769,139.591103,2024-02-08 17:31:03
1044,N4-06.ローソン中野本町新橋通り店,1,3,4,35.695819,139.674326,2024-02-08 17:31:03
1045,T3-07.徳殿公園,3,1,4,35.726728,139.65874,2024-02-08 17:31:03
1046,K1-35.セブン-イレブン 大田区西六郷2丁目店,5,0,5,35.549778,139.707362,2024-02-08 17:31:03
1047,A3-27.秋葉原駅中央口（ヨドバシカメラ前）,9,1,10,35.698986,139.774099,2024-02-08 17:31:03
1048,A3-28.秋葉原駅電気街口(西側交通広場),2,3,5,35.699173,139.772629,2024-02-08 17:31:03
1049,H1-57.新木場駅,61,1,62,35.64508,139.826456,2024-02-08 17:31:03
1050,H1-58.潮見駅,0,24,24,35.658703,139.817251,2024-02-08 17:31:03
1051,D7-02.セブン-イレブン 新宿中落合3丁目店,0,5,5,35.722202,139.691712,2024-02-08 17:31:03
1052,D2-06.飯田濠,6,7,13,35.70057,139.74301,2024-02-08 17:31:03
1053,C5-17.鈴与浜松町ビル,0,10,10,35.651103,139.759092,2024-02-08 17:31:03
1054,H1-59.LYURO 東京清澄,11,0,11,35.681316,139.792176,2024-02-08 17:31:03
1055,H1-60.荒川・砂町庭球場西,0,13,13,35.679678,139.844892,2024-02-08 17:31:03
1056,K1-44.中馬込貝塚公園,7,0,7,35.594795,139.704951,2024-02-08 17:31:03
1057,M6-11.京王サイクルパーク笹塚,5,0,5,35.674337,139.668801,2024-02-08 17:31:03
1058,J1-49.伊勢脇公園,3,1,4,35.638864,139.696568,2024-02-08 17:31:03
1059,K1-45.たぬき山公園,8,0,8,35.592801,139.715472,2024-02-08 17:31:03
1060,D2-01.あずさセンタービル,8,8,16,35.702286,139.741093,2024-02-08 17:31:03
1061,C1-02.西新橋1丁目（外堀通り）,1,5,6,35.668791,139.753582,2024-02-08 17:31:03
1062,O3-07.NTT井草ビル第1ポート,3,0,3,35.714044,139.61688,2024-02-08 17:31:03
1063,T2-41.ローソン 練馬東大泉五丁目店,0,3,3,35.74248,139.58715,2024-02-08 17:31:03
1064,H1-144.南砂住宅,7,0,7,35.674199,139.822018,2024-02-08 17:31:03
1065,C3-28.ヒューリックＪＰ赤坂ビル,0,11,11,35.672477,139.739743,2024-02-08 17:31:03
1066,H1-145.東雲都橋住宅,4,0,4,35.643131,139.797784,2024-02-08 17:31:03
1067,I1-58.品川区役所　第二庁舎前,15,2,17,35.609664,139.730006,2024-02-08 17:31:03
1068,K1-92.蒲田駅西口自転車駐車場,23,2,25,35.561101,139.715173,2024-02-08 17:31:03
1069,A2-24.水道橋駅西口前,1,4,5,35.702271,139.752619,2024-02-08 17:31:03
1070,K1-94.昭和島駅前,0,5,5,35.572188,139.749613,2024-02-08 17:31:03
1071,M5-15.新宿マインズタワー,15,5,20,35.686567,139.699355,2024-02-08 17:31:03
1072,D7-13.日本光電本社南側,15,0,15,35.71936,139.679083,2024-02-08 17:31:03
1073,N3-09.中野区役所(北側),0,5,5,35.708259,139.663829,2024-02-08 17:31:03
1074,H1-163.森下公園,4,0,4,35.68663,139.799529,2024-02-08 17:31:03
1075,B4-23.交通広場（豊海町）,5,6,11,35.653771,139.769295,2024-02-08 17:31:03
1076,D6-18.ヨドバシカメラ 新宿西口本店前,4,3,7,35.689689,139.698231,2024-02-08 17:31:03
1077,I1-47.NTT 東日本 関東病院(南側),0,7,7,35.630151,139.725215,2024-02-08 17:31:03
1078,H1-112.ファミリーマート江東塩浜二丁目店,3,0,3,35.66305,139.8087,2024-02-08 17:31:03
1079,K1-103.雪谷特別出張所,0,4,4,35.594515,139.691219,2024-02-08 17:31:03
1080,E5-17.Village藍染,5,0,5,35.720896,139.76422,2024-02-08 17:31:03
1081,Z04.ローソン川崎四谷上町店,7,1,8,35.527562,139.737102,2024-02-08 17:31:03
1082,Z03.ローソン川崎塩浜三丁目店,0,6,6,35.523754,139.746356,2024-02-08 17:31:03
1083,I1-49.京急鮫洲バイク駐輪場,6,0,6,35.603815,139.741362,2024-02-08 17:31:03
1084,I1-50.京急立会川第2バイク駐輪場,6,1,7,35.599196,139.739158,2024-02-08 17:31:03
1085,E4-14.NTT東日本大塚ビル,0,9,9,35.726188,139.741375,2024-02-08 17:31:03
1086,M2-07.ファミリーマート恵比寿駅東店,4,3,7,35.6471,139.712818,2024-02-08 17:31:03
1087,M4-07.千駄ヶ谷駅前,2,3,5,35.68082,139.71188,2024-02-08 17:31:03
1088,O5-07.バーンホーフ キクチ,8,12,20,35.698169,139.655665,2024-02-08 17:31:03
1089,J1-11.コンフォリア目黒青葉台,0,9,9,35.649023,139.696086,2024-02-08 17:31:03
1090,L1-14.給田3丁目,0,12,12,35.664335,139.590114,2024-02-08 17:31:03
1091,B4-06.月島駅地下駐輪場,1,16,17,35.66291,139.782564,2024-02-08 17:31:03
1092,C5-09.グランパーク,20,0,20,35.643202,139.746244,2024-02-08 17:31:03
1093,C5-08.AQUACITY芝浦,8,0,8,35.637366,139.74844,2024-02-08 17:31:03
1094,C3-08.赤坂パークビルヂング,3,0,3,35.671792,139.733668,2024-02-08 17:31:03
1095,C3-07.新青山ビル,10,5,15,35.672659,139.725644,2024-02-08 17:31:03
1096,C3-06.ホテルアジア会館,2,6,8,35.67064,139.728166,2024-02-08 17:31:03
1097,C1-24.三田国際ビル,0,35,35,35.653159,139.744673,2024-02-08 17:31:03
1098,C5-07.港区立港南図書館,9,0,9,35.632842,139.7495,2024-02-08 17:31:03
1099,A3-04.秋葉原公園,12,6,18,35.697642,139.774867,2024-02-08 17:31:03
1100,A3-05.和泉公園（西側入口）,1,2,3,35.698817,139.778898,2024-02-08 17:31:03
1101,A3-02.絶滅メディア博物館（楓ビル）,2,5,7,35.689575,139.767848,2024-02-08 17:31:03
1102,O3-10.メゾンパークス,6,2,8,35.716265,139.618954,2024-02-08 17:31:03
1103,A2-05.神田橋公園,0,20,20,35.689665,139.764091,2024-02-08 17:31:03
1104,A3-01.神田児童公園（西側交番横）,1,5,6,35.692983,139.76773,2024-02-08 17:31:03
1105,A2-03.西神田公園（西側）,5,1,6,35.698338,139.754876,2024-02-08 17:31:03
1106,M6-03.十三号通り公園,7,0,7,35.675198,139.663587,2024-02-08 17:31:03
1107,M6-02.サイカパーク笹塚,2,3,5,35.673444,139.666553,2024-02-08 17:31:03
1108,H1-165.亀戸梅屋敷,0,8,8,35.701318,139.825916,2024-02-08 17:31:03
1109,H1-166.亀戸クロック,7,11,18,35.696574,139.82972,2024-02-08 17:31:03
1110,M5-02.あいおいニッセイ同和損保新宿ビル,0,6,6,35.684423,139.692262,2024-02-08 17:31:03
1111,M6-01.幡ヶ谷駅高架下第一,28,6,34,35.677175,139.676769,2024-02-08 17:31:03
1112,A5-02.山王パークタワー,0,15,15,35.673555,139.741293,2024-02-08 17:31:03
1113,K1-116.旧呑川緑地（大森東五丁目）,12,0,12,35.567176,139.742345,2024-02-08 17:31:03
1114,K1-115.旧呑川緑地（大森中三丁目）,4,0,4,35.565685,139.736195,2024-02-08 17:31:03
1115,K1-114.下丸子公園,8,0,8,35.568722,139.680736,2024-02-08 17:31:03
1116,T3-05.東武練馬駅南,3,7,10,35.767129,139.664365,2024-02-08 17:31:03
1117,T1-14.ファミリーマート 練馬高松五丁目北店,4,0,4,35.761038,139.623148,2024-02-08 17:31:03
1118,C3-29.高橋是清翁記念公園,4,2,6,35.674094,139.728895,2024-02-08 17:31:03
1119,K1-141.蒲田駅西口歩道,0,4,4,35.561291,139.715076,2024-02-08 17:31:03
1120,C3-35.ワールド北青山ビル,12,4,16,35.667069,139.713423,2024-02-08 17:31:03
1121,M5-03.代々木大山公園,16,0,16,35.671282,139.675307,2024-02-08 17:31:03
1122,E5-13.弥生二丁目,4,2,6,35.715592,139.76192,2024-02-08 17:31:03
1123,E5-12.NK本郷ビル,3,1,4,35.704475,139.763041,2024-02-08 17:31:03
1124,B3-18.銀座松竹スクエア,1,9,10,35.668395,139.769849,2024-02-08 17:31:03
1125,C1-44.三田Avanti,5,1,6,35.64115,139.741471,2024-02-08 17:31:03
1126,T2-31.ファミリーマート 石神井台二丁目店,0,5,5,35.739488,139.590273,2024-02-08 17:31:03
1127,H1-150.ホテルヴィラフォンテーヌ南側,7,2,9,35.636978,139.791858,2024-02-08 17:31:03
1128,H1-149.有明ガーデン 公園口,6,2,8,35.639132,139.793047,2024-02-08 17:31:03
1129,H1-148.大島七丁目団地,0,15,15,35.694104,139.840278,2024-02-08 17:31:03
1130,B4-26.東武ストア晴海三丁目店,8,2,10,35.654371,139.779545,2024-02-08 17:31:03
1131,J1-26.田向公園,5,2,7,35.623459,139.687128,2024-02-08 17:31:03
1132,J1-25.碑文谷公園,6,2,8,35.625081,139.682632,2024-02-08 17:31:03
1133,H1-195.東京アクアティクスセンター,9,10,19,35.65238,139.815613,2024-02-08 17:31:03
1134,T1-13.ファミリーマート 練馬土支田二丁目店,2,4,6,35.761613,139.61349,2024-02-08 17:31:03
1135,T2-34.ファミリーマート 練馬富士見台店,1,4,5,35.73969,139.62125,2024-02-08 17:31:03
1136,T2-35.ファミリーマート 石神井台六丁目店,0,3,3,35.738607,139.585331,2024-02-08 17:31:03
1137,C1-81.田町タワー,16,3,19,35.646534,139.748913,2024-02-08 17:31:03
1138,J1-07.目黒川船入場,12,2,14,35.641992,139.701588,2024-02-08 17:31:03
1139,J1-08.目黒区民センター公園,18,0,18,35.634533,139.708868,2024-02-08 17:31:03
1140,D4-01.市谷仲之町,6,0,6,35.695102,139.723345,2024-02-08 17:31:03
1141,M2-11.鉢山町,15,0,15,35.652151,139.698426,2024-02-08 17:31:03
1142,E4-08.ドコモ・バイクシェア向丘ポート,7,2,9,35.720546,139.756685,2024-02-08 17:31:03
1143,D4-03.市谷加賀町2丁目,4,0,4,35.695636,139.727882,2024-02-08 17:31:03
1144,Z10.ローソン川崎浅田三丁目店,8,2,10,35.506142,139.701005,2024-02-08 17:31:03
1145,N1-01.BeGood野方,1,8,9,35.719717,139.64785,2024-02-08 17:31:03
1146,C2-03.アークヒルズサウスタワー,0,13,13,35.666357,139.73923,2024-02-08 17:31:03
1147,C2-01.アークヒルズ（アーク森ビル）,0,18,18,35.667107,139.739565,2024-02-08 17:31:03
1148,C2-02.六本木ヒルズ,9,17,26,35.661158,139.728533,2024-02-08 17:31:03
1149,C5-03.港南公園C,0,28,28,35.624966,139.746657,2024-02-08 17:31:03
1150,C5-04.みなとパーク芝浦,8,0,8,35.646801,139.751208,2024-02-08 17:31:03
1151,C1-16.機械振興会館,4,2,6,35.659442,139.745549,2024-02-08 17:31:03
1152,C1-14.新橋プラザビル,4,0,4,35.664461,139.756082,2024-02-08 17:31:03
1153,H1-73.イシマビル,5,2,7,35.67386,139.79976,2024-02-08 17:31:03
1154,O7-01.西永福公園,5,0,5,35.67753,139.63667,2024-02-08 17:31:03
1155,O6-02.富士見ヶ丘南自転車駐車場,6,2,8,35.68296,139.60861,2024-02-08 17:31:03
1156,K1-50.テクノポートカマタ 第1,2,4,6,35.556199,139.721476,2024-02-08 17:31:03
1157,J1-14.二の橋自転車置場1,37,2,39,35.614856,139.678208,2024-02-08 17:31:03
1158,O3-08.NTT井草ビル第２ポート,1,2,3,35.714077,139.61694,2024-02-08 17:31:03
1159,H1-124.セブン-イレブン 江東海辺店,12,0,12,35.680636,139.817977,2024-02-08 17:31:03
1160,D1-11.三井ガーデンホテル神宮外苑の杜プレミア,4,1,5,35.679807,139.715931,2024-02-08 17:31:03
1161,O7-07.ハレ永福,3,5,8,35.678913,139.639944,2024-02-08 17:31:03
1162,C5-32.トレードピアお台場,0,12,12,35.627891,139.776896,2024-02-08 17:31:03
1163,B4-18.豊海センタービル,3,1,4,35.653531,139.769431,2024-02-08 17:31:03
1164,D5-04.西戸山公園野球場,5,1,6,35.707388,139.700204,2024-02-08 17:31:03
1165,D5-03.北新宿公園,0,6,6,35.702288,139.68862,2024-02-08 17:31:03
1166,D3-04.鶴巻南公園,0,5,5,35.706182,139.723394,2024-02-08 17:31:03
1167,D3-03.甘泉園公園,2,0,2,35.712431,139.715418,2024-02-08 17:31:03
1168,K1-03.池上会館,0,6,6,35.576593,139.706597,2024-02-08 17:31:03
1169,K1-02.平和の森公園,14,1,15,35.579049,139.739878,2024-02-08 17:31:03
1170,K1-01.大森海苔のふるさと館,0,17,17,35.57685,139.742496,2024-02-08 17:31:03
1171,D6-13.新宿中央公園（ジャブジャブ池下）,4,5,9,35.687652,139.689254,2024-02-08 17:31:03
1172,T2-28.ファミリーマート 南大泉六丁目店,4,1,5,35.752217,139.571095,2024-02-08 17:31:03
1173,K1-05.平和島公園プール,10,7,17,35.581832,139.741581,2024-02-08 17:31:03
1174,K1-04.京急蒲田駅東口,17,1,18,35.559483,139.724273,2024-02-08 17:31:03
1175,E2-10.音羽パークロード（北入口）,15,0,15,35.716586,139.727705,2024-02-08 17:31:03
1176,E2-11.音羽パークロード（キャッチボール場横）,20,0,20,35.715382,139.728533,2024-02-08 17:31:03
1177,I1-21.大井競馬場(正門前),10,0,10,35.593887,139.741204,2024-02-08 17:31:03
1178,J1-27.衾町公園,0,1,1,35.623215,139.668472,2024-02-08 17:31:03
1179,T2-44.中島橋自転車駐車場,4,2,6,35.75372,139.584332,2024-02-08 17:31:03
1180,B3-15.ACホテル・バイ・マリオット東京銀座,0,7,7,35.668845,139.765144,2024-02-08 17:31:03
1181,D5-07.百人町1丁目,5,2,7,35.699252,139.697606,2024-02-08 17:31:03
1182,C4-04.ショパン高輪,3,2,5,35.632128,139.732097,2024-02-08 17:31:03
1183,B1-18.セブン-イレブン 日本橋小網町店,0,2,2,35.681352,139.781436,2024-02-08 17:31:03
1184,T2-71.わかば児童公園,4,3,7,35.7211,139.574669,2024-02-08 17:31:03
1185,M3-15.co-ba ebisu,0,10,10,35.647076,139.703964,2024-02-08 17:31:03
1186,C2-20.三井ガーデンホテル六本木プレミア,3,2,5,35.66206,139.735501,2024-02-08 17:31:03
1187,I1-70.五反田リバーステーション,5,3,8,35.624566,139.72448,2024-02-08 17:31:03
1188,E5-25.ジェノヴィア東大前グリーンヴェール,10,0,10,35.711875,139.759306,2024-02-08 17:31:03
1189,D1-12.ジェノヴィア新宿御苑グリーンヴェール,1,5,6,35.689017,139.714755,2024-02-08 17:31:03
1190,C5-33.msb Tamachi,25,8,33,35.645682,139.748768,2024-02-08 17:31:03
1191,G4-09.SYFORME MORISHITA Ⅱ 1,1,0,1,35.690348,139.796133,2024-02-08 17:31:03
1192,G4-10.SYFORME MORISHITA Ⅱ 2,4,0,4,35.690307,139.796128,2024-02-08 17:31:03
1193,N3-19.上高田パーキング,0,13,13,35.715878,139.673669,2024-02-08 17:31:03
1194,Z13.京急川崎日進町駐輪場,6,5,11,35.528361,139.696499,2024-02-08 17:31:03
1195,F6-01.松坂屋上野店,4,1,5,35.707305,139.773657,2024-02-08 17:31:03
1196,F4-01.SYFORME ASAKUSA,3,1,4,35.718832,139.791133,2024-02-08 17:31:03
1197,F2-02.アップルパーク浅草6丁目第3,0,2,2,35.716062,139.799552,2024-02-08 17:31:03
1198,F2-01.松が谷2丁目2,2,18,20,35.71283,139.787754,2024-02-08 17:31:03
1199,F1-02.台東デザイナーズビレッジ,2,5,7,35.706023,139.783751,2024-02-08 17:31:03
1200,F2-03.台東区生涯学習センター,1,5,6,35.717497,139.790055,2024-02-08 17:31:03
1201,K1-146.南馬込6丁目25-11,3,0,3,35.582743,139.710561,2024-02-08 17:31:03
1202,F3-01.清川1丁目18-11,1,16,17,35.724944,139.801684,2024-02-08 17:31:03
1203,F1-03.新御徒町駅自転車駐車場,2,12,14,35.706793,139.782985,2024-02-08 17:31:03
1204,F3-02.台東区リバーサイドスポーツセンター,0,7,7,35.717571,139.804216,2024-02-08 17:31:03
1205,I1-45.セブン-イレブン品川西五反田3丁目店,0,4,4,35.62541,139.718135,2024-02-08 17:31:03
1206,H1-135.北砂5丁目団地,0,21,21,35.684218,139.832843,2024-02-08 17:31:03
1207,C3-16.赤坂ガーデンシティ,0,7,7,35.6738,139.731525,2024-02-08 17:31:03
1208,J1-34.田道広場公園,10,0,10,35.636269,139.709073,2024-02-08 17:31:03
1209,O5-08.セシオン杉並,0,3,3,35.69714,139.65432,2024-02-08 17:31:03
1210,A2-04.ちよだプラットフォームスクウェア,0,22,22,35.691456,139.762228,2024-02-08 17:31:03
1211,I1-102.J.GRAN Court 品川西大井 EAST,7,0,7,35.598244,139.722447,2024-02-08 17:31:03
1212,H1-196.フットサルクラブ東京東陽町,4,2,6,35.665288,139.824294,2024-02-08 17:31:03
1213,F2-04.コンフォラス浅草マンション,0,3,3,35.717241,139.801674,2024-02-08 17:31:03
1214,G5-03.京成リッチモンドホテル東京錦糸町,0,3,3,35.693492,139.81506,2024-02-08 17:31:03
1215,K1-27.六郷文化センター,4,0,4,35.544715,139.707623,2024-02-08 17:31:03
1216,K1-147.トヨタモビリティ東京GRGarage東京蒲田店,2,0,2,35.552741,139.718404,2024-02-08 17:31:03
1217,K1-148.トヨタモビリティ東京 蒲田仲六郷店,6,0,6,35.552068,139.71747,2024-02-08 17:31:03
1218,K1-150.トヨタモビリティ東京 池上第二京浜店,4,1,5,35.568019,139.696379,2024-02-08 17:31:03
1219,K1-149.トヨタモビリティ東京 大田店,6,0,6,35.59336,139.715879,2024-02-08 17:31:03
1220,C1-82.トヨタモビリティ東京 港三田店,5,0,5,35.647831,139.739048,2024-02-08 17:31:03
1221,D4-11.トヨタモビリティ東京 新宿明治通り南店,2,0,2,35.699835,139.70808,2024-02-08 17:31:03
1222,C3-31.赤坂一丁目,8,9,17,35.670239,139.744285,2024-02-08 17:31:03
1223,E1-04.礫川公園,29,12,41,35.707853,139.751518,2024-02-08 17:31:03
1224,M3-23.円山町7-1,5,3,8,35.658229,139.694885,2024-02-08 17:31:03
1225,M3-24.渋谷道玄坂２丁目駐輪場,2,15,17,35.66026,139.69684,2024-02-08 17:31:03
1226,T3-32.練馬北町1丁目,0,6,6,35.764452,139.666299,2024-02-08 17:31:03
1227,H1-197.セブン-イレブン江東南砂葛西橋通り店,4,0,4,35.675361,139.825034,2024-02-08 17:31:03
1228,T2-84.石神井町二丁目緑地,0,3,3,35.748395,139.605958,2024-02-08 17:31:03
1229,T2-82.梅の木児童遊園,2,3,5,35.737899,139.576584,2024-02-08 17:31:03
1230,T2-83.西大泉さくら緑地,5,3,8,35.760442,139.573145,2024-02-08 17:31:03
1231,D7-05.西落合図書館,7,1,8,35.725818,139.678976,2024-02-08 17:31:03
1232,D6-28.東急ステイ新宿,0,6,6,35.690899,139.706348,2024-02-08 17:31:03
1233,T2-85.泉新公園,3,1,4,35.7547,139.601497,2024-02-08 17:31:03
1234,T2-86.石神井町八丁目緑地,2,1,3,35.746956,139.600798,2024-02-08 17:31:03
1235,T2-87.南大泉四丁目児童遊園,1,3,4,35.745607,139.573947,2024-02-08 17:31:03
1236,T2-88.南大泉かたまち緑地,0,4,4,35.739633,139.570457,2024-02-08 17:31:03
1237,T2-89.南大泉三丁目児童遊園,0,3,3,35.742755,139.568335,2024-02-08 17:31:03
1238,E2-05.護国寺駅西自転車駐車場,23,0,23,35.719421,139.725584,2024-02-08 17:31:03
1239,J1-59.第44興和ビル,0,4,4,35.647704,139.693671,2024-02-08 17:31:03
1240,C1-15.東京タワー,10,6,16,35.65928,139.744767,2024-02-08 17:31:03
1241,C5-20.ローソン芝浦二丁目店,3,1,4,35.645254,139.754765,2024-02-08 17:31:03
1242,C2-27.有栖川宮記念公園第一,17,0,17,35.651382,139.724392,2024-02-08 17:31:03
1243,C2-28.有栖川宮記念公園第二,7,1,8,35.651129,139.726003,2024-02-08 17:31:03
1244,C2-29.狸穴公園,4,1,5,35.658204,139.738935,2024-02-08 17:31:03
1245,T2-90.南田中四丁目緑地,2,2,4,35.733195,139.612327,2024-02-08 17:31:03
1246,T2-91.石神井町四丁目緑地,5,0,5,35.745272,139.604579,2024-02-08 17:31:03
1247,A3-41.秋葉原ダイビル,3,4,7,35.698917,139.771856,2024-02-08 17:31:03
1248,J1-54.田道住区センター三田分室,1,3,4,35.638904,139.712518,2024-02-08 17:31:03
1249,H1-140.キャナルパレス住吉,11,5,16,35.689896,139.815116,2024-02-08 17:31:03
1250,C1-57.虎ノ門ツインビルディング,0,31,31,35.667259,139.745643,2024-02-08 17:31:03
1251,K1-54.ファミリーマート大田久が原五丁目店,3,1,4,35.579435,139.698552,2024-02-08 17:31:03
1252,B1-29.ASTILE日本橋浜町,8,0,8,35.685504,139.790817,2024-02-08 17:31:03
1253,N3-20.SYFORME NAKANO-SAKAUE,3,2,5,35.701157,139.679617,2024-02-08 17:31:03
1254,D6-31.東急歌舞伎町タワー駐輪場,8,1,9,35.696207,139.700521,2024-02-08 17:31:03
1255,I1-30.ローソン 大井三丁目店,5,0,5,35.603327,139.729006,2024-02-08 17:31:03
1256,K1-151.PATH仲六郷,9,1,10,35.549465,139.711157,2024-02-08 17:31:03
1257,H1-198.Br Tower 有明 MID CROSS,1,6,7,35.63464,139.783445,2024-02-08 17:31:03
1258,H1-04.石と光の広場（国際展示場駅）,37,24,61,35.63363,139.79082,2024-02-08 17:31:03
1259,B4-24.ミュプレ月島,6,1,7,35.66288,139.78329,2024-02-08 17:31:03
1260,H1-199.ラ・ヴェール東陽町,10,0,10,35.664244,139.814506,2024-02-08 17:31:03
1261,H1-200.ヴェッセル木場南,3,2,5,35.662414,139.813333,2024-02-08 17:31:03
1262,F1-04.台東2丁目21,3,2,5,35.703465,139.780325,2024-02-08 17:31:03
1263,F3-03.ヴェルステージ南千住,1,4,5,35.728704,139.801867,2024-02-08 17:31:03
1264,J1-46.五本木西みどり街かど公園,2,1,3,35.632735,139.683899,2024-02-08 17:31:03
1265,Z24.総合川崎臨港病院,1,4,5,35.525854,139.717848,2024-02-08 17:31:03
1266,K1-131.東急武蔵新田駅駐輪場,11,4,15,35.567146,139.693344,2024-02-08 17:31:03
1267,K1-152.アットホームスクエア前,0,7,7,35.543327,139.703223,2024-02-08 17:31:03
1268,B2-04.清水建設本社（都営地下鉄宝町駅 Ａ８出口）,0,13,13,35.676119,139.772895,2024-02-08 17:31:03
1269,H1-202.辰巳の森海浜公園,8,4,12,35.648107,139.813572,2024-02-08 17:31:03
1270,H1-201.ウエリスアーバン水天宮前2,6,0,6,35.678099,139.791831,2024-02-08 17:31:03
1271,I1-103.五反田ＪＰビルディング,0,2,2,35.622389,139.721552,2024-02-08 17:31:03
1272,L1-16.上祖師谷7丁目,13,1,14,35.65838,139.59231,2024-02-08 17:31:03
1273,O5-09.AppCruise中野,1,1,2,35.700772,139.66063,2024-02-08 17:31:03
1274,H1-203.セブン-イレブン江東木場３丁目店,0,2,2,35.67517,139.804087,2024-02-08 17:31:03
1275,H1-44.テプコ豊洲ビル,25,0,25,35.648726,139.790877,2024-02-08 17:31:03
1276,L1-17.赤堤3丁目,2,5,7,35.659787,139.636696,2024-02-08 17:31:03
1277,L1-18.上北沢1丁目,20,10,30,35.662796,139.626795,2024-02-08 17:31:03
1278,B3-16.明石町区民館,0,17,17,35.666001,139.778102,2024-02-08 17:31:03
1279,I1-104.源氏前ビル,4,0,4,35.603521,139.712345,2024-02-08 17:31:03
1280,J1-28.宮前公園,2,1,3,35.617699,139.664826,2024-02-08 17:31:03
1281,M6-18.セブン-イレブン渋谷本町3丁目店,3,0,3,35.686521,139.685017,2024-02-08 17:31:03
1282,O7-08.杉並区和泉2-3-17,1,3,4,35.67187,139.65474,2024-02-08 17:31:03
1283,T1-17.セブン-イレブン練馬田柄通店,6,1,7,35.75987,139.640474,2024-02-08 17:31:03
1284,H1-18.東京ビッグサイト,9,7,16,35.631192,139.79401,2024-02-08 17:31:03
1285,M3-01.渋谷マークシティ,12,1,13,35.657726,139.697802,2024-02-08 17:31:03
1286,H1-70.有明スポーツセンター,11,6,17,35.63403,139.784319,2024-02-08 17:31:03
1287,H1-41.深川北スポーツセンター,12,0,12,35.676475,139.804741,2024-02-08 17:31:03
1288,H1-55.深川江戸資料館,3,4,7,35.681089,139.800777,2024-02-08 17:31:03
1289,I1-61.五反田文化センター,4,3,7,35.622588,139.716159,2024-02-08 17:31:03
1290,N3-13.中部すこやか福祉センター,5,0,5,35.700052,139.673715,2024-02-08 17:31:03
1291,A4-02.東京サンケイビル,0,17,17,35.686847,139.765151,2024-02-08 17:31:03
1292,M3-09.ティップ.クロス TOKYO 渋谷,11,8,19,35.661475,139.699296,2024-02-08 17:31:03
1293,B3-02.サンクンガーデン,3,3,6,35.670336,139.771911,2024-02-08 17:31:03
1294,T2-10.勤労福祉会館,3,2,5,35.748153,139.58765,2024-02-08 17:31:03
1295,K1-133.東京港野鳥公園,12,1,13,35.584217,139.759232,2024-02-08 17:31:03
1296,K1-21.六郷特別出張所,0,4,4,35.55079,139.716517,2024-02-08 17:31:03
1297,H1-54.砂町文化センター,8,12,20,35.680052,139.831874,2024-02-08 17:31:03
1298,D1-08.新宿歴史博物館,3,1,4,35.689984,139.725261,2024-02-08 17:31:03
1299,E1-05.春日地下自転車駐車場,24,3,27,35.708291,139.753335,2024-02-08 17:31:03
1300,E1-15.播磨坂事業所,5,0,5,35.71724,139.74289,2024-02-08 17:31:03
1301,E5-02.不忍通りふれあい館,8,3,11,35.719356,139.764308,2024-02-08 17:31:03
1302,E4-02.向丘地域活動センター,9,4,13,35.717357,139.757817,2024-02-08 17:31:03
1303,C3-18.明治記念館,4,1,5,35.678509,139.721207,2024-02-08 17:31:03
1304,D5-05.中央図書館,12,3,15,35.705018,139.706841,2024-02-08 17:31:03
1305,E2-07.肥後細川庭園,13,0,13,35.713223,139.721699,2024-02-08 17:31:03
1306,A1-05.富士見出張所,3,0,3,35.699187,139.746348,2024-02-08 17:31:03
1307,E5-07.湯島三丁目児童遊園,6,2,8,35.707296,139.769393,2024-02-08 17:31:03
1308,D5-10.桜美林大学 新宿キャンパス,1,6,7,35.705154,139.697562,2024-02-08 17:31:03
1309,A3-08.神田明神（神田神社）,9,4,13,35.702029,139.768245,2024-02-08 17:31:03
1310,E2-14.永青文庫 ミュージアム,5,0,5,35.713145,139.723342,2024-02-08 17:31:03
1311,M5-17.小田急サザンタワー,8,1,9,35.6866,139.70014,2024-02-08 17:31:03
1312,K1-16.ファミリーマート 矢口二丁目店,6,0,6,35.563092,139.693548,2024-02-08 17:31:03
1313,H1-206.北砂5丁目団地2,0,7,7,35.683866,139.831809,2024-02-08 17:31:03
1314,G1-02.八広駅高架下,4,10,14,35.727495,139.828499,2024-02-08 17:31:03
1315,F4-02.Risingplace浅草四番館,0,4,4,35.717963,139.791025,2024-02-08 17:31:03
1316,H1-204.大島四丁目団地2,7,1,8,35.68832,139.828829,2024-02-08 17:31:03
1317,H1-205.大島四丁目団地3,8,1,9,35.688236,139.827711,2024-02-08 17:31:03
1318,H1-106.亀戸中央公園,15,4,19,35.699874,139.834263,2024-02-08 17:31:03
1319,E5-30.湯島3丁目15,2,8,10,35.705148,139.769314,2024-02-08 17:31:03
1320,B4-38.HARUMI FLAG SUN VILLAGE,0,22,22,35.650347,139.771785,2024-02-08 17:31:03
1321,B4-32.HARUMI FLAG SEA VILLAGE,2,9,11,35.648731,139.774995,2024-02-08 17:31:03
1322,B4-31.HARUMI FLAG PORT VILLAGE,0,19,19,35.650604,139.77724,2024-02-08 17:31:03
1323,B4-33.HARUMI FLAG SEA VILLAGE,0,15,15,35.649552,139.776369,2024-02-08 17:31:03
1324,B4-36.HARUMI FLAG SEA VILLAGE,3,9,12,35.650742,139.778097,2024-02-08 17:31:03
1325,B4-35.HARUMI FLAG SEA VILLAGE,5,7,12,35.650573,139.777908,2024-02-08 17:31:03
1326,B4-37.HARUMI FLAG SUN VILLAGE,0,15,15,35.649419,139.771447,2024-02-08 17:31:03
1327,B4-34.HARUMI FLAG SEA VILLAGE,4,8,12,35.649932,139.776958,2024-02-08 17:31:03
1328,B4-39.HARUMI FLAG SUN VILLAGE,0,15,15,35.650863,139.772549,2024-02-08 17:31:03
1329,B4-40.HARUMI FLAG SUN VILLAGE,0,16,16,35.651305,139.773379,2024-02-08 17:31:03
1330,B4-41.HARUMI FLAG SUN VILLAGE,0,13,13,35.649854,139.77334,2024-02-08 17:31:03
1331,B4-42.HARUMI FLAG SUN VILLAGE,1,10,11,35.649329,139.772656,2024-02-08 17:31:03
1332,B4-28.HARUMI FLAG PORT VILLAGE,0,13,13,35.651183,139.776119,2024-02-08 17:31:03
1333,B4-50.HARUMI FLAG PARK VILLAGE,4,5,9,35.648295,139.773973,2024-02-08 17:31:03
1334,B4-49.HARUMI FLAG PARK VILLAGE,6,10,16,35.648636,139.774251,2024-02-08 17:31:03
1335,B4-48.HARUMI FLAG PARK VILLAGE,0,4,4,35.649513,139.775287,2024-02-08 17:31:03
1336,B4-47.HARUMI FLAG PARK VILLAGE,2,4,6,35.649119,139.775138,2024-02-08 17:31:03
1337,B4-46.HARUMI FLAG PARK VILLAGE,0,26,26,35.649642,139.773859,2024-02-08 17:31:03
1338,B4-45.HARUMI FLAG PARK VILLAGE,0,24,24,35.649002,139.772764,2024-02-08 17:31:03
1339,B4-44.HARUMI FLAG PARK VILLAGE,3,10,13,35.648221,139.772666,2024-02-08 17:31:03
1340,B4-30.HARUMI FLAG PORT VILLAGE,3,8,11,35.651136,139.778218,2024-02-08 17:31:03
1341,B4-29.HARUMI FLAG PORT VILLAGE,5,6,11,35.651907,139.777391,2024-02-08 17:31:03
1342,L1-19.三軒茶屋1丁目駐輪場,1,3,4,35.639302,139.674744,2024-02-08 17:31:03
1343,O7-09.方南月極パーキング,11,6,17,35.678921,139.658289,2024-02-08 17:31:03
1344,O5-10.ローソン ツルハドラッグ杉並和田店,1,3,4,35.68942,139.662118,2024-02-08 17:31:03
1345,O2-04.西荻北1丁目,2,3,5,35.708082,139.607543,2024-02-08 17:31:03
1346,K1-75.三井不動産インダストリアルパーク羽田,0,12,12,35.556231,139.751408,2024-02-08 17:31:03
1347,F1-05.ホウエイコート秋葉原,1,0,1,35.703024,139.78052,2024-02-08 17:31:03
1348,C3-36.第35興和ビル,1,2,3,35.666349,139.741781,2024-02-08 17:31:03
1349,B4-53.晴海五丁目ターミナル,28,78,106,35.651627,139.773103,2024-02-08 17:31:03
1350,C5-44.ブランズタワー芝浦,9,0,9,35.643105,139.753039,2024-02-08 17:31:03
1351,A3-47.ホテルヴィラフォンテーヌ東京大手町,13,0,13,35.690602,139.766916,2024-02-08 17:31:03
1352,A1-20.菱和パレス九段,4,1,5,35.693021,139.740317,2024-02-08 17:31:03
0,E5-26.本郷4丁目,0,5,5,35.708596,139.758269,2024-02-08 13:08:04
1,A3-42.内神田3丁目,30,3,33,35.692599,139.770109,2024-02-08 13:08:04
2,T2-76.東中前の森緑地,3,2,5,35.748736,139.574839,2024-02-08 13:08:04
3,A2-20.神田スクエア,19,0,19,35.693408,139.762809,2024-02-08 13:08:04
4,K1-79.Tマークシティホテル東京大森,3,4,7,35.586993,139.736491,2024-02-08 13:08:04
5,K1-80.大森北6丁目,1,3,4,35.579849,139.731241,2024-02-08 13:08:04
6,H1-130.トヨタモビリティ東京 深川店,3,7,10,35.676643,139.816054,2024-02-08 13:08:04
7,H1-131.セブン-イレブン 江東佐賀2丁目店,0,18,18,35.679029,139.793535,2024-02-08 13:08:04
8,H1-132.セブン-イレブン 江東三好4丁目店,0,37,37,35.681418,139.809287,2024-02-08 13:08:04
9,A6-22.半蔵門PREX South,12,3,15,35.683433,139.740756,2024-02-08 13:08:04
10,I1-74.セブン-イレブン西五反田6丁目店,2,4,6,35.622403,139.71771,2024-02-08 13:08:04
11,G2-01.東京ソラマチ,3,4,7,35.709777,139.810189,2024-02-08 13:08:04
12,T2-59.平成公園,2,1,3,35.722917,139.587864,2024-02-08 13:08:04
13,I1-26.大崎西口公園,0,8,8,35.617475,139.729221,2024-02-08 13:08:04
14,I1-96.西五反田２丁目,10,0,10,35.627599,139.720463,2024-02-08 13:08:04
15,H1-172.サンヨーパシフィックマンション,0,11,11,35.668856,139.794069,2024-02-08 13:08:04
16,J1-56.青葉台四丁目街かど公園,3,1,4,35.654009,139.692727,2024-02-08 13:08:04
17,H1-173.森下駅前,6,34,40,35.687837,139.79654,2024-02-08 13:08:04
18,E3-01.大塚地域活動センター跡地,5,5,10,35.718656,139.734556,2024-02-08 13:08:04
19,E2-03.目白台運動公園,27,14,41,35.715556,139.721988,2024-02-08 13:08:04
20,T2-77.大泉なかよし緑地,3,1,4,35.759861,139.581682,2024-02-08 13:08:04
21,E2-01.江戸川橋Ｂ自転車駐車場,44,37,81,35.710381,139.732137,2024-02-08 13:08:04
22,E2-02.江戸川公園,9,10,19,35.710958,139.731165,2024-02-08 13:08:04
23,D7-14.大栄パーク西落合１丁目,4,2,6,35.720028,139.678936,2024-02-08 13:08:04
24,E1-07.礫川地域活動センター,0,8,8,35.712015,139.750284,2024-02-08 13:08:04
25,M6-05.七号通り公園,0,14,14,35.67917,139.67493,2024-02-08 13:08:04
26,H1-138.HW.HILLS新大橋,0,11,11,35.687416,139.795588,2024-02-08 13:08:04
27,B4-21.月島駅前第一駐輪場,15,19,34,35.663681,139.785651,2024-02-08 13:08:04
28,N2-03.野方1丁目,5,2,7,35.712179,139.65603,2024-02-08 13:08:04
29,C5-52.港南四丁目第3アパート駐車場,7,4,11,35.630109,139.747094,2024-02-08 13:08:04
30,E5-27.真正館駐車場,0,4,4,35.714875,139.76394,2024-02-08 13:08:04
31,C5-35.品川駅港南口,5,0,5,35.62822,139.741135,2024-02-08 13:08:04
32,N2-01.NTT野方ビル,3,2,5,35.710285,139.66173,2024-02-08 13:08:04
33,D6-27.新宿三井ビルディング二号館,8,1,9,35.686334,139.692881,2024-02-08 13:08:04
34,D1-10.曙橋駐輪場,3,13,16,35.691888,139.724365,2024-02-08 13:08:04
35,I1-39.MID POINT 目黒不動前,3,2,5,35.628116,139.713149,2024-02-08 13:08:04
36,E3-07.小日向1丁目,0,20,20,35.713388,139.737009,2024-02-08 13:08:04
37,C1-47.パークプレイス三田,8,1,9,35.641791,139.740734,2024-02-08 13:08:04
38,I1-38.ローソン 八潮三丁目店,25,20,45,35.594544,139.760423,2024-02-08 13:08:04
39,C2-24.Dash Living HigashiAzabu,6,0,6,35.655135,139.744449,2024-02-08 13:08:04
40,J1-04.菅刈公園,7,1,8,35.650351,139.692853,2024-02-08 13:08:04
41,O4-09.ローソン杉並本天沼一丁目店,0,3,3,35.712496,139.632778,2024-02-08 13:08:04
42,T3-29.平和台もものき緑地,1,2,3,35.755773,139.661913,2024-02-08 13:08:04
43,D2-10.市谷砂土原町3丁目,3,9,12,35.696242,139.735776,2024-02-08 13:08:04
44,C1-48.竹芝客船ターミナル,10,5,15,35.655139,139.762812,2024-02-08 13:08:04
45,B1-06.伊場仙ビル,3,2,5,35.687624,139.777125,2024-02-08 13:08:04
46,B2-01.鉄砲洲児童公園（西側）,0,23,23,35.67224,139.779348,2024-02-08 13:08:04
47,B1-04.産業会館,1,4,5,35.694164,139.787057,2024-02-08 13:08:04
48,B1-05.日本橋保健センター,0,11,11,35.687419,139.779053,2024-02-08 13:08:04
49,B2-05.ＮＴＴ東日本築地ビル,0,11,11,35.670674,139.775993,2024-02-08 13:08:04
50,B2-02.柳通り（東京スクエアガーデン前）,12,0,12,35.676393,139.768319,2024-02-08 13:08:04
51,B2-03.男女平等センター（ブーケ21）,8,3,11,35.673923,139.778671,2024-02-08 13:08:04
52,C2-13.麻布運動場,8,0,8,35.651718,139.728165,2024-02-08 13:08:04
53,D2-08.旧市ヶ谷商業高校,0,16,16,35.70074,139.731363,2024-02-08 13:08:04
54,C1-35.セブン-イレブン 三田駅北店,3,2,5,35.649032,139.750147,2024-02-08 13:08:04
55,B4-12.THE TOKYO TOWERS,0,98,98,35.655497,139.774556,2024-02-08 13:08:04
56,C5-21.セブン-イレブン 芝浦3丁目店,4,2,6,35.642399,139.746992,2024-02-08 13:08:04
57,H1-67.セブン-イレブン 江東亀戸9丁目店,0,15,15,35.69766,139.843408,2024-02-08 13:08:04
58,C2-15.住友不動産六本木グランドタワー,0,13,13,35.664367,139.737185,2024-02-08 13:08:04
59,C2-14.元麻布ヒルズ,1,9,10,35.653608,139.73138,2024-02-08 13:08:04
60,M6-14.ドコモショップ笹塚店,0,5,5,35.67323,139.66393,2024-02-08 13:08:04
61,N4-07.南台2丁目,2,10,12,35.68509,139.671102,2024-02-08 13:08:04
62,K1-68.ART FACTORY 城南島,6,2,8,35.580511,139.775957,2024-02-08 13:08:04
63,H1-178.北砂7丁目団地(第二),0,4,4,35.678031,139.837193,2024-02-08 13:08:04
64,H1-179.北砂7丁目団地(第三),0,11,11,35.678246,139.8366,2024-02-08 13:08:04
65,A1-17.雉子橋集積所,6,0,6,35.692605,139.755761,2024-02-08 13:08:04
66,H1-177.北砂7丁目団地(第一),0,13,13,35.678537,139.837391,2024-02-08 13:08:04
67,K1-95.城南島海浜公園,11,5,16,35.578259,139.783505,2024-02-08 13:08:04
68,B3-17.銀座6丁目-SQUARE,7,0,7,35.66711,139.76643,2024-02-08 13:08:04
69,J1-33.芳窪街かど公園,12,1,13,35.629861,139.666293,2024-02-08 13:08:04
70,N3-07.なかのZERO,2,3,5,35.70442,139.67141,2024-02-08 13:08:04
71,N4-04.弥生町5丁目,3,9,12,35.690897,139.668345,2024-02-08 13:08:04
72,A3-44.THE WAVES AKIHABARA,0,5,5,35.694679,139.779504,2024-02-08 13:08:04
73,K1-138.羽田エアポートガーデン,6,3,9,35.544534,139.763244,2024-02-08 13:08:04
74,C3-26.ホテルリブマックス赤坂,2,3,5,35.67011,139.733375,2024-02-08 13:08:04
75,C1-52.NTT三田ビル,3,3,6,35.652549,139.747789,2024-02-08 13:08:04
76,D1-07.Dash Living Shinjuku,4,0,4,35.689757,139.710091,2024-02-08 13:08:04
77,O4-07.ローソン成田西三丁目店,0,5,5,35.690311,139.62178,2024-02-08 13:08:04
78,H1-152.コンポジット亀戸ウエスト,0,10,10,35.699187,139.82429,2024-02-08 13:08:04
79,E1-13.エルアージュ小石川,0,40,40,35.71399,139.75137,2024-02-08 13:08:04
80,B4-22.リビオレゾン勝どきNEX,0,46,46,35.65554,139.77102,2024-02-08 13:08:04
81,H1-176.JMFビル東陽町02,3,3,6,35.667677,139.823552,2024-02-08 13:08:04
82,H1-102.ファミリーマート東砂七丁目店,0,17,17,35.672714,139.837914,2024-02-08 13:08:04
83,H1-101.ファミリーマート新木場一丁目店,5,1,6,35.642571,139.836766,2024-02-08 13:08:04
84,K1-67.京浜島防災広場,0,15,15,35.570508,139.764013,2024-02-08 13:08:04
85,K1-66.昭和島二丁目公園,0,12,12,35.575097,139.751446,2024-02-08 13:08:04
86,I1-80.リバーサイド品川港南ビル,5,5,10,35.622714,139.74471,2024-02-08 13:08:04
87,J1-10.NTTデータ駒場研修センター,6,4,10,35.655779,139.680948,2024-02-08 13:08:04
88,A2-17.竹橋ビル,8,0,8,35.692396,139.75639,2024-02-08 13:08:04
89,H1-91.亀戸駅北口第三自転車駐車場,13,5,18,35.696913,139.823911,2024-02-08 13:08:04
90,H1-92.亀戸駅東口第二自転車駐車場,7,7,14,35.69788,139.830559,2024-02-08 13:08:04
91,K1-59.京急梅屋敷第1駐車場,6,1,7,35.565768,139.727396,2024-02-08 13:08:04
92,K1-60.京急平和島第1駐車場,2,7,9,35.576336,139.733691,2024-02-08 13:08:04
93,I1-42.京急青横駐車場,3,0,3,35.611582,139.742528,2024-02-08 13:08:04
94,I1-43.京急南大井駐車場,1,8,9,35.594722,139.737101,2024-02-08 13:08:04
95,O7-05.ジーベック方南町,1,0,1,35.680849,139.65626,2024-02-08 13:08:04
96,H1-100.URアーバンライフ亀戸,21,8,29,35.697935,139.821855,2024-02-08 13:08:04
97,A6-10.紀尾井町ビル（西側）,9,3,12,35.682516,139.736494,2024-02-08 13:08:04
98,C3-02.赤坂地区総合支所,0,7,7,35.674788,139.731423,2024-02-08 13:08:04
99,C2-08.ファミリーマート西麻布霞町店,0,9,9,35.661673,139.721118,2024-02-08 13:08:04
100,A6-09.紀尾井町ビル（北側）,6,0,6,35.682902,139.736494,2024-02-08 13:08:04
101,H1-28.有明客船ターミナル,10,1,11,35.630063,139.792209,2024-02-08 13:08:04
102,B1-12.ファミリーマート堀留町二丁目店,0,7,7,35.687786,139.78205,2024-02-08 13:08:04
103,H1-26.青海客船ターミナル,15,0,15,35.619234,139.774485,2024-02-08 13:08:04
104,H1-27.パレットタウン乗船場,10,0,10,35.624467,139.781305,2024-02-08 13:08:04
105,O1-04.井草1-34,7,8,15,35.72758,139.62432,2024-02-08 13:08:04
106,C1-76.浜松町駅北口交通広場(ハマサイト前),14,2,16,35.656647,139.758301,2024-02-08 13:08:04
107,J1-52.駒沢一丁目公園前,7,2,9,35.629807,139.662398,2024-02-08 13:08:04
108,C1-75.虎ノ門PFビル,6,1,7,35.665466,139.748014,2024-02-08 13:08:04
109,B2-18.旭ビルディング,11,0,11,35.678291,139.78157,2024-02-08 13:08:04
110,N2-09.松山駐車場No.1,2,4,6,35.722991,139.673048,2024-02-08 13:08:04
111,I1-82.トミンハイム西五反田四丁目,3,3,6,35.627386,139.711182,2024-02-08 13:08:04
112,O4-03.ザ・ハウス,0,12,12,35.707035,139.633066,2024-02-08 13:08:04
113,O4-04.阿佐谷南3-43,15,1,16,35.704147,139.631955,2024-02-08 13:08:04
114,K1-83.北千束北児童公園,6,0,6,35.611085,139.68599,2024-02-08 13:08:04
115,I1-95.東京レールゲート EAST,8,0,8,35.584998,139.761055,2024-02-08 13:08:04
116,M5-19.グランリヴィエール代々木,2,3,5,35.68285,139.698528,2024-02-08 13:08:04
117,H1-192.ウエリスアーバン水天宮前,3,1,4,35.678296,139.791949,2024-02-08 13:08:04
118,N2-08.江古田区民活動センター,3,1,4,35.728893,139.670119,2024-02-08 13:08:04
119,D7-04.セブン-イレブン 新宿下落合3丁目店,1,2,3,35.722645,139.701982,2024-02-08 13:08:04
120,K1-82.西蒲田公園,7,0,7,35.561499,139.71123,2024-02-08 13:08:04
121,H1-68.芝浦工業大学附属中学高等学校,0,37,37,35.649274,139.792213,2024-02-08 13:08:04
122,K1-24.東糀谷防災公園,0,16,16,35.557074,139.74575,2024-02-08 13:08:04
123,H1-03.東雲駅,13,2,15,35.640736,139.804331,2024-02-08 13:08:04
124,K1-26.大森諏訪公園,0,15,15,35.574785,139.730762,2024-02-08 13:08:04
125,K1-25.鶴渡公園,2,1,3,35.56892,139.725082,2024-02-08 13:08:04
126,N3-10.エーエスホームズⅡ駐車場,5,1,6,35.702659,139.662563,2024-02-08 13:08:04
127,J1-37.中目黒公園,12,6,18,35.640398,139.704069,2024-02-08 13:08:04
128,A1-10.ヒューリック九段ビル,6,0,6,35.696449,139.750784,2024-02-08 13:08:04
129,K1-93.六間堀仲羽公園,2,2,4,35.548864,139.74484,2024-02-08 13:08:04
130,T2-53.上練馬公園,2,2,4,35.772863,139.626969,2024-02-08 13:08:04
131,M5-01.初台駅南口,2,10,12,35.680154,139.685937,2024-02-08 13:08:04
132,C1-60.専売ビル,11,3,14,35.647659,139.745055,2024-02-08 13:08:04
133,K1-85.大田区青少年交流センター ゆいっつ,3,1,4,35.583555,139.743381,2024-02-08 13:08:04
134,I1-64.株式会社ユアス ゆうパック取扱所：ポストのうしろ,8,2,10,35.622965,139.731014,2024-02-08 13:08:04
135,C4-09.ケーヨーデイツー三田店,0,5,5,35.646375,139.740061,2024-02-08 13:08:04
136,C1-61.環三浜松町駅南,23,15,38,35.653096,139.75739,2024-02-08 13:08:04
137,K1-84.佐伯山緑地,0,13,13,35.581698,139.71491,2024-02-08 13:08:04
138,C1-59.セレスティン芝三井ビルディング,5,8,13,35.650845,139.748346,2024-02-08 13:08:04
139,G2-07.レオーネ押上cube,3,1,4,35.706167,139.815955,2024-02-08 13:08:04
140,E1-06.文京シビックセンター,11,9,20,35.708265,139.751983,2024-02-08 13:08:04
141,D2-13.THE CENTER TOKYO,0,24,24,35.695646,139.725722,2024-02-08 13:08:04
142,E5-22.千駄木2丁目,1,5,6,35.724828,139.762583,2024-02-08 13:08:04
143,C4-07.品川プリンスホテル,9,1,10,35.628266,139.734171,2024-02-08 13:08:04
144,A3-43.unito CHIYODA,0,4,4,35.69474,139.77929,2024-02-08 13:08:04
145,C4-06.白金プラチナレジデンス,0,22,22,35.644134,139.723432,2024-02-08 13:08:04
146,I1-63.セブン-イレブン西五反田店,3,0,3,35.62765,139.719212,2024-02-08 13:08:04
147,H1-53.豊洲シビックセンター,16,2,18,35.653991,139.795513,2024-02-08 13:08:04
148,T3-16.練馬区役所東庁舎(第一),10,0,10,35.735428,139.652379,2024-02-08 13:08:04
149,T2-68.さくら原っぱ緑地,2,3,5,35.731372,139.619164,2024-02-08 13:08:04
150,T2-69.久保新田さくら公園,0,4,4,35.76525,139.575978,2024-02-08 13:08:04
151,H1-187.森下文化センター,0,5,5,35.685344,139.80234,2024-02-08 13:08:04
152,E4-04.セブン-イレブン 文京本駒込１丁目店,0,5,5,35.724707,139.750469,2024-02-08 13:08:04
153,M2-13.恵比寿プライムスクエアタワー南,8,0,8,35.649257,139.713272,2024-02-08 13:08:04
154,H1-48.セブン-イレブン 江東潮見２丁目店,0,8,8,35.658249,139.815775,2024-02-08 13:08:04
155,H1-51.豊洲交通広場　東,25,1,26,35.654958,139.795718,2024-02-08 13:08:04
156,H1-52.辰巳駅,12,3,15,35.646756,139.809295,2024-02-08 13:08:04
157,D7-01.下落合図書館,5,10,15,35.715894,139.698578,2024-02-08 13:08:04
158,H1-50.豊洲交通広場　北,8,3,11,35.655457,139.795161,2024-02-08 13:08:04
159,A6-14.MG市ヶ谷ビルディング,0,2,2,35.690861,139.736393,2024-02-08 13:08:04
160,T2-21.ファミリーマート 練馬大泉町一丁目店,2,2,4,35.768448,139.601679,2024-02-08 13:08:04
161,A6-15.東急番町ビル,4,1,5,35.688929,139.7358,2024-02-08 13:08:04
162,A1-18.東京区政会館別館(特別区研修所),3,1,4,35.696202,139.752351,2024-02-08 13:08:04
163,T3-18.練馬駅北,10,9,19,35.738585,139.653396,2024-02-08 13:08:04
164,C1-43.KDX浜松町プレイス,3,3,6,35.658169,139.752509,2024-02-08 13:08:04
165,C5-27.プレミア海岸ビル,10,11,21,35.648948,139.757895,2024-02-08 13:08:04
166,I1-29.ローソン 勝島一丁目店,0,20,20,35.599987,139.745195,2024-02-08 13:08:04
167,H1-72.ネクストサイト深川ビル,20,1,21,35.674578,139.797396,2024-02-08 13:08:04
168,T1-11.むつみ台,0,3,3,35.768528,139.639807,2024-02-08 13:08:04
169,T1-10.月見大橋下,5,0,5,35.758366,139.628982,2024-02-08 13:08:04
170,H1-167.大島八丁目公園,1,9,10,35.688074,139.838932,2024-02-08 13:08:04
171,K1-36.セブン-イレブン 大田区南雪谷5丁目店,0,12,12,35.587815,139.691748,2024-02-08 13:08:04
172,L1-01.羽根木公園,5,6,11,35.66088,139.654546,2024-02-08 13:08:04
173,P1-02.雑司ヶ谷一丁目,8,0,8,35.721738,139.723103,2024-02-08 13:08:04
174,I1-66.南大井文化センター駐車場,2,4,6,35.596733,139.73804,2024-02-08 13:08:04
175,L1-05.NTT烏山ビル,0,4,4,35.669285,139.597931,2024-02-08 13:08:04
176,L1-04.下馬中央公園,0,5,5,35.63367,139.678139,2024-02-08 13:08:04
177,L1-03.世田谷城阯公園,0,6,6,35.645838,139.647799,2024-02-08 13:08:04
178,L1-02.若林公園,5,2,7,35.647075,139.654472,2024-02-08 13:08:04
179,T2-30.ファミリーマート 練馬東大泉四丁目店,4,0,4,35.750804,139.58243,2024-02-08 13:08:04
180,L1-07.NTT成城ビル,2,1,3,35.648021,139.606529,2024-02-08 13:08:04
181,L1-06.NTT瀬田ビル,0,12,12,35.618357,139.626191,2024-02-08 13:08:04
182,T3-12.春日町西公園,3,1,4,35.748092,139.636587,2024-02-08 13:08:04
183,T3-13.平和台児童公園,2,2,4,35.757298,139.664139,2024-02-08 13:08:04
184,T2-38.ファミリーマート 練馬上石神井四丁目店,7,2,9,35.727195,139.590179,2024-02-08 13:08:04
185,B1-28.アイルイムーブル日本橋,9,0,9,35.684502,139.77906,2024-02-08 13:08:04
186,A2-28.NTTコミュニケーションズ一ツ橋ビル駐車場,8,0,8,35.6915,139.75685,2024-02-08 13:08:04
187,C3-32.乃木公園,4,1,5,35.667936,139.72745,2024-02-08 13:08:04
188,T3-14.わらべ児童遊園,3,1,4,35.759774,139.654529,2024-02-08 13:08:04
189,T2-52.田柄中央児童公園,2,3,5,35.762395,139.641522,2024-02-08 13:08:04
190,M4-06.THE SHARE 原宿,9,0,9,35.671823,139.708158,2024-02-08 13:08:04
191,K1-10.セブン‐イレブン 大田区西糀谷１丁目店,1,3,4,35.559647,139.730098,2024-02-08 13:08:04
192,K1-09.セブン‐イレブン 大田区西蒲田２丁目店,0,23,23,35.570763,139.705895,2024-02-08 13:08:04
193,H1-63.東京スイソミル,0,14,14,35.65637,139.811765,2024-02-08 13:08:04
194,B1-16.小網町児童遊園,5,1,6,35.683695,139.780043,2024-02-08 13:08:04
195,H1-61.Brilliaランニングスタジアムマギーズ東京前,7,2,9,35.648281,139.786112,2024-02-08 13:08:04
196,K1-08.セブン‐イレブン 大田区東蒲田キネマ通り店,0,6,6,35.562368,139.730143,2024-02-08 13:08:04
197,C1-34.城山ガーデン,8,0,8,35.664479,139.743731,2024-02-08 13:08:04
198,H1-62.扇橋一丁目公園南,0,42,42,35.683343,139.812161,2024-02-08 13:08:04
199,J1-23.清水池公園,9,14,23,35.623756,139.692517,2024-02-08 13:08:04
200,C5-18.パークタワー品川ベイワード,8,11,19,35.634529,139.748378,2024-02-08 13:08:04
201,E4-07.ファミリーマート 本駒込二丁目店,3,1,4,35.727279,139.74627,2024-02-08 13:08:04
202,C5-45.パークアクシス芝浦キャナル,1,8,9,35.644794,139.755688,2024-02-08 13:08:04
203,A2-02.西神田公園（北側）,5,4,9,35.698591,139.755113,2024-02-08 13:08:04
204,T2-49.善福寺公園テニスクラブ,5,4,9,35.719674,139.593696,2024-02-08 13:08:04
205,H1-193.ライフ豊洲店,27,0,27,35.651833,139.79962,2024-02-08 13:08:04
206,A2-01.神田駿河台下,52,1,53,35.695762,139.761585,2024-02-08 13:08:04
207,I1-51.京急鈴ヶ森駐車場,0,14,14,35.589573,139.735585,2024-02-08 13:08:04
208,T2-36.サントピア テニスパーク,4,6,10,35.75195,139.616028,2024-02-08 13:08:04
209,G4-13. Parking in 両国駅前第2,0,3,3,35.696492,139.791591,2024-02-08 13:08:04
210,K1-120.蒲田駅消費者生活センター横自転車駐車場 屋上部,6,0,6,35.560125,139.71569,2024-02-08 13:08:04
211,N3-18.藤和シティコープ新中野3,4,2,6,35.69942,139.673964,2024-02-08 13:08:04
212,K1-145.トヨタモビリティ東京馬込テクニカル研修センター,6,7,13,35.58209,139.701362,2024-02-08 13:08:04
213,K1-100.多摩川台公園,5,0,5,35.589794,139.666955,2024-02-08 13:08:04
214,C1-54.ニッセイ虎ノ門ビル,12,0,12,35.664344,139.746662,2024-02-08 13:08:04
215,I1-52.カスタリアタワー品川シーサイド,7,2,9,35.607557,139.746866,2024-02-08 13:08:04
216,I1-53.天王洲公園,3,1,4,35.620355,139.749339,2024-02-08 13:08:04
217,C2-18.ブランシェ東麻布,0,3,3,35.656769,139.743224,2024-02-08 13:08:04
218,A3-45.鍛冶町2丁目,13,4,17,35.691578,139.77138,2024-02-08 13:08:04
219,H1-87.パークアクシス木場キャナルウエスト,0,26,26,35.662514,139.803694,2024-02-08 13:08:04
220,D6-20.淀橋けやき橋公園,5,10,15,35.693544,139.685806,2024-02-08 13:08:04
221,A3-46.神田須田町2丁目,0,0,0,35.695457,139.772972,2024-02-08 13:08:04
222,B3-13.国立がん研究センター,11,0,11,35.664871,139.767188,2024-02-08 13:08:04
223,I1-35.シーフォートスクエア,18,0,18,35.622954,139.750593,2024-02-08 13:08:04
224,K1-55.カバヤビル,6,12,18,35.576275,139.713704,2024-02-08 13:08:04
225,C3-24.SHARE GREEN 南青山 西エントランス,0,7,7,35.668419,139.724676,2024-02-08 13:08:04
226,A5-06.APA HOTEL PRIDE〈国会議事堂前〉,10,0,10,35.674468,139.741328,2024-02-08 13:08:04
227,A6-17.東京ガーデンテラス紀尾井町（プリンス通り側）,12,0,12,35.680431,139.738203,2024-02-08 13:08:04
228,B4-07.勝どき駅地下駐輪場,58,3,61,35.658135,139.776131,2024-02-08 13:08:04
229,B4-08.東京ミッドベイ勝どき（西仲通り）,1,17,18,35.656449,139.771302,2024-02-08 13:08:04
230,B3-04.築地市場駅地下駐輪場,17,0,17,35.664265,139.767426,2024-02-08 13:08:04
231,C5-10.シーバンス,11,3,14,35.649959,139.756068,2024-02-08 13:08:04
232,H1-34.門前仲町駅,48,3,51,35.67391,139.796165,2024-02-08 13:08:04
233,C3-10.ファミリーマート特許庁前店,0,6,6,35.670364,139.744684,2024-02-08 13:08:04
234,A1-01.千代田区役所,6,0,6,35.693799,139.753281,2024-02-08 13:08:04
235,A1-03.東京区政会館（メトロA5出口）,7,0,7,35.701073,139.747525,2024-02-08 13:08:04
236,B3-06.朝日新聞東京本社,4,0,4,35.664457,139.767214,2024-02-08 13:08:04
237,A1-04.東京区政会館（西側駐輪場）,7,0,7,35.701347,139.746951,2024-02-08 13:08:04
238,T1-03.四季の香公園,5,0,5,35.760585,139.626284,2024-02-08 13:08:04
239,T1-04.春の風公園,3,0,3,35.75731,139.624922,2024-02-08 13:08:04
240,T1-05.夏の雲公園,5,0,5,35.753964,139.629116,2024-02-08 13:08:04
241,H1-194.セブン-イレブン江東北砂5丁目店,0,5,5,35.68268,139.8353,2024-02-08 13:08:04
242,O5-03.新高円寺地下自転車駐輪場,5,9,14,35.697265,139.649397,2024-02-08 13:08:04
243,O3-06.アミーズ荻窪,3,1,4,35.714616,139.625116,2024-02-08 13:08:04
244,T2-03.リヴィンオズ大泉店,7,1,8,35.752383,139.594855,2024-02-08 13:08:04
245,O6-06.上高井戸1丁目,0,7,7,35.673055,139.611293,2024-02-08 13:08:04
246,T2-05.石神井図書館,3,1,4,35.736076,139.599676,2024-02-08 13:08:04
247,T2-06.総合体育館,2,1,3,35.748957,139.621385,2024-02-08 13:08:04
248,O5-02.馬橋ハイツ,4,2,6,35.705686,139.642587,2024-02-08 13:08:04
249,N1-07.プランドール上鷺宮,1,6,7,35.733292,139.630369,2024-02-08 13:08:04
250,E1-18.アーバネックス小石川春日,0,8,8,35.709261,139.746374,2024-02-08 13:08:04
251,T3-03.新桜台駅自転車駐車場,4,3,7,35.740378,139.667502,2024-02-08 13:08:04
252,O3-05.Nちゃりパーク,15,6,21,35.70389,139.6185,2024-02-08 13:08:04
253,O5-01.朝霞ハイツ,7,4,11,35.71038,139.64519,2024-02-08 13:08:04
254,L1-11.アイムタウン上祖師谷,2,1,3,35.656849,139.594422,2024-02-08 13:08:04
255,L1-12.鈴木リースホーム駐車場,11,3,14,35.646648,139.633038,2024-02-08 13:08:04
256,L1-13.わびさびホステル,2,2,4,35.647393,139.667085,2024-02-08 13:08:04
257,G2-05.リアナスカイパーク押上,5,1,6,35.715733,139.815451,2024-02-08 13:08:04
258,T3-02.早宮第二自転車駐車場,7,4,11,35.756846,139.652154,2024-02-08 13:08:04
259,I1-37.ガーデンシティ品川御殿山,6,3,9,35.623466,139.734359,2024-02-08 13:08:04
260,T2-47.上石神井駅北第二自転車駐車場,6,4,10,35.726523,139.5905,2024-02-08 13:08:04
261,C1-51.環二新橋四丁目,9,3,12,35.663843,139.757697,2024-02-08 13:08:04
262,M6-07.笹塚東,15,6,21,35.675436,139.670594,2024-02-08 13:08:04
263,M3-10.ウノサワ東急ビル,8,0,8,35.647757,139.712981,2024-02-08 13:08:04
264,C2-26.一の橋公園,6,1,7,35.655367,139.738075,2024-02-08 13:08:04
265,H1-14.ホテルリブマックス東京潮見駅前,4,2,6,35.658351,139.818229,2024-02-08 13:08:04
266,D2-12.ヴィアイン飯田橋後楽園,0,14,14,35.705774,139.743366,2024-02-08 13:08:04
267,D3-08.ホテルリブマックス高田馬場駅前,8,0,8,35.712952,139.701356,2024-02-08 13:08:04
268,H1-103.清澄庭園,4,6,10,35.680948,139.796917,2024-02-08 13:08:04
269,H1-104.木場公園,0,19,19,35.676488,139.809616,2024-02-08 13:08:04
270,H1-105.猿江恩賜公園,7,1,8,35.692277,139.817491,2024-02-08 13:08:04
271,G4-07.ディアレイシャス両国,2,2,4,35.69955,139.803204,2024-02-08 13:08:04
272,T2-46.大泉郵便局バス停自転車駐車場,0,9,9,35.766491,139.587232,2024-02-08 13:08:04
273,I1-18.東品川公園,4,3,7,35.61379,139.746617,2024-02-08 13:08:04
274,J1-03.西郷山公園,5,1,6,35.650688,139.696696,2024-02-08 13:08:04
275,J1-02.駒場野公園,10,4,14,35.657718,139.681043,2024-02-08 13:08:04
276,D2-14.ローソン 神楽坂駅北店,0,16,16,35.704201,139.735815,2024-02-08 13:08:04
277,K1-65.下丸子3丁目,7,5,12,35.571711,139.685337,2024-02-08 13:08:04
278,T2-43.学園通り自転車駐車場,8,0,8,35.7547,139.5871,2024-02-08 13:08:04
279,I1-46.セブン-イレブン 品川東中延2丁目店,0,7,7,35.608721,139.714158,2024-02-08 13:08:04
280,T2-04.石神井公園駅南口,12,1,13,35.743354,139.606592,2024-02-08 13:08:04
281,J1-06.観音橋自転車置場,34,11,45,35.642251,139.69692,2024-02-08 13:08:04
282,J1-05.東山公園　北,0,13,13,35.64853,139.686309,2024-02-08 13:08:04
283,J1-45.プラウド中目黒,0,3,3,35.63767,139.7045,2024-02-08 13:08:04
284,H1-168.大島五丁目公園,12,1,13,35.68642,139.836151,2024-02-08 13:08:04
285,J1-47.本町みなみ街かど公園,3,14,17,35.61847,139.70019,2024-02-08 13:08:04
286,J1-48.グランドエクセル祐天寺,0,20,20,35.64372,139.68777,2024-02-08 13:08:04
287,K1-101.小池公園,0,5,5,35.599541,139.697962,2024-02-08 13:08:04
288,H1-171.LOGI’Q南砂町,6,3,9,35.672877,139.842339,2024-02-08 13:08:04
289,H1-153.三井リンクラボ新木場1,9,1,10,35.63851,139.823534,2024-02-08 13:08:04
290,H1-154.やぐら橋下,20,0,20,35.631132,139.792726,2024-02-08 13:08:04
291,D5-11.NTTコミュニケーションズ新宿ビル,3,6,9,35.699312,139.696468,2024-02-08 13:08:04
292,C5-31.ヒルトン東京お台場,3,7,10,35.626267,139.771438,2024-02-08 13:08:04
293,K1-78.城南鋳物団地協同組合,0,10,10,35.567562,139.766854,2024-02-08 13:08:04
294,I1-68.八潮公園第二,0,8,8,35.600003,139.754288,2024-02-08 13:08:04
295,I1-67.八潮公園第一,0,11,11,35.601149,139.754284,2024-02-08 13:08:04
296,H1-123.ダイワロイネットホテル東京有明,19,2,21,35.634316,139.793199,2024-02-08 13:08:04
297,J1-24.ボヌールREIWA,4,1,5,35.612389,139.676238,2024-02-08 13:08:04
298,B2-12.東京ダイヤビルディング（東側）,16,2,18,35.674835,139.785656,2024-02-08 13:08:04
299,J1-15.二の橋自転車置場2,16,0,16,35.614391,139.678396,2024-02-08 13:08:04
300,H1-77.ライフ東砂店,0,10,10,35.684641,139.844243,2024-02-08 13:08:04
301,D1-09.NTT四谷ビル,0,3,3,35.691188,139.712079,2024-02-08 13:08:04
302,E4-11.プライマル千石,0,14,14,35.727519,139.742815,2024-02-08 13:08:04
303,I1-23.東海橋防災船着場,0,14,14,35.616114,139.74033,2024-02-08 13:08:04
304,A4-12.東京ミッドタウン日比谷,4,0,4,35.674274,139.759111,2024-02-08 13:08:04
305,K1-46.池上駅前自転車駐車場,5,7,12,35.571478,139.702779,2024-02-08 13:08:04
306,I1-24.しながわ区民公園(中央口),2,12,14,35.593611,139.738056,2024-02-08 13:08:04
307,T2-13.セブン-イレブン 練馬石神井町8丁目店,0,5,5,35.750414,139.600011,2024-02-08 13:08:04
308,O3-04.アヴァンセ阿佐ヶ谷,2,0,2,35.712,139.62816,2024-02-08 13:08:04
309,B4-01.黎明橋公園（駐輪場）,2,10,12,35.656071,139.780068,2024-02-08 13:08:04
310,T2-32.セブン-イレブン 練馬東大泉NTTビル店,4,4,8,35.750761,139.594457,2024-02-08 13:08:04
311,K1-142.コーラル洗足池,9,1,10,35.604567,139.689096,2024-02-08 13:08:04
312,K1-28.鵜の木特別出張所,4,0,4,35.574886,139.685122,2024-02-08 13:08:04
313,T1-02.ホテルカデンツァ東京,12,0,12,35.755106,139.621675,2024-02-08 13:08:04
314,C2-16.ザ・ベルグレイヴィア麻布,0,7,7,35.657264,139.743821,2024-02-08 13:08:04
315,N3-11.上高田区民活動センター,3,2,5,35.711501,139.672761,2024-02-08 13:08:04
316,T3-30.北西大松公園,2,2,4,35.765979,139.64931,2024-02-08 13:08:04
317,D6-05.新宿中央公園（水の広場）,5,1,6,35.690474,139.690219,2024-02-08 13:08:04
318,D6-07.新宿フロントタワー,4,5,9,35.696387,139.689924,2024-02-08 13:08:04
319,T2-73.早実グラウンド記念公園,2,2,4,35.734615,139.576214,2024-02-08 13:08:04
320,O7-03.永福町西幸モータープール東,2,9,11,35.67156,139.64609,2024-02-08 13:08:04
321,D1-03.新左門児童遊園,0,5,5,35.684523,139.720519,2024-02-08 13:08:04
322,D1-04.四谷見附公園,0,31,31,35.683448,139.728425,2024-02-08 13:08:04
323,I1-54.天王洲オーシャンスクエア,12,3,15,35.622356,139.749468,2024-02-08 13:08:04
324,D6-01.新宿区役所本庁舎,45,1,46,35.693602,139.703229,2024-02-08 13:08:04
325,D6-02.新宿区役所第二分庁舎,35,0,35,35.693976,139.706134,2024-02-08 13:08:04
326,D6-03.新宿中央公園（ポケットパーク）,9,0,9,35.691559,139.690029,2024-02-08 13:08:04
327,D6-04.新宿中央公園（ちびっこ広場）,8,2,10,35.686649,139.689821,2024-02-08 13:08:04
328,A6-21.日本工営ビル,2,2,4,35.684584,139.734442,2024-02-08 13:08:04
329,I1-77.セブン-イレブン品川西中延1丁目店,0,20,20,35.612217,139.708164,2024-02-08 13:08:04
330,T1-01.光が丘駅前広場,11,2,13,35.759164,139.629466,2024-02-08 13:08:04
331,T2-37.上石神井2丁目,2,6,8,35.729615,139.59532,2024-02-08 13:08:04
332,I1-75.セブン-イレブン品川二葉4丁目店,0,6,6,35.603275,139.713428,2024-02-08 13:08:04
333,M5-13.セブン-イレブン初台店,0,14,14,35.675049,139.68444,2024-02-08 13:08:04
334,D6-24.ＮＴＴ東日本 本社ビル,9,3,12,35.683102,139.688852,2024-02-08 13:08:04
335,H1-134.豊洲ぐるり公園,11,11,22,35.643141,139.777821,2024-02-08 13:08:04
336,H1-133.北砂2丁目公園,0,27,27,35.679001,139.825809,2024-02-08 13:08:04
337,E3-08.サガラマンション,0,4,4,35.722833,139.734662,2024-02-08 13:08:04
338,O4-05.阿佐ヶ谷南1-30,1,2,3,35.700703,139.639985,2024-02-08 13:08:04
339,O5-06.EXAM高円寺南,5,0,5,35.70273,139.65864,2024-02-08 13:08:04
340,G2-03.押上１丁目２６-４,5,0,5,35.710323,139.815215,2024-02-08 13:08:04
341,K1-132.多摩川駅前自転車等駐車場,15,0,15,35.587232,139.669519,2024-02-08 13:08:04
342,C5-47.oak港南品川,23,2,25,35.62413,139.744831,2024-02-08 13:08:04
343,D3-15.カースルいずみ,6,8,14,35.711324,139.711976,2024-02-08 13:08:04
344,C5-15.セブン-イレブン 港区芝浦ふ頭店,0,8,8,35.640215,139.755971,2024-02-08 13:08:04
345,C5-14.セブン-イレブン 港区汐彩橋店,0,13,13,35.640481,139.753659,2024-02-08 13:08:04
346,D5-01.新宿コズミックセンター,0,8,8,35.705244,139.70841,2024-02-08 13:08:04
347,H1-45.夢の島競技場,18,2,20,35.648596,139.824936,2024-02-08 13:08:04
348,E1-01.後楽橋横,25,0,25,35.702746,139.752009,2024-02-08 13:08:04
349,B1-15.ロイヤルパークホテル,0,11,11,35.682332,139.78722,2024-02-08 13:08:04
350,C4-05.白金台駅自転車駐車場,5,10,15,35.638927,139.727083,2024-02-08 13:08:04
351,E1-02.東京ドーム（ミーツポート）,8,1,9,35.70311,139.754951,2024-02-08 13:08:04
352,M2-06.あいおいニッセイ同和損保恵比寿ビル,6,1,7,35.647237,139.71512,2024-02-08 13:08:04
353,J1-12.工大橋下流自転車置場,3,1,4,35.605828,139.680265,2024-02-08 13:08:04
354,C5-25.NEX-TEC芝浦,38,0,38,35.639571,139.755551,2024-02-08 13:08:04
355,H1-175.ダイアパレス大島駅前,0,2,2,35.689543,139.836394,2024-02-08 13:08:04
356,C1-65.東京ポートシティ竹芝,10,3,13,35.654757,139.761516,2024-02-08 13:08:04
357,O2-03.西荻北5-8-17,4,1,5,35.709712,139.601846,2024-02-08 13:08:04
358,B2-21.八重洲二丁目北地区広場,3,1,4,35.67942,139.77004,2024-02-08 13:08:04
359,I1-101.下神明駅前,25,0,25,35.60838,139.726587,2024-02-08 13:08:04
360,N2-04.野方2丁目,6,0,6,35.713018,139.656768,2024-02-08 13:08:04
361,N2-05.野方3丁目,0,12,12,35.717877,139.654732,2024-02-08 13:08:04
362,K1-88.大田久が原西郵便局,0,6,6,35.582756,139.6925,2024-02-08 13:08:04
363,C5-51.トミンタワー台場一番街,1,9,10,35.634627,139.77663,2024-02-08 13:08:04
364,C4-10.亀塚公園,10,0,10,35.642764,139.741174,2024-02-08 13:08:04
365,H1-190.福山通運 東京支店,0,27,27,35.664845,139.796643,2024-02-08 13:08:04
366,C1-80.浜松町262ビル,10,2,12,35.654289,139.75557,2024-02-08 13:08:04
367,B2-19.リエトコートアルクスタワー,0,10,10,35.670506,139.77854,2024-02-08 13:08:04
368,C1-79.髙松コンストラクショングループ 東京本社ビル,1,5,6,35.648765,139.753363,2024-02-08 13:08:04
369,C5-43.オアーゼ芝浦MJビル,7,2,9,35.644798,139.752697,2024-02-08 13:08:04
370,J1-44.五本木2丁目,1,7,8,35.634441,139.687186,2024-02-08 13:08:04
371,B2-17.アーバネックス八丁堀,3,0,3,35.67518,139.77364,2024-02-08 13:08:04
372,M6-16.パールマンション,2,0,2,35.67464,139.67876,2024-02-08 13:08:04
373,G4-06.ドムス・スタイル両国,0,7,7,35.700453,139.798978,2024-02-08 13:08:04
374,G2-04.ラ　ステュディオ押上,3,2,5,35.712157,139.815298,2024-02-08 13:08:04
375,T3-15.セブン-イレブン練馬北町8丁目店,6,0,6,35.768105,139.646049,2024-02-08 13:08:04
376,C1-77.芝公園,13,5,18,35.65513,139.749645,2024-02-08 13:08:04
377,I1-27.小関橋公園,2,2,4,35.620699,139.730904,2024-02-08 13:08:04
378,B3-01.中央区役所,5,1,6,35.670855,139.772052,2024-02-08 13:08:04
379,A6-08.二番町ガーデン,4,1,5,35.685489,139.734562,2024-02-08 13:08:04
380,B1-01.十思公園,0,10,10,35.691058,139.777915,2024-02-08 13:08:04
381,B4-02.月島特別出張所,0,42,42,35.662197,139.782719,2024-02-08 13:08:04
382,A4-05.大手町タワー,18,0,18,35.685938,139.764886,2024-02-08 13:08:04
383,H1-22.豊洲市場（7街区）,32,38,70,35.6447,139.784512,2024-02-08 13:08:04
384,A6-07.二番町センタービル,0,2,2,35.685966,139.736328,2024-02-08 13:08:04
385,A2-12.神保町三井ビルディング,10,0,10,35.694532,139.760695,2024-02-08 13:08:04
386,E2-06.oto no ha Cafe,0,4,4,35.713991,139.725665,2024-02-08 13:08:04
387,B4-10.リバーシティ,0,15,15,35.668795,139.784784,2024-02-08 13:08:04
388,B1-03.常盤公園（北側）,7,2,9,35.688405,139.770068,2024-02-08 13:08:04
389,C5-19.グランドメゾン田町,6,1,7,35.645537,139.754899,2024-02-08 13:08:04
390,K1-11.ファミリーマート かわだ多摩川２丁目店,0,4,4,35.558289,139.697403,2024-02-08 13:08:04
391,J1-43.アルコタワー・ホテル雅叙園東京,12,0,12,35.63237,139.712681,2024-02-08 13:08:04
392,N1-03.鷺宮南駐輪場,6,3,9,35.721827,139.635949,2024-02-08 13:08:04
393,N2-06.江古田1丁目B,1,5,6,35.72515,139.672614,2024-02-08 13:08:04
394,D7-12.プラウド高田馬場,4,1,5,35.715538,139.701683,2024-02-08 13:08:04
395,K1-118.久が原3丁目,0,9,9,35.580741,139.687152,2024-02-08 13:08:04
396,K1-125.池上駅南口第1,1,1,2,35.571866,139.703214,2024-02-08 13:08:04
397,K1-117.安詳寺,5,14,19,35.581798,139.695222,2024-02-08 13:08:04
398,I1-91.アクロス目黒タワー,8,2,10,35.634019,139.719749,2024-02-08 13:08:04
399,K1-126.池上駅南口第2,2,1,3,35.571815,139.702387,2024-02-08 13:08:04
400,C5-50.お台場レインボー公園,12,0,12,35.633133,139.777315,2024-02-08 13:08:04
401,T3-26.富士見ランド公園,0,8,8,35.73701,139.627244,2024-02-08 13:08:04
402,T1-15.つのの山緑地,4,0,4,35.765144,139.636606,2024-02-08 13:08:04
403,T1-16.ゆりの木通り南公園,3,1,4,35.767582,139.636304,2024-02-08 13:08:04
404,H1-185.UR大島六丁目団地(第二),2,2,4,35.690038,139.833252,2024-02-08 13:08:04
405,H1-186.セブン-イレブン亀戸昭和橋通り店,0,8,8,35.694804,139.831357,2024-02-08 13:08:04
406,K1-96.西馬込駅前自転車駐車場,9,5,14,35.586408,139.705425,2024-02-08 13:08:04
407,H1-184.UR大島六丁目団地(第一),1,4,5,35.689913,139.833279,2024-02-08 13:08:04
408,A6-25.麹町仮住宅,4,0,4,35.679192,139.74019,2024-02-08 13:08:04
409,C1-69.塩釜公園,0,11,11,35.662908,139.755014,2024-02-08 13:08:04
410,C1-68.桜田公園,28,1,29,35.665214,139.757008,2024-02-08 13:08:04
411,A2-14.興和一橋ビル,15,0,15,35.6927,139.759311,2024-02-08 13:08:04
412,C5-41.トヨタモビリティ東京 芝浦店,4,2,6,35.639644,139.745532,2024-02-08 13:08:04
413,T2-22.ファミリーマート 石神井台7丁目店,4,1,5,35.731909,139.579685,2024-02-08 13:08:04
414,A6-20.紀尾井町PREX,6,0,6,35.68369,139.736936,2024-02-08 13:08:04
415,C5-24.GLOBAL FRONT TOWER,0,13,13,35.647713,139.755534,2024-02-08 13:08:04
416,E5-09.文京区 男女平等センター,4,11,15,35.70861,139.75768,2024-02-08 13:08:04
417,K1-37.東京サーハウス前,17,4,21,35.563874,139.685011,2024-02-08 13:08:04
418,B4-15.リバーシティ　イーストタワーズ,0,18,18,35.669188,139.785301,2024-02-08 13:08:04
419,M6-08.Be Good 幡ヶ谷,0,13,13,35.682453,139.677687,2024-02-08 13:08:04
420,D5-09.ハウジングステージ新宿,6,7,13,35.702277,139.701214,2024-02-08 13:08:04
421,D6-21.新宿5丁目,2,5,7,35.691613,139.711233,2024-02-08 13:08:04
422,K1-39.東京モノレール 流通センター駅前,29,0,29,35.581752,139.748705,2024-02-08 13:08:04
423,K1-38.ネクストサイト蒲田ビル,9,0,9,35.558916,139.717253,2024-02-08 13:08:04
424,T3-17.練馬区役所東庁舎(第二),5,0,5,35.735585,139.652544,2024-02-08 13:08:04
425,H1-107.大島小松川公園,0,27,27,35.692641,139.846346,2024-02-08 13:08:04
426,B1-11.浜町川緑道,3,43,46,35.684158,139.787649,2024-02-08 13:08:04
427,A6-19.番町麹町ビルディング,11,1,12,35.685578,139.732078,2024-02-08 13:08:04
428,B3-12.築地場外市場,13,5,18,35.665254,139.769301,2024-02-08 13:08:04
429,I1-40.御殿山トラストタワー,26,0,26,35.622371,139.737457,2024-02-08 13:08:04
430,M5-08.古賀政男音楽博物館,2,0,2,35.668091,139.680243,2024-02-08 13:08:04
431,H1-90.富士倉庫運輸(株) FACE-1前,0,11,11,35.655102,139.805205,2024-02-08 13:08:04
432,A3-38.パークホームズ千代田淡路町,4,0,4,35.695163,139.769566,2024-02-08 13:08:04
433,D2-11.神楽坂アインスタワー,2,4,6,35.702833,139.739,2024-02-08 13:08:04
434,C2-04.飯倉いきいきプラザ,0,5,5,35.656991,139.740739,2024-02-08 13:08:04
435,B1-09.スマイルホテル日本橋三越前,18,0,18,35.686101,139.776089,2024-02-08 13:08:04
436,E5-15.文京千駄木の郷,7,4,11,35.726499,139.759884,2024-02-08 13:08:04
437,C2-05.ありすいきいきプラザ,9,4,13,35.651046,139.727745,2024-02-08 13:08:04
438,C5-06.品川シーズンテラス,19,0,19,35.632303,139.742393,2024-02-08 13:08:04
439,B1-10.箱崎川第二公園,6,3,9,35.680833,139.784267,2024-02-08 13:08:04
440,L1-15.ソフィア,0,3,3,35.663222,139.587803,2024-02-08 13:08:04
441,A3-12.秋葉原UDX北側駐輪場前,15,0,15,35.70111,139.772855,2024-02-08 13:08:04
442,A2-08.KDX御茶ノ水ビル,6,3,9,35.700568,139.76013,2024-02-08 13:08:04
443,A3-07.淡路公園,5,1,6,35.696942,139.767302,2024-02-08 13:08:04
444,A1-08.飯田橋サクラテラス（早稲田通り）,11,0,11,35.699132,139.74462,2024-02-08 13:08:04
445,A3-13.富士ソフトビル（駐車場入口横）,4,14,18,35.700486,139.774254,2024-02-08 13:08:04
446,A2-09.テラススクエア,8,0,8,35.6931,139.7599,2024-02-08 13:08:04
447,A6-11.東京ガーデンテラス紀尾井町,17,5,22,35.67962,139.7364,2024-02-08 13:08:04
448,K1-124.矢口2丁目,1,5,6,35.564161,139.695187,2024-02-08 13:08:04
449,N3-15.ライオンズマンション中野東,1,2,3,35.71046,139.6855,2024-02-08 13:08:04
450,M3-11.渋谷道玄坂東急ビル,8,2,10,35.65718,139.698687,2024-02-08 13:08:04
451,H1-180.シティコート大島,8,0,8,35.691954,139.836462,2024-02-08 13:08:04
452,B1-27.日本橋本町4丁目,23,5,28,35.68973,139.77598,2024-02-08 13:08:04
453,M3-22.森谷ビル,15,0,15,35.64514,139.71686,2024-02-08 13:08:04
454,N3-17.東中野3丁目,9,1,10,35.70862,139.680679,2024-02-08 13:08:04
455,N2-10.関根ビル,1,4,5,35.733432,139.671241,2024-02-08 13:08:04
456,T1-06.秋の陽公園,5,0,5,35.762326,139.635226,2024-02-08 13:08:04
457,N1-02.鷺宮東駐輪場,0,14,14,35.721556,139.640397,2024-02-08 13:08:04
458,K1-140.西馬込駅前自転車駐車場(奥),14,0,14,35.586382,139.705116,2024-02-08 13:08:04
459,H1-182.錦糸町プライムタワー,13,1,14,35.695695,139.820507,2024-02-08 13:08:04
460,E5-05.駒込地域活動センター,0,9,9,35.728644,139.752183,2024-02-08 13:08:04
461,M3-06.渋谷第一生命ビル,4,0,4,35.657556,139.704129,2024-02-08 13:08:04
462,T2-42.石神井公園駅北第二自転車駐車場,2,3,5,35.74553,139.608939,2024-02-08 13:08:04
463,K1-144.蒲田五丁目44番自転車駐車場,10,0,10,35.559809,139.716993,2024-02-08 13:08:04
464,M3-07.渋谷ファーストプレイス,10,0,10,35.65506,139.69384,2024-02-08 13:08:04
465,H1-74.タダノ教習センター,10,0,10,35.63848,139.832305,2024-02-08 13:08:04
466,H1-151.コスモリード錦糸町,0,9,9,35.701347,139.819973,2024-02-08 13:08:04
467,T2-23.セブン-イレブン 練馬南大泉5丁目店,6,0,6,35.750185,139.579216,2024-02-08 13:08:04
468,M4-13.J-cube,3,0,3,35.66616,139.70458,2024-02-08 13:08:04
469,T2-65.さくらの辻公園,0,5,5,35.734805,139.599906,2024-02-08 13:08:04
470,T2-24.セブン-イレブン 練馬インター店,0,27,27,35.754586,139.606409,2024-02-08 13:08:04
471,O5-05.モンテ・ベルテ,0,2,2,35.701454,139.650518,2024-02-08 13:08:04
472,J1-42.都立大学駅北口バス停前,3,6,9,35.618622,139.67596,2024-02-08 13:08:04
473,K1-97.トミンタワー多摩川二丁目,0,13,13,35.555561,139.704345,2024-02-08 13:08:04
474,D1-14.コモレ四谷,0,7,7,35.68752,139.72818,2024-02-08 13:08:04
475,K1-106.ファミリーマート上池台夫婦坂店,0,9,9,35.599329,139.703343,2024-02-08 13:08:04
476,J1-39.松見坂公園,0,10,10,35.655483,139.687325,2024-02-08 13:08:04
477,J1-40.西小山公園,5,3,8,35.616541,139.697369,2024-02-08 13:08:04
478,J1-38.林試の森公園 北,6,6,12,35.626355,139.700153,2024-02-08 13:08:04
479,I1-84.セブン-イレブン西品川2丁目店,0,3,3,35.613819,139.728418,2024-02-08 13:08:04
480,D6-26.セブン-イレブン新宿６丁目文化センター通り店,7,2,9,35.694951,139.708219,2024-02-08 13:08:04
481,T2-25.ファミリーマート 高野台二丁目店,1,4,5,35.746045,139.620087,2024-02-08 13:08:04
482,I1-85.GOODOFFICE品川,1,4,5,35.621081,139.741178,2024-02-08 13:08:04
483,K1-74.大田スタジアム,3,3,6,35.587423,139.753871,2024-02-08 13:08:04
484,C1-64.東京虎ノ門グローバルスクエア,3,2,5,35.669941,139.749261,2024-02-08 13:08:04
485,K1-72.ファミリーマート大森西四丁目店,0,7,7,35.573358,139.723105,2024-02-08 13:08:04
486,H1-118.ファミリーマート亀戸駅前店,6,5,11,35.69839,139.825484,2024-02-08 13:08:04
487,I1-62.天王洲Rim,0,7,7,35.622277,139.745638,2024-02-08 13:08:04
488,H1-40.深川東京モダン館,4,1,5,35.674076,139.795008,2024-02-08 13:08:04
489,H1-117.東京パークサイドビル,7,3,10,35.671225,139.808561,2024-02-08 13:08:04
490,J1-01.目黒区総合庁舎,8,1,9,35.640675,139.698088,2024-02-08 13:08:04
491,C5-16.品川インターシティ,23,0,23,35.626704,139.742174,2024-02-08 13:08:04
492,A1-12.北の丸スクエア,7,0,7,35.695515,139.750213,2024-02-08 13:08:04
493,H1-46.セブン-イレブン 江東枝川2丁目店,0,25,25,35.659287,139.807358,2024-02-08 13:08:04
494,A2-25.プラウド神田駿河台,11,2,13,35.698991,139.76091,2024-02-08 13:08:04
495,C5-49.プラウドタワー芝浦,0,15,15,35.638912,139.747422,2024-02-08 13:08:04
496,T3-25.北町みのり公園,0,4,4,35.767627,139.65243,2024-02-08 13:08:04
497,H1-75.ジオ深川住吉,1,9,10,35.684247,139.815638,2024-02-08 13:08:04
498,T1-09.ローソン練馬旭町一丁目店,4,1,5,35.765704,139.625178,2024-02-08 13:08:04
499,T2-26.ファミリーマート 大泉学園町四丁目店,0,7,7,35.767388,139.587625,2024-02-08 13:08:04
500,T2-27.ファミリーマート 大泉長久保通り店,2,3,5,35.773841,139.591456,2024-02-08 13:08:04
501,C3-19.明治記念館西,3,1,4,35.678179,139.720809,2024-02-08 13:08:04
502,I1-11.鮫洲入江広場,11,3,14,35.603984,139.744504,2024-02-08 13:08:04
503,I1-10.品川シーサイド公園第1,15,3,18,35.607717,139.749478,2024-02-08 13:08:04
504,I1-09.東品川海上公園第1,0,16,16,35.616633,139.748945,2024-02-08 13:08:04
505,D3-06.セブン-イレブン高田馬場3丁目中央店,0,7,7,35.713872,139.698301,2024-02-08 13:08:04
506,K1-40.大田文化の森,0,17,17,35.579649,139.720263,2024-02-08 13:08:04
507,C1-41.港区立エコプラザ,6,3,9,35.658709,139.757036,2024-02-08 13:08:04
508,I1-13.八潮北公園,0,11,11,35.613421,139.75375,2024-02-08 13:08:04
509,I1-12.しながわ区民公園（北側）,2,2,4,35.596091,139.740884,2024-02-08 13:08:04
510,T2-09.こぐれの森緑地,3,7,10,35.763741,139.588847,2024-02-08 13:08:04
511,T3-31.パークサイド関口,3,5,8,35.74097,139.63836,2024-02-08 13:08:04
512,H1-183.MFLP新木場1,4,0,4,35.643958,139.838358,2024-02-08 13:08:04
513,T2-33.ウインドヒルズ189,2,4,6,35.74642,139.581204,2024-02-08 13:08:04
514,T2-67.陽和病院,0,7,7,35.761211,139.603316,2024-02-08 13:08:04
515,H1-82.セブンｰイレブン 北砂3丁目明治通り店,0,21,21,35.683514,139.827081,2024-02-08 13:08:04
516,T2-60.武蔵関公園（第一）,9,0,9,35.724747,139.565817,2024-02-08 13:08:04
517,I1-48.NTT 東日本 関東病院(北側),5,4,9,35.632191,139.725002,2024-02-08 13:08:04
518,T2-58.立野公園,3,2,5,35.716776,139.577975,2024-02-08 13:08:04
519,I1-100.東急荏原中延駅駐輪場,3,4,7,35.610444,139.712333,2024-02-08 13:08:04
520,T2-56.大泉公園（第一）,2,2,4,35.77228,139.58325,2024-02-08 13:08:04
521,T2-55.大泉町もみじやま公園,0,3,3,35.767296,139.602321,2024-02-08 13:08:04
522,T2-54.土支田農業公園,0,9,9,35.760939,139.609264,2024-02-08 13:08:04
523,I1-44.大井三ツ又商店街入口,6,1,7,35.604606,139.734483,2024-02-08 13:08:04
524,T2-62.大泉井頭公園,6,4,10,35.746681,139.57754,2024-02-08 13:08:04
525,T2-61.武蔵関公園（第二）,4,0,4,35.727826,139.570056,2024-02-08 13:08:04
526,T3-09.学田公園,4,1,5,35.730428,139.648704,2024-02-08 13:08:04
527,K1-105.東糀谷二丁目児童公園,0,7,7,35.555702,139.740802,2024-02-08 13:08:04
528,T3-04.サンパレス平和台,8,4,12,35.759827,139.659121,2024-02-08 13:08:04
529,K1-104.六郷BASE,1,5,6,35.543573,139.714393,2024-02-08 13:08:04
530,M4-16.神宮前6丁目,2,1,3,35.668673,139.702816,2024-02-08 13:08:04
531,K1-69.京急平和島第2Bバイク駐輪場,0,7,7,35.585747,139.735242,2024-02-08 13:08:04
532,H1-155.メブクス豊洲,10,10,20,35.645726,139.784496,2024-02-08 13:08:04
533,C2-11.一の橋,10,43,53,35.654726,139.737491,2024-02-08 13:08:04
534,C4-11.ザ・パークハウス 三田ガーデン,0,14,14,35.64816,139.737991,2024-02-08 13:08:04
535,H1-161.昭文社制作本部ビル,4,2,6,35.684003,139.794983,2024-02-08 13:08:04
536,N2-07.新井区民活動センター,1,4,5,35.714292,139.663327,2024-02-08 13:08:04
537,K1-87.羽田イノベーションシティ,2,8,10,35.547061,139.756277,2024-02-08 13:08:04
538,N3-16.COURT 5,5,0,5,35.699743,139.664608,2024-02-08 13:08:04
539,C4-01.高輪地区総合支所(5F),1,10,11,35.641833,139.734519,2024-02-08 13:08:04
540,C5-48.セブンイレブン港区海岸三丁目店,0,8,8,35.636808,139.752517,2024-02-08 13:08:04
541,H1-42.江東区スポーツ会館,0,29,29,35.683961,139.821559,2024-02-08 13:08:04
542,B2-10.東京ダイヤビルディング（北側）,0,12,12,35.675702,139.785229,2024-02-08 13:08:04
543,H1-43.東京イースト21,0,17,17,35.675639,139.815255,2024-02-08 13:08:04
544,B3-20.歌舞伎座タワー駐輪場2F,6,0,6,35.670106,139.768041,2024-02-08 13:08:04
545,B3-21.歌舞伎座タワー駐輪場3F,11,0,11,35.6701,139.76801,2024-02-08 13:08:04
546,K1-139.プラットホステル京急 羽田ホーム,8,2,10,35.548104,139.748889,2024-02-08 13:08:04
547,J1-58.目黒女子会館前,3,2,5,35.629011,139.69716,2024-02-08 13:08:04
548,T2-18.ファミリーマート練馬西税務署前店,2,2,4,35.745505,139.580878,2024-02-08 13:08:04
549,C3-23.LIFORK 南青山 北エントランス,14,15,29,35.669916,139.725701,2024-02-08 13:08:04
550,C1-46.新虎通りCORE,15,2,17,35.665124,139.754054,2024-02-08 13:08:04
551,C1-45.浜松町クレアタワー,16,3,19,35.656324,139.755927,2024-02-08 13:08:04
552,K1-53.セブン-イレブン 田園調布郵便局前店,15,5,20,35.589309,139.678587,2024-02-08 13:08:04
553,K1-52.大田区総合体育館,7,0,7,35.564152,139.727422,2024-02-08 13:08:04
554,T1-12.ファミリーマート 高松六丁目店,3,1,4,35.756873,139.616612,2024-02-08 13:08:04
555,D7-07.ローソン 新宿西落合三丁目店,0,5,5,35.725171,139.675897,2024-02-08 13:08:04
556,A6-16.一番町第二TGビル,3,2,5,35.688351,139.744321,2024-02-08 13:08:04
557,C3-33.PASONA SQUARE,13,0,13,35.667462,139.716058,2024-02-08 13:08:04
558,A3-24.岩本町ほほえみプラザ,0,11,11,35.69441,139.777715,2024-02-08 13:08:04
559,H1-35.ヒューリック豊洲プライムスクエア,7,0,7,35.652376,139.797724,2024-02-08 13:08:04
560,C5-11.フェイバリッチタワー品川,0,57,57,35.631729,139.749767,2024-02-08 13:08:04
561,E2-13.デルックス文京神楽坂,1,3,4,35.70781,139.732227,2024-02-08 13:08:04
562,C5-01.こうなん星の公園,45,0,45,35.629697,139.742167,2024-02-08 13:08:04
563,C5-02.港南緑水公園,0,79,79,35.628955,139.750731,2024-02-08 13:08:04
564,A3-22.龍閑児童公園,0,8,8,35.693234,139.779702,2024-02-08 13:08:04
565,A3-21.神田ふれあい通り第３,6,6,12,35.695176,139.772832,2024-02-08 13:08:04
566,H1-30.江東区役所（北側）,9,3,12,35.67338,139.8164,2024-02-08 13:08:04
567,C1-17.港区役所,4,0,4,35.657866,139.751068,2024-02-08 13:08:04
568,H1-31.江東区役所（南側）,14,3,17,35.67214,139.8166,2024-02-08 13:08:04
569,C1-09.愛宕グリーンヒルズ,9,0,9,35.662051,139.748132,2024-02-08 13:08:04
570,D1-02.四谷特別出張所（新宿御苑大木戸門前）,16,1,17,35.687435,139.714169,2024-02-08 13:08:04
571,D1-01.花園西公園,4,1,5,35.690612,139.711631,2024-02-08 13:08:04
572,C1-04.虎ノ門ヒルズ,12,2,14,35.666527,139.748804,2024-02-08 13:08:04
573,C1-05.西新橋2丁目（新虎通り）,14,0,14,35.665593,139.752617,2024-02-08 13:08:04
574,C1-73.日比谷フォートタワー,14,0,14,35.669871,139.753147,2024-02-08 13:08:04
575,K1-102.上池台四丁目公園,0,7,7,35.595119,139.6996,2024-02-08 13:08:04
576,M2-01.恵比寿保健相談所（恵比寿社会教育館）,0,15,15,35.64524,139.71946,2024-02-08 13:08:04
577,I1-98.コーポ荏原,0,5,5,35.60411,139.709784,2024-02-08 13:08:04
578,C3-17.セブン-イレブン 港区溜池山王店,2,16,18,35.670308,139.743242,2024-02-08 13:08:04
579,T2-11.石神井松の風文化公園,2,1,3,35.739471,139.595578,2024-02-08 13:08:04
580,M2-03.サイカパーク恵比寿,15,0,15,35.646581,139.710613,2024-02-08 13:08:04
581,M2-02.アメリカ橋公園,7,1,8,35.643606,139.713099,2024-02-08 13:08:04
582,T2-50.North Ridge 吉祥寺,8,1,9,35.72305,139.579555,2024-02-08 13:08:04
583,J1-35.目黒川田道街かど公園,5,1,6,35.634574,139.710332,2024-02-08 13:08:04
584,H1-174.ジュネス(エントランス側),0,2,2,35.682712,139.823961,2024-02-08 13:08:04
585,M6-17.笹塚一丁目駐輪場,1,6,7,35.672922,139.668729,2024-02-08 13:08:04
586,C4-14.神応ほっとプラザ,3,7,10,35.643711,139.724753,2024-02-08 13:08:04
587,K1-107.馬込駅A2出口,4,6,10,35.596854,139.712139,2024-02-08 13:08:04
588,T3-11.ガラクタ公園,1,2,3,35.740321,139.631256,2024-02-08 13:08:04
589,T2-80.みその緑地,2,3,5,35.756825,139.590528,2024-02-08 13:08:04
590,T3-24.AZEST新桜台,5,2,7,35.743962,139.670315,2024-02-08 13:08:04
591,D4-07.新宿余丁町ビル,0,9,9,35.698512,139.716482,2024-02-08 13:08:04
592,T3-01.練馬春日町駅自転車駐車場,7,0,7,35.751438,139.641265,2024-02-08 13:08:04
593,H1-89.BUDDY スポーツアリーナ,7,7,14,35.637041,139.781088,2024-02-08 13:08:04
594,E5-14.上野広小路駅（湯島側）,0,14,14,35.707313,139.771857,2024-02-08 13:08:04
595,H1-109.Brillia ist 東雲キャナルコート東側,0,44,44,35.648008,139.803487,2024-02-08 13:08:04
596,H1-108.Brillia ist 東雲キャナルコート北側,0,20,20,35.648431,139.803125,2024-02-08 13:08:04
597,C1-53.ホテルリブマックス新橋,4,0,4,35.661149,139.754612,2024-02-08 13:08:04
598,D7-10.染の里 おちあい,1,5,6,35.715211,139.689788,2024-02-08 13:08:04
599,A1-15.富士見みらい館,0,6,6,35.697167,139.745629,2024-02-08 13:08:04
600,E4-15.千石4丁目,2,3,5,35.729153,139.741368,2024-02-08 13:08:04
601,H1-111.ファミリーマート木場六丁目店,0,9,9,35.66688,139.80779,2024-02-08 13:08:04
602,C5-36.お台場海浜公園駅,3,0,3,35.62974,139.778178,2024-02-08 13:08:04
603,H1-10.出会い橋,15,0,15,35.625029,139.777344,2024-02-08 13:08:04
604,H1-11.テレコムセンター駅,7,14,21,35.61813,139.778698,2024-02-08 13:08:04
605,H1-47.トピレックプラザ,0,37,37,35.672481,139.835877,2024-02-08 13:08:04
606,H1-13.アーバンドック ららぽーと豊洲,19,0,19,35.654067,139.792376,2024-02-08 13:08:04
607,T2-66.大泉学園町希望ヶ丘公園,0,4,4,35.778605,139.588883,2024-02-08 13:08:04
608,C5-37.台場駅,0,24,24,35.626388,139.772453,2024-02-08 13:08:04
609,H1-16.豊洲三丁目公園,19,0,19,35.657477,139.796629,2024-02-08 13:08:04
610,H1-17.東雲水辺公園,0,69,69,35.64704,139.80469,2024-02-08 13:08:04
611,C1-72.新田町ビル,11,0,11,35.646307,139.746428,2024-02-08 13:08:04
612,K1-98.鵜の木松山公園,2,5,7,35.577433,139.680752,2024-02-08 13:08:04
613,C1-71.芝商業高校前交差点,0,5,5,35.65583,139.759896,2024-02-08 13:08:04
614,H1-122.東砂スポーツセンター,0,11,11,35.679167,139.839746,2024-02-08 13:08:04
615,O6-05.コージーコート久我山,0,5,5,35.687531,139.60439,2024-02-08 13:08:04
616,T2-39.ローソン 練馬大泉町五丁目店,7,1,8,35.758929,139.597548,2024-02-08 13:08:04
617,J1-50.大岡山公園,2,2,4,35.609958,139.684087,2024-02-08 13:08:04
618,J1-51.池尻大橋駅東口駐輪場,0,5,5,35.650627,139.687228,2024-02-08 13:08:04
619,K1-99.東原くすのき公園,7,1,8,35.584086,139.67898,2024-02-08 13:08:04
620,N3-12.桃園区民活動センター,2,1,3,35.702414,139.667327,2024-02-08 13:08:04
621,H1-191.三井リンクラボ新木場2,14,0,14,35.644863,139.831107,2024-02-08 13:08:04
622,M5-09.代々木上原駅前,5,0,5,35.66865,139.679251,2024-02-08 13:08:04
623,O3-09.NTT井草ビル第3ポート,4,3,7,35.714151,139.61693,2024-02-08 13:08:04
624,T1-07.土支田一丁目（笹目通り）,2,8,10,35.765913,139.619285,2024-02-08 13:08:04
625,K1-22.矢口特別出張所,2,3,5,35.562324,139.690486,2024-02-08 13:08:04
626,T3-08.中新井川児童遊園,2,5,7,35.728268,139.649188,2024-02-08 13:08:04
627,H1-78.ローソン新木場一丁目店,14,0,14,35.645604,139.834941,2024-02-08 13:08:04
628,A6-13.番町会館,5,1,6,35.689131,139.733071,2024-02-08 13:08:04
629,H1-71.セブン-イレブン 江東東陽4丁目,0,5,5,35.670906,139.819386,2024-02-08 13:08:04
630,D2-09.セブン-イレブン 新宿岩戸町店,3,0,3,35.700993,139.736355,2024-02-08 13:08:04
631,I1-08.天王洲アイル第一水辺広場,26,5,31,35.622294,139.751644,2024-02-08 13:08:04
632,I1-07.しながわ水族館,1,15,16,35.590641,139.736354,2024-02-08 13:08:04
633,D3-09.西早稲田3丁目,2,2,4,35.712545,139.713319,2024-02-08 13:08:04
634,E1-16.小石川3丁目緑地,0,21,21,35.714338,139.746346,2024-02-08 13:08:04
635,C5-28.芝浦ルネサイトタワー,6,1,7,35.643683,139.7506,2024-02-08 13:08:04
636,I1-59.文庫の森第一,13,9,22,35.612357,139.721484,2024-02-08 13:08:04
637,I1-60.文庫の森第二,0,5,5,35.611368,139.720424,2024-02-08 13:08:04
638,C1-38.KDX西新橋ビル（西側）,2,2,4,35.66495,139.750459,2024-02-08 13:08:04
639,C1-37.KDX西新橋ビル（北側）,5,0,5,35.665218,139.750827,2024-02-08 13:08:04
640,T2-14.NPC24H東大泉第6パーキング,0,6,6,35.747807,139.593599,2024-02-08 13:08:04
641,C3-12.赤坂センタービルディング前（青山通り）,4,4,8,35.676732,139.733905,2024-02-08 13:08:04
642,H1-36.フジゴルフセンター,0,22,22,35.66605,139.806699,2024-02-08 13:08:04
643,C1-27.虎ノ門2丁目タワー,14,0,14,35.668547,139.747175,2024-02-08 13:08:04
644,C5-12.第2東運ビル,5,3,8,35.633742,139.748281,2024-02-08 13:08:04
645,D6-08.新宿イーストサイドスクエア,6,0,6,35.697158,139.707887,2024-02-08 13:08:04
646,A4-08.永代通り（大手町駅B2c出口前）,24,0,24,35.684349,139.766958,2024-02-08 13:08:04
647,H1-37.東雲駅（東京湾岸道路）,32,3,35,35.640618,139.802455,2024-02-08 13:08:04
648,C3-11.赤坂見附南,1,0,1,35.676566,139.737083,2024-02-08 13:08:04
649,M6-04.本町東べんてん橋公園,0,19,19,35.687126,139.680702,2024-02-08 13:08:04
650,I1-79.品川浦第二,11,3,14,35.621904,139.741429,2024-02-08 13:08:04
651,K1-81.コーナン本羽田萩中店,10,3,13,35.549568,139.731093,2024-02-08 13:08:04
652,D6-25.新宿駅東南口自転車駐輪場,29,4,33,35.689755,139.701323,2024-02-08 13:08:04
653,I1-78.セブン-イレブン西大井店,3,8,11,35.601431,139.718659,2024-02-08 13:08:04
654,H1-136.東砂一丁目公園,0,17,17,35.683542,139.839763,2024-02-08 13:08:04
655,A6-23.セブン-イレブン 千代田三番町店,0,14,14,35.689466,139.745316,2024-02-08 13:08:04
656,C5-34.五色橋ビル,0,13,13,35.636644,139.751798,2024-02-08 13:08:04
657,K1-41.郷土博物館,0,12,12,35.588644,139.710413,2024-02-08 13:08:04
658,G2-06.ディアレイシャス押上スカイヴィレッジ,0,5,5,35.71408,139.810588,2024-02-08 13:08:04
659,O3-11.ハイリビング関根,6,2,8,35.707877,139.618926,2024-02-08 13:08:04
660,O7-02.永福中央公園,6,0,6,35.67121,139.64145,2024-02-08 13:08:04
661,K1-29.萩中文化センター,4,5,9,35.55017,139.728146,2024-02-08 13:08:04
662,K1-30.テクノFRONT森ケ崎,2,2,4,35.567922,139.746181,2024-02-08 13:08:04
663,K1-130.COCOONひろば平和島,15,2,17,35.578728,139.735238,2024-02-08 13:08:04
664,H1-81.豊洲IHIビル（北側）,21,0,21,35.659829,139.793243,2024-02-08 13:08:04
665,E4-03.昭和小学校北側（不忍通り）,25,8,33,35.73166,139.748625,2024-02-08 13:08:04
666,C2-12.六本木ファーストビル,15,0,15,35.66249,139.741397,2024-02-08 13:08:04
667,D3-16.セジョリ江戸川橋,5,10,15,35.708734,139.730509,2024-02-08 13:08:04
668,A5-04.日比谷パークフロント前　日比谷公園南面向い歩道上,6,2,8,35.671514,139.753952,2024-02-08 13:08:04
669,C3-22.OMO3東京赤坂 by 星野リゾート,8,0,8,35.674929,139.736053,2024-02-08 13:08:04
670,B1-20.竜閑さくら橋際街角広場,0,18,18,35.688301,139.768958,2024-02-08 13:08:04
671,H1-83.ローソン江東東雲店,1,12,13,35.642165,139.800439,2024-02-08 13:08:04
672,H1-84.NTT東日本辰巳ビル,0,20,20,35.647091,139.817333,2024-02-08 13:08:04
673,C5-26.ピアシティ芝浦ビル,9,5,14,35.644155,139.756216,2024-02-08 13:08:04
674,T3-28.ほしぞら緑地,0,3,3,35.755137,139.661208,2024-02-08 13:08:04
675,I1-88.セブン-イレブン品川南大井3丁目店,1,1,2,35.58768,139.734515,2024-02-08 13:08:04
676,I1-87.セブン-イレブン西大井滝王子通り店,0,8,8,35.599774,139.723467,2024-02-08 13:08:04
677,G4-11.ホテルマイステイズ浅草,19,3,22,35.703972,139.797327,2024-02-08 13:08:04
678,C5-30.フェイム芝浦インターウェーブ,0,11,11,35.647872,139.75391,2024-02-08 13:08:04
679,M6-13.JICA東京,9,3,12,35.673409,139.675203,2024-02-08 13:08:04
680,A4-13.アーバンネット大手町ビル,5,0,5,35.68557,139.766929,2024-02-08 13:08:04
681,B4-27.リバーシティ西ブロック,11,7,18,35.670491,139.784447,2024-02-08 13:08:04
682,K1-143.大森北1丁目,60,0,60,35.584914,139.730504,2024-02-08 13:08:04
683,E5-24.本郷6丁目,3,2,5,35.712445,139.758157,2024-02-08 13:08:04
684,D2-17.genten市ヶ谷店,10,0,10,35.690657,139.73255,2024-02-08 13:08:04
685,A4-14.東京国際フォーラム（有楽町駅ガード側）,7,1,8,35.675739,139.763712,2024-02-08 13:08:04
686,A2-27.丸紅ビル,6,0,6,35.690958,139.759876,2024-02-08 13:08:04
687,K1-135.北千束2丁目,4,2,6,35.608633,139.693653,2024-02-08 13:08:04
688,A1-19.九段会館テラス,4,0,4,35.694065,139.751801,2024-02-08 13:08:04
689,K1-136.BIG FUN 平和島,0,9,9,35.585489,139.740194,2024-02-08 13:08:04
690,K1-137.京浜島つばさ公園,0,14,14,35.571578,139.770532,2024-02-08 13:08:04
691,D1-16.ルネ新宿御苑タワー,7,3,10,35.690155,139.713377,2024-02-08 13:08:04
692,G6-01.オーキッドレジデンス森下,3,4,7,35.692547,139.799231,2024-02-08 13:08:04
693,T2-63.三原台公園,1,6,7,35.751471,139.599835,2024-02-08 13:08:04
694,O4-01.阿佐ヶ谷南公園,1,1,2,35.70328,139.62981,2024-02-08 13:08:04
695,B4-11.ダンスキューブ勝どき,0,17,17,35.656565,139.775073,2024-02-08 13:08:04
696,D1-06.四谷第六小学校北,10,0,10,35.681754,139.715256,2024-02-08 13:08:04
697,T2-64.高野台中央公園,1,2,3,35.746768,139.613885,2024-02-08 13:08:04
698,H1-169.セブンイレブン江東亀戸7丁目東店,0,10,10,35.697157,139.839835,2024-02-08 13:08:04
699,H1-170.セブンイレブン江東亀戸7丁目南店,0,30,30,35.695937,139.838017,2024-02-08 13:08:04
700,B2-16.ホテルサードニクス東京,5,0,5,35.67684,139.77876,2024-02-08 13:08:04
701,I1-93.中央海浜公園前交差点（南側）,4,1,5,35.595498,139.750654,2024-02-08 13:08:04
702,I1-92.中央海浜公園前交差点（北側）,10,0,10,35.595873,139.75134,2024-02-08 13:08:04
703,B1-26.Dash Living Nihonbashi,3,3,6,35.68802,139.78112,2024-02-08 13:08:04
704,H1-158.東京国際交流館,11,1,12,35.621845,139.776833,2024-02-08 13:08:04
705,J1-32.緑が丘駅前高架下,7,0,7,35.606793,139.678372,2024-02-08 13:08:04
706,K1-90.ファミリーマート大田仲池上一丁目店,1,5,6,35.5873,139.701644,2024-02-08 13:08:04
707,K1-91.穴守稲荷神社,4,6,10,35.550027,139.74973,2024-02-08 13:08:04
708,C1-67.京阪神 虎ノ門ビル,17,4,21,35.669228,139.751668,2024-02-08 13:08:04
709,K1-89.ファミリーマート大田千鳥三丁目店,3,2,5,35.572086,139.68708,2024-02-08 13:08:04
710,I1-97.トミンハイム東品川三丁目第二,14,5,19,35.613387,139.749307,2024-02-08 13:08:04
711,T2-51.練馬区役所石神井庁舎,10,0,10,35.743772,139.603317,2024-02-08 13:08:04
712,T2-75.石神井台二丁目緑地,3,0,3,35.734684,139.593628,2024-02-08 13:08:04
713,E5-19.千駄木公園,1,6,7,35.728333,139.757629,2024-02-08 13:08:04
714,E5-18.団子坂上広場,0,11,11,35.724921,139.75903,2024-02-08 13:08:04
715,A5-07.富国生命ビル,3,3,6,35.670452,139.75557,2024-02-08 13:08:04
716,H1-156.つどい橋下,0,9,9,35.630791,139.787396,2024-02-08 13:08:04
717,H1-159.夢の大橋西,16,0,16,35.627599,139.782953,2024-02-08 13:08:04
718,H1-143.ダイバーシティ東京 プラザ,8,2,10,35.624619,139.776006,2024-02-08 13:08:04
719,I1-57.大井水神公園,69,4,73,35.589972,139.729368,2024-02-08 13:08:04
720,B2-15.KABUTO ONE,5,1,6,35.68168,139.77825,2024-02-08 13:08:04
721,K1-64.多摩川グリーンスクエア,0,16,16,35.545459,139.719489,2024-02-08 13:08:04
722,T2-57.大泉公園（第二）,5,1,6,35.771708,139.583551,2024-02-08 13:08:04
723,A4-06.大手町ファーストスクエア,10,0,10,35.686037,139.764472,2024-02-08 13:08:04
724,C1-50.NTT虎ノ門ビル,11,3,14,35.666075,139.748008,2024-02-08 13:08:04
725,C1-23.三田いきいきプラザ,9,0,9,35.648637,139.749834,2024-02-08 13:08:04
726,H1-29.スカイズタワー＆ガーデン,0,76,76,35.647618,139.792152,2024-02-08 13:08:04
727,C1-21.汐留ビルディング,5,5,10,35.657363,139.75918,2024-02-08 13:08:04
728,A3-16.地蔵橋東児童遊園,2,4,6,35.691069,139.775376,2024-02-08 13:08:04
729,A3-18.美倉橋北児童遊園,0,11,11,35.69703,139.779928,2024-02-08 13:08:04
730,A4-01.丸ビル（南側駐輪場）,12,0,12,35.680514,139.764002,2024-02-08 13:08:04
731,A3-11.練成公園,0,8,8,35.703735,139.770629,2024-02-08 13:08:04
732,A3-10.芳林公園（北側）,0,9,9,35.701978,139.7698,2024-02-08 13:08:04
733,A6-02.いきいきプラザ一番町（西側駐輪場）,4,4,8,35.687031,139.739327,2024-02-08 13:08:04
734,A6-01.東郷元帥記念公園（南側）,3,2,5,35.689879,139.740178,2024-02-08 13:08:04
735,A5-03.参議院第二別館（永田町駅2番出口）,10,6,16,35.677763,139.74271,2024-02-08 13:08:04
736,A4-03.東京国際フォーラム（メトロD5出口）,8,0,8,35.675843,139.763329,2024-02-08 13:08:04
737,K1-15.セブン‐イレブン 大田区西蒲田店,3,0,3,35.56694,139.716331,2024-02-08 13:08:04
738,K1-49.ローソン仲池上一丁目店,1,9,10,35.586585,139.698552,2024-02-08 13:08:04
739,A2-06.東光電気工事 別館（屋内駐輪場）,7,0,7,35.69919,139.75701,2024-02-08 13:08:04
740,M4-01.新宿タカシマヤ,4,2,6,35.68714,139.702775,2024-02-08 13:08:04
741,M4-03.NTTドコモ代々木ビル,6,4,10,35.684451,139.702884,2024-02-08 13:08:04
742,M3-03.代官山 T-SITE,6,2,8,35.649823,139.700139,2024-02-08 13:08:04
743,K1-14.大森地域庁舎,6,3,9,35.578239,139.723262,2024-02-08 13:08:04
744,C5-46.ウエリスアーバン品川タワー,0,22,22,35.630961,139.746875,2024-02-08 13:08:04
745,C4-13.コシダコネクトビル,0,15,15,35.637765,139.739128,2024-02-08 13:08:04
746,K1-127.第二石井ビル,5,0,5,35.559286,139.722611,2024-02-08 13:08:04
747,C1-74.札の辻スクエア,6,2,8,35.645155,139.744543,2024-02-08 13:08:04
748,H1-164.森下三丁目第三児童遊園,0,19,19,35.68546,139.80244,2024-02-08 13:08:04
749,C1-78.CIRCLES新橋,9,0,9,35.66646,139.752138,2024-02-08 13:08:04
750,C3-34.3rd MINAMI AOYAMA,6,0,6,35.668622,139.715957,2024-02-08 13:08:04
751,O4-06.杉並区役所本庁舎,3,2,5,35.699328,139.636343,2024-02-08 13:08:04
752,D3-14.コーシャハイム高田馬場,5,1,6,35.712413,139.70168,2024-02-08 13:08:04
753,D7-11.新宿清掃事務所,2,4,6,35.716359,139.704377,2024-02-08 13:08:04
754,D5-08.ウエリス新宿早稲田の森,0,9,9,35.704597,139.708397,2024-02-08 13:08:04
755,E2-12.水道2丁目,0,29,29,35.709147,139.739183,2024-02-08 13:08:04
756,M6-10.京王コインパーク幡ヶ谷,0,11,11,35.6772,139.678117,2024-02-08 13:08:04
757,E3-05.文京スポーツセンター,49,11,60,35.721045,139.735687,2024-02-08 13:08:04
758,J1-36.WJ Haus,0,7,7,35.629067,139.711779,2024-02-08 13:08:04
759,K1-51.テクノポートカマタ 第2,11,0,11,35.555808,139.722791,2024-02-08 13:08:04
760,D1-13.新宿御苑新宿門【西側】,0,22,22,35.688945,139.706536,2024-02-08 13:08:04
761,I1-31.セブン-イレブン 品川戸越5丁目店,3,3,6,35.608193,139.719139,2024-02-08 13:08:04
762,T3-27.貫井川緑地,1,3,4,35.738427,139.632251,2024-02-08 13:08:04
763,H1-147.大島四丁目団地,9,8,17,35.68744,139.827075,2024-02-08 13:08:04
764,O4-02.成宗さくら公園,2,0,2,35.69638,139.63482,2024-02-08 13:08:04
765,O1-01.上瀬戸公園,3,1,4,35.72077,139.6045,2024-02-08 13:08:04
766,T2-15.NPC24H大泉学園南口パーキング,10,0,10,35.748611,139.584251,2024-02-08 13:08:04
767,O3-03.桃井1丁目5番地,6,1,7,35.71013,139.61194,2024-02-08 13:08:04
768,H1-08.東京テレポート駅,0,50,50,35.627087,139.779779,2024-02-08 13:08:04
769,H1-05.相鉄グランドフレッサ 東京ベイ有明,14,0,14,35.632148,139.79017,2024-02-08 13:08:04
770,H1-06.武蔵野大学,2,13,15,35.630185,139.786618,2024-02-08 13:08:04
771,A4-15.TOKIWAブリッジ,8,1,9,35.686389,139.769237,2024-02-08 13:08:04
772,H1-160.花の広場,8,9,17,35.633908,139.793322,2024-02-08 13:08:04
773,H1-01.豊洲ＩＨＩビル前（晴海通り）,10,0,10,35.658911,139.792531,2024-02-08 13:08:04
774,H1-02.豊洲駅,13,3,16,35.654196,139.79626,2024-02-08 13:08:04
775,J1-19.NTT東日本自由が丘ビル,3,1,4,35.615098,139.675954,2024-02-08 13:08:04
776,C2-19.広尾駅,5,0,5,35.650732,139.72256,2024-02-08 13:08:04
777,H1-114.東京夢の島マリーナ,5,10,15,35.651987,139.830691,2024-02-08 13:08:04
778,K1-71.ファミリーマート大田大森南店,2,3,5,35.562769,139.74327,2024-02-08 13:08:04
779,J1-20.すずめのお宿緑地公園,2,7,9,35.617773,139.685351,2024-02-08 13:08:04
780,H1-115.東京夢の島マリーナ 第4駐車場,2,12,14,35.650235,139.835993,2024-02-08 13:08:04
781,M5-10.富ヶ谷2丁目,15,2,17,35.665961,139.686491,2024-02-08 13:08:04
782,J1-21.中央緑地公園,0,9,9,35.630694,139.690482,2024-02-08 13:08:04
783,H1-116.出会い橋高架下,27,22,49,35.625037,139.777646,2024-02-08 13:08:04
784,M3-12.渋谷南東急ビル,6,0,6,35.656228,139.706284,2024-02-08 13:08:04
785,T2-01.大泉学園駅北口,2,3,5,35.749918,139.58618,2024-02-08 13:08:04
786,K1-06.大森駅入新井自転車駐車場,6,0,6,35.585269,139.726279,2024-02-08 13:08:04
787,D6-06.新宿中央公園（エコギャラリー下）,0,14,14,35.691199,139.687966,2024-02-08 13:08:04
788,D6-14.新宿ファーストウエスト,13,1,14,35.689529,139.695995,2024-02-08 13:08:04
789,D6-15.住友不動産西新宿ビル,11,0,11,35.69465,139.695911,2024-02-08 13:08:04
790,H1-56.南砂三丁目緑地公園西,0,30,30,35.672361,139.829825,2024-02-08 13:08:04
791,T2-74.扇橋公園,2,3,5,35.731791,139.588844,2024-02-08 13:08:04
792,B2-20.SHビル,3,0,3,35.675398,139.779962,2024-02-08 13:08:04
793,I1-17.東品川海上公園第2,0,16,16,35.616364,139.749171,2024-02-08 13:08:04
794,I1-16.品川浦,13,1,14,35.6214,139.741958,2024-02-08 13:08:04
795,A4-11.二重橋前駅(メトロ4番出口),5,0,5,35.680753,139.762069,2024-02-08 13:08:04
796,H1-76.有明物流センター,1,18,19,35.638571,139.78829,2024-02-08 13:08:04
797,K1-43.北馬込わくわく公園,0,14,14,35.600707,139.703216,2024-02-08 13:08:04
798,K1-42.馬込西公園,11,3,14,35.58849,139.70376,2024-02-08 13:08:04
799,T1-08.セブン-イレブン 練馬高松6丁目店,4,0,4,35.756506,139.620347,2024-02-08 13:08:04
800,T2-17.ファミリーマート 練馬石神井町八丁目店,0,6,6,35.74755,139.597968,2024-02-08 13:08:04
801,K1-31.テクノWING,0,12,12,35.546252,139.731708,2024-02-08 13:08:04
802,K1-32.石川町文化センター,5,0,5,35.601958,139.682876,2024-02-08 13:08:04
803,I1-20.しおじ公園,9,11,20,35.59632,139.751279,2024-02-08 13:08:04
804,I1-19.品川シーサイド公園第2,7,0,7,35.607571,139.749108,2024-02-08 13:08:04
805,J1-29.カスタリア目黒鷹番,2,3,5,35.626121,139.688576,2024-02-08 13:08:04
806,H1-127.古石場川親水公園,0,38,38,35.669291,139.795364,2024-02-08 13:08:04
807,D4-05.カスタリア新宿7丁目,0,14,14,35.700732,139.711472,2024-02-08 13:08:04
808,I1-71.セブン-イレブン南大井浜川店,0,4,4,35.596483,139.7355,2024-02-08 13:08:04
809,I1-72.セブン-イレブン大井店,0,22,22,35.600081,139.728193,2024-02-08 13:08:04
810,T3-21.くまのやま緑地,4,1,5,35.747038,139.667965,2024-02-08 13:08:04
811,K1-110.萩中集会所裏,9,4,13,35.550479,139.739538,2024-02-08 13:08:04
812,O2-02.シエール荻窪,30,0,30,35.708265,139.612703,2024-02-08 13:08:04
813,H1-128.豊洲市場（5街区）,31,3,34,35.645162,139.785386,2024-02-08 13:08:04
814,N1-09.若宮レジデンス,1,4,5,35.716184,139.643905,2024-02-08 13:08:04
815,M6-12.LIVART SEASON 幡ヶ谷,0,15,15,35.683156,139.67338,2024-02-08 13:08:04
816,H1-142.東京ベイ潮見プリンスホテル,0,19,19,35.660632,139.817294,2024-02-08 13:08:04
817,G1-01.鐘ヶ淵駅南自転車駐車場,1,8,9,35.732291,139.82012,2024-02-08 13:08:04
818,M1-01.渋谷区役所,8,0,8,35.66362,139.69801,2024-02-08 13:08:04
819,I1-83.かもめ歩道橋,0,25,25,35.600161,139.749902,2024-02-08 13:08:04
820,N4-05.セブン-イレブン中野鍋横店,3,2,5,35.693815,139.668571,2024-02-08 13:08:04
821,D4-02.JICA市ヶ谷ビル（地球ひろば／研究所）,7,0,7,35.694927,139.731328,2024-02-08 13:08:04
822,T3-19.なかみや児童遊園,1,4,5,35.749388,139.651824,2024-02-08 13:08:04
823,N1-08.上鷺自転車保管場所,2,5,7,35.729056,139.627864,2024-02-08 13:08:04
824,O7-06.松木1丁目,2,11,13,35.686015,139.642784,2024-02-08 13:08:04
825,E4-16.ビレッジワン,1,6,7,35.723723,139.740143,2024-02-08 13:08:04
826,D1-15.フロンティア四谷,1,8,9,35.68768,139.71937,2024-02-08 13:08:04
827,K1-128.大森西3丁目,2,13,15,35.571975,139.732137,2024-02-08 13:08:04
828,N1-06.大和区民活動センター,0,5,5,35.713562,139.649075,2024-02-08 13:08:04
829,G4-01.両国ビューホテル1,0,7,7,35.69566,139.79214,2024-02-08 13:08:04
830,G4-02.両国ビューホテル2,0,8,8,35.69562,139.79206,2024-02-08 13:08:04
831,G4-05.両国駅西口臨時自転車駐車場,18,2,20,35.698588,139.792946,2024-02-08 13:08:04
832,G4-03.本所1-6-5,10,4,14,35.702525,139.796632,2024-02-08 13:08:04
833,G5-01.牡丹橋自転車駐車場,15,2,17,35.693059,139.813417,2024-02-08 13:08:04
834,G5-02.横川3-7-10,17,20,37,35.70378,139.814298,2024-02-08 13:08:04
835,G4-04.NTTドコモ墨田ビル,14,7,21,35.697898,139.795345,2024-02-08 13:08:04
836,G2-02.押上1-23-8,1,6,7,35.710111,139.81488,2024-02-08 13:08:04
837,C5-13.区立芝浦西運河沿緑地,9,31,40,35.638245,139.749754,2024-02-08 13:08:04
838,D6-12.東京ビジネスホテル,0,3,3,35.69342,139.710568,2024-02-08 13:08:04
839,D6-11.ホテルリステル新宿,0,4,4,35.693029,139.711327,2024-02-08 13:08:04
840,D6-10.ホテルサンライト新宿,3,0,3,35.694201,139.707047,2024-02-08 13:08:04
841,H1-39.辰巳駅東口自転車駐車場,21,4,25,35.645823,139.812178,2024-02-08 13:08:04
842,H1-38.辰巳駅西口自転車駐車場,89,0,89,35.646857,139.808912,2024-02-08 13:08:04
843,C2-10.元麻布三丁目,0,7,7,35.655865,139.730566,2024-02-08 13:08:04
844,C2-09.麻布地区総合支所,2,0,2,35.660614,139.734771,2024-02-08 13:08:04
845,M3-20.東急ステイ渋谷新南口,8,0,8,35.65494,139.70534,2024-02-08 13:08:04
846,I1-86.ファミリーマート二葉三丁目店,3,0,3,35.601694,139.719778,2024-02-08 13:08:04
847,A2-23.axle御茶ノ水,7,0,7,35.696126,139.763297,2024-02-08 13:08:04
848,C4-02.白金台いきいきプラザ,4,1,5,35.63756,139.724981,2024-02-08 13:08:04
849,N3-04.東中野駅地下駐輪場,0,22,22,35.707883,139.683284,2024-02-08 13:08:04
850,N3-05.中野坂上駅地下駐輪場,0,6,6,35.698068,139.682781,2024-02-08 13:08:04
851,N3-03.青桐公園,0,15,15,35.697024,139.677846,2024-02-08 13:08:04
852,N3-01.中野四季の森公園,5,5,10,35.708487,139.662135,2024-02-08 13:08:04
853,N4-01.本四公園,1,9,10,35.69693,139.672721,2024-02-08 13:08:04
854,N4-02.栄町公園,0,11,11,35.686474,139.671383,2024-02-08 13:08:04
855,K1-57.池上本門寺,5,1,6,35.579585,139.705377,2024-02-08 13:08:04
856,C1-49.汐留シティセンター,12,3,15,35.666213,139.760907,2024-02-08 13:08:04
857,C4-15.クロスレジデンス白金高輪,0,13,13,35.642771,139.733046,2024-02-08 13:08:04
858,K1-56.NTT馬込ビル,0,9,9,35.588106,139.718852,2024-02-08 13:08:04
859,J1-41.CASSIA目黒,0,9,9,35.631319,139.70237,2024-02-08 13:08:04
860,A2-22.専修大学,6,0,6,35.696147,139.753709,2024-02-08 13:08:04
861,T3-20.はやいち公園,2,2,4,35.75312,139.65661,2024-02-08 13:08:04
862,B3-19.本の森ちゅうおう,9,0,9,35.67363,139.77623,2024-02-08 13:08:04
863,K1-86.IMPREST STAY TOKYO 蒲田,21,1,22,35.556267,139.727246,2024-02-08 13:08:04
864,T3-23.氷川台二丁目緑地,3,1,4,35.756575,139.669689,2024-02-08 13:08:04
865,T3-22.氷川台三丁目ちびっこ公園,1,2,3,35.750547,139.66707,2024-02-08 13:08:04
866,B1-23.NANAEI日本橋,4,3,7,35.679616,139.784341,2024-02-08 13:08:04
867,B2-11.京橋エドグラン,12,0,12,35.677576,139.769822,2024-02-08 13:08:04
868,N1-05.大野ハイツ,1,4,5,35.7266,139.62948,2024-02-08 13:08:04
869,B2-09.茅場町一丁目平和ビル,10,0,10,35.680203,139.778679,2024-02-08 13:08:04
870,B2-08.共同ビル（茅場町交差点前）,9,0,9,35.681012,139.778569,2024-02-08 13:08:04
871,B2-07.東京証券会館（北側）,1,0,1,35.680864,139.779331,2024-02-08 13:08:04
872,O3-12.大宮前体育館,0,3,3,35.696567,139.610517,2024-02-08 13:08:04
873,B1-08.明治座,0,19,19,35.688038,139.786561,2024-02-08 13:08:04
874,B4-05.ドコモ・バイクシェア晴海ポート,0,28,28,35.654165,139.781568,2024-02-08 13:08:04
875,B4-04.ＫＤＸ晴海ビル,0,0,0,35.65443,139.77843,2024-02-08 13:08:04
876,B4-03.桜の散歩道（晴海トリトンスクエア前）,4,12,16,35.658665,139.782553,2024-02-08 13:08:04
877,E5-08.セブン-イレブン 文京動坂上店,1,4,5,35.727778,139.756296,2024-02-08 13:08:04
878,H1-65.ローソン南砂日曹橋店,8,7,15,35.669507,139.825553,2024-02-08 13:08:04
879,H1-66.中川船番所資料館,0,8,8,35.687732,139.846383,2024-02-08 13:08:04
880,K1-113.ファミリーマート大田上池台四丁目店,1,6,7,35.594658,139.700133,2024-02-08 13:08:04
881,H1-64.ローソン東雲駅前店,9,1,10,35.640228,139.804267,2024-02-08 13:08:04
882,E1-11.小石川運動場前,12,3,15,35.703914,139.747061,2024-02-08 13:08:04
883,T2-70.三ツ塚けやき緑地,2,2,4,35.720318,139.570762,2024-02-08 13:08:04
884,H1-137.住友不動産ショッピングシティ有明ガーデン,21,0,21,35.638985,139.793653,2024-02-08 13:08:04
885,C5-40.芝浦ふ頭駅前暫定自転車駐車場,3,1,4,35.64096,139.75754,2024-02-08 13:08:04
886,M3-21.渋谷ソラスタ,11,1,12,35.65618,139.69612,2024-02-08 13:08:04
887,D7-03.中井駅北,19,12,31,35.715645,139.687486,2024-02-08 13:08:04
888,K1-119.シーンズ大森パークサイド,4,0,4,35.58223,139.72763,2024-02-08 13:08:04
889,M6-15.cova Hatagaya,0,2,2,35.67741,139.67383,2024-02-08 13:08:04
890,C2-25.アパホテル＆リゾート＜六本木駅東＞,33,9,42,35.661783,139.737242,2024-02-08 13:08:04
891,D4-10.東新宿ポート(余丁町6番),1,5,6,35.696585,139.713081,2024-02-08 13:08:04
892,O1-02.井荻南地下自転車駐車場,7,7,14,35.72424,139.61431,2024-02-08 13:08:04
893,O1-03.LUCKY HOUSE,1,3,4,35.72489,139.62383,2024-02-08 13:08:04
894,D6-30.京王プラザホテル,7,0,7,35.6897,139.694823,2024-02-08 13:08:04
895,D6-29.都庁第二本庁舎前,13,0,13,35.688735,139.692249,2024-02-08 13:08:04
896,O3-02.アートメゾン荻窪,6,2,8,35.71355,139.6199,2024-02-08 13:08:04
897,J1-57.トレインチ自由が丘,4,1,5,35.606667,139.667324,2024-02-08 13:08:04
898,O2-01.サカエフラット荻窪,10,1,11,35.70535,139.61497,2024-02-08 13:08:04
899,O3-01.西田公園,1,6,7,35.69575,139.62065,2024-02-08 13:08:04
900,K1-47.NTT雪ヶ谷ビル,8,2,10,35.598601,139.684747,2024-02-08 13:08:04
901,O7-04.永福町西幸モータープール西,7,1,8,35.67161,139.64527,2024-02-08 13:08:04
902,K1-48.ファミリーマート大田上池台三丁目店,0,21,21,35.590934,139.696915,2024-02-08 13:08:04
903,K1-111.本羽田公園,4,3,7,35.546499,139.736761,2024-02-08 13:08:04
904,C1-58.ウォーターズ竹芝,3,7,10,35.655937,139.763251,2024-02-08 13:08:04
905,K1-109.萩中公園プール駐輪場,8,0,8,35.549323,139.737091,2024-02-08 13:08:04
906,K1-108.仲江名公園,2,2,4,35.557999,139.732564,2024-02-08 13:08:04
907,E1-17.小石川パークスクエア,0,10,10,35.713913,139.745416,2024-02-08 13:08:04
908,D6-23.アパホテル 東新宿 歌舞伎町西,2,0,2,35.697535,139.703633,2024-02-08 13:08:04
909,H1-98.洲崎川緑道公園,0,34,34,35.668705,139.810549,2024-02-08 13:08:04
910,H1-99.南砂三丁目公園,19,5,24,35.669695,139.831874,2024-02-08 13:08:04
911,H1-96.越中島公園,0,18,18,35.668757,139.790156,2024-02-08 13:08:04
912,H1-97.浜園公園,0,18,18,35.661852,139.802224,2024-02-08 13:08:04
913,H1-94.新木場一丁目緑地公園,8,1,9,35.64423,139.835823,2024-02-08 13:08:04
914,H1-95.若洲公園,7,17,24,35.619451,139.834429,2024-02-08 13:08:04
915,J1-09.ファミリーマート佐野久下目黒店,2,3,5,35.629252,139.712716,2024-02-08 13:08:04
916,H1-93.新木場一丁目公園,7,0,7,35.64143,139.835455,2024-02-08 13:08:04
917,I1-55.鈴ヶ森公園,0,22,22,35.593559,139.734704,2024-02-08 13:08:04
918,O6-04.柏の宮公園,0,5,5,35.67834,139.62711,2024-02-08 13:08:04
919,B4-14.Brillia ist Tower 勝どき,0,21,21,35.660526,139.776816,2024-02-08 13:08:04
920,D7-08.上落合3丁目,2,11,13,35.71115,139.68232,2024-02-08 13:08:04
921,H1-21.UR東雲キャナルコート,0,89,89,35.646041,139.804495,2024-02-08 13:08:04
922,H1-20.日本科学未来館,23,7,30,35.619377,139.777582,2024-02-08 13:08:04
923,H1-19.UR豊洲四丁目団地,14,7,21,35.653603,139.80144,2024-02-08 13:08:04
924,T2-45.風致地区バス停第三自転車駐車場,0,7,7,35.771068,139.586798,2024-02-08 13:08:04
925,H1-33.深川ギャザリア（ウエストスクエア）,0,28,28,35.66789,139.803,2024-02-08 13:08:04
926,H1-32.区営塩浜住宅前,0,24,24,35.664591,139.813954,2024-02-08 13:08:04
927,H1-23.KDX豊洲グランスクエア,12,2,14,35.648085,139.798986,2024-02-08 13:08:04
928,C2-22.飯倉公園,9,1,10,35.655649,139.74427,2024-02-08 13:08:04
929,I1-89.下神明駅自転車駐車場,4,1,5,35.608402,139.726118,2024-02-08 13:08:04
930,C5-39.お台場海浜公園東,11,2,13,35.631021,139.778109,2024-02-08 13:08:04
931,C5-38.お台場海浜公園乗船場,0,15,15,35.628743,139.773915,2024-02-08 13:08:04
932,O4-08.ローソン阿佐ヶ谷青梅街道店,0,5,5,35.703203,139.62804,2024-02-08 13:08:04
933,T2-72.高塚南緑地,4,2,6,35.733132,139.570311,2024-02-08 13:08:04
934,O6-03.みなみ荘,6,4,10,35.68073,139.62803,2024-02-08 13:08:04
935,K1-129.ローソン東糀谷一丁目店,0,8,8,35.557427,139.739126,2024-02-08 13:08:04
936,E1-03.東京ドーム（黄色いビル横）,8,0,8,35.70319,139.751888,2024-02-08 13:08:04
937,K1-23.大田区役所本庁舎前,6,0,6,35.561183,139.716339,2024-02-08 13:08:04
938,T2-78.北大泉くれはし公園,1,2,3,35.761474,139.592735,2024-02-08 13:08:04
939,J1-53.ボヌールAllamanda,3,2,5,35.612833,139.675047,2024-02-08 13:08:04
940,A3-39.トーシン東神田ビル,0,4,4,35.694834,139.780333,2024-02-08 13:08:04
941,O6-01.高井戸みどり公園,4,5,9,35.67912,139.61074,2024-02-08 13:08:04
942,T2-79.大泉学園町八丁目緑地,4,2,6,35.774457,139.596182,2024-02-08 13:08:04
943,O5-04.リヴィエール,17,3,20,35.70104,139.65839,2024-02-08 13:08:04
944,N3-08.中野区役所(西側),6,0,6,35.707968,139.663519,2024-02-08 13:08:04
945,I1-99.北品川２丁目,4,2,6,35.61663,139.74192,2024-02-08 13:08:04
946,P1-01.サンシャインシティ,5,2,7,35.728846,139.718577,2024-02-08 13:08:04
947,N3-14.ヴィラソンサ落合,0,7,7,35.713227,139.680966,2024-02-08 13:08:04
948,H1-49.セブン-イレブン 江東新砂３丁目店,0,22,22,35.667892,139.8311,2024-02-08 13:08:04
949,I1-06.大森貝塚遺跡庭園,9,0,9,35.593489,139.72967,2024-02-08 13:08:04
950,M2-12.恵比寿プライムスクエアタワー北,8,1,9,35.650541,139.713361,2024-02-08 13:08:04
951,H1-69.ファミリーマート 江東石島店,0,32,32,35.680474,139.812316,2024-02-08 13:08:04
952,B3-09.築地永谷コーポラス,0,16,16,35.66523,139.776313,2024-02-08 13:08:04
953,E4-10.白山四丁目第二児童遊園横,3,8,11,35.720349,139.746924,2024-02-08 13:08:04
954,I1-03.大井町駅中央口（西側）,7,0,7,35.605617,139.73472,2024-02-08 13:08:04
955,I1-04.大井町歩道橋,5,0,5,35.605146,139.734694,2024-02-08 13:08:04
956,I1-01.品川区役所 本庁舎前,10,0,10,35.609052,139.729825,2024-02-08 13:08:04
957,I1-02.品川区役所 第三庁舎前,9,0,9,35.608161,139.730048,2024-02-08 13:08:04
958,G4-08.ブオンサンヴァレンティーノ,0,6,6,35.691677,139.793857,2024-02-08 13:08:04
959,J1-13.洗足二丁目駐輪場,13,4,17,35.61061,139.693443,2024-02-08 13:08:04
960,J1-16.八雲橋自転車置場,2,4,6,35.617353,139.672256,2024-02-08 13:08:04
961,H1-189.MFLP新木場2,0,35,35,35.634453,139.824,2024-02-08 13:08:04
962,M6-09.ファミリーマート渋谷本町店,0,11,11,35.683756,139.684965,2024-02-08 13:08:04
963,H1-113.123+N東雲店,0,36,36,35.646366,139.801492,2024-02-08 13:08:04
964,J1-17.ファミリーマート原町二丁目店,0,6,6,35.613902,139.691476,2024-02-08 13:08:04
965,E5-21.動坂公園,0,11,11,35.73176,139.756669,2024-02-08 13:08:04
966,E5-20.本郷2丁目,0,8,8,35.704391,139.758575,2024-02-08 13:08:04
967,T2-48.武蔵関駅南第二自転車駐車場,2,2,4,35.726064,139.578015,2024-02-08 13:08:04
968,A6-26.相互半蔵門ビル,6,3,9,35.683378,139.743189,2024-02-08 13:08:04
969,J1-31.守屋図書館,12,7,19,35.634194,139.688833,2024-02-08 13:08:04
970,M3-19.渋谷キャスト,21,0,21,35.662146,139.702793,2024-02-08 13:08:04
971,N1-04.都立家政南駐輪場,0,10,10,35.721679,139.645265,2024-02-08 13:08:04
972,N2-02.江古田1丁目A,0,3,3,35.724988,139.672511,2024-02-08 13:08:04
973,C1-56.鈴与竹芝ビル,3,2,5,35.654873,139.762103,2024-02-08 13:08:04
974,D3-07.戸塚特別出張所,6,1,7,35.71429,139.70507,2024-02-08 13:08:04
975,G4-12.プレミアムキューブ両国,0,7,7,35.70103,139.803341,2024-02-08 13:08:04
976,A2-21.神田神保町3丁目,7,0,7,35.694578,139.754434,2024-02-08 13:08:04
977,B4-19.コーシャタワー佃,0,25,25,35.668044,139.785801,2024-02-08 13:08:04
978,I1-81.戸越6丁目,16,4,20,35.608127,139.717865,2024-02-08 13:08:04
979,A6-24.国立劇場,0,15,15,35.682218,139.743292,2024-02-08 13:08:04
980,E5-23.ビレッジ千駄木,0,7,7,35.722353,139.760966,2024-02-08 13:08:04
981,H1-119.榎戸材木店,0,6,6,35.638319,139.834741,2024-02-08 13:08:04
982,C5-29.Hi-NODE(ハイノード),7,1,8,35.651672,139.760549,2024-02-08 13:08:04
983,J1-22.NTTコミュニケーションズ唐ヶ崎ビル,0,4,4,35.627373,139.692044,2024-02-08 13:08:04
984,A2-18.猿楽町SSビル東,4,1,5,35.698654,139.759762,2024-02-08 13:08:04
985,A2-19.猿楽町SSビル西,3,0,3,35.698641,139.759306,2024-02-08 13:08:04
986,C1-55.アーバンネット内幸町ビル,19,1,20,35.669267,139.756018,2024-02-08 13:08:04
987,D4-06.グリーンフォート河田,0,13,13,35.697143,139.718739,2024-02-08 13:08:04
988,K1-134.東調布公園,3,7,10,35.588363,139.69042,2024-02-08 13:08:04
989,M5-18.Luxe初台,0,5,5,35.679182,139.68596,2024-02-08 13:08:04
990,D7-06.エムアイセミナーハウス,3,2,5,35.721064,139.677128,2024-02-08 13:08:04
991,A3-37.ポータル秋葉原,0,25,25,35.695737,139.78162,2024-02-08 13:08:04
992,M5-11.あおい通り,8,1,9,35.688154,139.698975,2024-02-08 13:08:04
993,E5-04.保健サービスセンター本郷支所,0,5,5,35.727046,139.760439,2024-02-08 13:08:04
994,E5-03.汐見地域活動センター（本郷図書館）,0,5,5,35.725538,139.76116,2024-02-08 13:08:04
995,E5-01.文京総合体育館,30,1,31,35.708121,139.763583,2024-02-08 13:08:04
996,E4-01.千石南自転車駐車場,5,20,25,35.72707,139.746112,2024-02-08 13:08:04
997,E3-03.大塚公園,4,17,21,35.724286,139.730954,2024-02-08 13:08:04
998,E3-02.教育の森公園,5,12,17,35.719345,139.736198,2024-02-08 13:08:04
999,I1-25.セブン-イレブン 品川旗の台2丁目店,0,3,3,35.607084,139.705007,2024-02-08 13:08:04
1000,B1-21.日本橋二丁目街角広場,11,0,11,35.680861,139.774493,2024-02-08 13:08:04
1001,C3-30.東京赤坂NKビル (ヴィアインプライム赤坂),9,0,9,35.672652,139.738908,2024-02-08 13:08:04
1002,A3-36.クロックカフェ東神田,0,5,5,35.694943,139.782718,2024-02-08 13:08:04
1003,E1-14.いきいき礫川,0,9,9,35.711147,139.747386,2024-02-08 13:08:04
1004,D4-09.トミンハイム仲之町,0,13,13,35.69617,139.722021,2024-02-08 13:08:04
1005,L1-08.NTT砧ビル,0,6,6,35.63534,139.601602,2024-02-08 13:08:04
1006,L1-09.コージーK・駒沢,2,2,4,35.632689,139.654804,2024-02-08 13:08:04
1007,L1-10.宮坂2-4-10,0,7,7,35.652913,139.644825,2024-02-08 13:08:04
1008,I1-22.ウィラ大井 (ショッピングモール),2,3,5,35.596579,139.745009,2024-02-08 13:08:04
1009,K1-76.グリーンベルト,9,0,9,35.585178,139.726339,2024-02-08 13:08:04
1010,H1-121.南砂5丁目,0,42,42,35.676603,139.829736,2024-02-08 13:08:04
1011,M3-02.文化総合センター大和田,5,0,5,35.65558,139.69966,2024-02-08 13:08:04
1012,D4-04.ジェノヴィア新宿早稲田グリーンヴェール,1,5,6,35.700033,139.71983,2024-02-08 13:08:04
1013,A3-20.神田ふれあい通り第２,1,1,2,35.695005,139.772747,2024-02-08 13:08:04
1014,H1-120.豊洲5丁目,17,1,18,35.650948,139.799711,2024-02-08 13:08:04
1015,C5-42.DHC芝浦2丁目ビル,1,7,8,35.644241,139.753834,2024-02-08 13:08:04
1016,I1-65.セブン-イレブン品川東大井1丁目店,7,0,7,35.605996,139.743037,2024-02-08 13:08:04
1017,M2-04.広尾東公園,5,1,6,35.653382,139.721059,2024-02-08 13:08:04
1018,M3-13.渋谷駅東口地下駐輪場,18,0,18,35.657682,139.703307,2024-02-08 13:08:04
1019,A3-19.神田ふれあい通り第１,0,5,5,35.694904,139.772712,2024-02-08 13:08:04
1020,O6-07.ローソン杉並宮前一丁目店,2,3,5,35.689639,139.613516,2024-02-08 13:08:04
1021,T3-10.貫井一丁目緑地,0,3,3,35.736378,139.632485,2024-02-08 13:08:04
1022,M2-05.日本赤十字医療センター,1,9,10,35.65519,139.718559,2024-02-08 13:08:04
1023,T2-20.パークサイド石神井,0,13,13,35.741769,139.591103,2024-02-08 13:08:04
1024,N4-06.ローソン中野本町新橋通り店,0,6,6,35.695819,139.674326,2024-02-08 13:08:04
1025,T3-07.徳殿公園,3,1,4,35.726728,139.65874,2024-02-08 13:08:04
1026,K1-35.セブン-イレブン 大田区西六郷2丁目店,0,13,13,35.549778,139.707362,2024-02-08 13:08:04
1027,A3-27.秋葉原駅中央口（ヨドバシカメラ前）,5,5,10,35.698986,139.774099,2024-02-08 13:08:04
1028,A3-28.秋葉原駅電気街口(西側交通広場),5,0,5,35.699173,139.772629,2024-02-08 13:08:04
1029,H1-57.新木場駅,5,60,65,35.64508,139.826456,2024-02-08 13:08:04
1030,H1-58.潮見駅,0,27,27,35.658703,139.817251,2024-02-08 13:08:04
1031,D7-02.セブン-イレブン 新宿中落合3丁目店,0,16,16,35.722202,139.691712,2024-02-08 13:08:04
1032,D2-06.飯田濠,13,1,14,35.70057,139.74301,2024-02-08 13:08:04
1033,C5-17.鈴与浜松町ビル,6,3,9,35.651103,139.759092,2024-02-08 13:08:04
1034,H1-59.LYURO 東京清澄,0,24,24,35.681316,139.792176,2024-02-08 13:08:04
1035,H1-60.荒川・砂町庭球場西,0,29,29,35.679678,139.844892,2024-02-08 13:08:04
1036,K1-44.中馬込貝塚公園,1,6,7,35.594795,139.704951,2024-02-08 13:08:04
1037,M6-11.京王サイクルパーク笹塚,0,5,5,35.674337,139.668801,2024-02-08 13:08:04
1038,J1-49.伊勢脇公園,1,3,4,35.638864,139.696568,2024-02-08 13:08:04
1039,K1-45.たぬき山公園,1,7,8,35.592801,139.715472,2024-02-08 13:08:04
1040,D2-01.あずさセンタービル,12,6,18,35.702286,139.741093,2024-02-08 13:08:04
1041,C1-02.西新橋1丁目（外堀通り）,5,1,6,35.668791,139.753582,2024-02-08 13:08:04
1042,O3-07.NTT井草ビル第1ポート,2,1,3,35.714044,139.61688,2024-02-08 13:08:04
1043,T2-41.ローソン 練馬東大泉五丁目店,0,4,4,35.74248,139.58715,2024-02-08 13:08:04
1044,H1-144.南砂住宅,0,18,18,35.674199,139.822018,2024-02-08 13:08:04
1045,C3-28.ヒューリックＪＰ赤坂ビル,11,0,11,35.672477,139.739743,2024-02-08 13:08:04
1046,H1-145.東雲都橋住宅,0,14,14,35.643131,139.797784,2024-02-08 13:08:04
1047,I1-58.品川区役所　第二庁舎前,18,0,18,35.609664,139.730006,2024-02-08 13:08:04
1048,K1-92.蒲田駅西口自転車駐車場,25,0,25,35.561101,139.715173,2024-02-08 13:08:04
1049,A2-24.水道橋駅西口前,6,0,6,35.702271,139.752619,2024-02-08 13:08:04
1050,K1-94.昭和島駅前,0,25,25,35.572188,139.749613,2024-02-08 13:08:04
1051,M5-15.新宿マインズタワー,18,2,20,35.686567,139.699355,2024-02-08 13:08:04
1052,D7-13.日本光電本社南側,11,4,15,35.71936,139.679083,2024-02-08 13:08:04
1053,N3-09.中野区役所(北側),5,0,5,35.708259,139.663829,2024-02-08 13:08:04
1054,H1-163.森下公園,2,3,5,35.68663,139.799529,2024-02-08 13:08:04
1055,B4-23.交通広場（豊海町）,0,12,12,35.653771,139.769295,2024-02-08 13:08:04
1056,D6-18.ヨドバシカメラ 新宿西口本店前,1,5,6,35.689689,139.698231,2024-02-08 13:08:04
1057,I1-47.NTT 東日本 関東病院(南側),7,0,7,35.630151,139.725215,2024-02-08 13:08:04
1058,H1-112.ファミリーマート江東塩浜二丁目店,3,0,3,35.66305,139.8087,2024-02-08 13:08:04
1059,K1-103.雪谷特別出張所,0,7,7,35.594515,139.691219,2024-02-08 13:08:04
1060,E5-17.Village藍染,0,5,5,35.720896,139.76422,2024-02-08 13:08:04
1061,I1-49.京急鮫洲バイク駐輪場,6,0,6,35.603815,139.741362,2024-02-08 13:08:04
1062,I1-50.京急立会川第2バイク駐輪場,0,13,13,35.599196,139.739158,2024-02-08 13:08:04
1063,E4-14.NTT東日本大塚ビル,0,17,17,35.726188,139.741375,2024-02-08 13:08:04
1064,M2-07.ファミリーマート恵比寿駅東店,7,0,7,35.6471,139.712818,2024-02-08 13:08:04
1065,M4-07.千駄ヶ谷駅前,1,3,4,35.68082,139.71188,2024-02-08 13:08:04
1066,O5-07.バーンホーフ キクチ,11,9,20,35.698169,139.655665,2024-02-08 13:08:04
1067,J1-11.コンフォリア目黒青葉台,0,6,6,35.649023,139.696086,2024-02-08 13:08:04
1068,L1-14.給田3丁目,0,13,13,35.664335,139.590114,2024-02-08 13:08:04
1069,B4-06.月島駅地下駐輪場,1,16,17,35.66291,139.782564,2024-02-08 13:08:04
1070,C5-09.グランパーク,20,1,21,35.643202,139.746244,2024-02-08 13:08:04
1071,C5-08.AQUACITY芝浦,5,6,11,35.637366,139.74844,2024-02-08 13:08:04
1072,C3-08.赤坂パークビルヂング,5,0,5,35.671792,139.733668,2024-02-08 13:08:04
1073,C3-07.新青山ビル,17,1,18,35.672659,139.725644,2024-02-08 13:08:04
1074,C3-06.ホテルアジア会館,0,11,11,35.67064,139.728166,2024-02-08 13:08:04
1075,C1-24.三田国際ビル,0,10,10,35.653159,139.744673,2024-02-08 13:08:04
1076,C5-07.港区立港南図書館,0,37,37,35.632842,139.7495,2024-02-08 13:08:04
1077,A3-04.秋葉原公園,0,18,18,35.697642,139.774867,2024-02-08 13:08:04
1078,A3-05.和泉公園（西側入口）,4,2,6,35.698817,139.778898,2024-02-08 13:08:04
1079,A3-02.絶滅メディア博物館（楓ビル）,8,0,8,35.689575,139.767848,2024-02-08 13:08:04
1080,O3-10.メゾンパークス,3,5,8,35.716265,139.618954,2024-02-08 13:08:04
1081,A2-05.神田橋公園,1,0,1,35.689665,139.764091,2024-02-08 13:08:04
1082,A3-01.神田児童公園（西側交番横）,4,2,6,35.692983,139.76773,2024-02-08 13:08:04
1083,A2-03.西神田公園（西側）,5,0,5,35.698338,139.754876,2024-02-08 13:08:04
1084,M6-03.十三号通り公園,0,9,9,35.675198,139.663587,2024-02-08 13:08:04
1085,M6-02.サイカパーク笹塚,0,10,10,35.673444,139.666553,2024-02-08 13:08:04
1086,H1-165.亀戸梅屋敷,0,10,10,35.701318,139.825916,2024-02-08 13:08:04
1087,H1-166.亀戸クロック,16,3,19,35.696574,139.82972,2024-02-08 13:08:04
1088,M5-02.あいおいニッセイ同和損保新宿ビル,0,4,4,35.684423,139.692262,2024-02-08 13:08:04
1089,M6-01.幡ヶ谷駅高架下第一,23,12,35,35.677175,139.676769,2024-02-08 13:08:04
1090,A5-02.山王パークタワー,4,1,5,35.673555,139.741293,2024-02-08 13:08:04
1091,K1-116.旧呑川緑地（大森東五丁目）,5,7,12,35.567176,139.742345,2024-02-08 13:08:04
1092,K1-115.旧呑川緑地（大森中三丁目）,0,7,7,35.565685,139.736195,2024-02-08 13:08:04
1093,K1-114.下丸子公園,6,2,8,35.568722,139.680736,2024-02-08 13:08:04
1094,T3-05.東武練馬駅南,0,10,10,35.767129,139.664365,2024-02-08 13:08:04
1095,T1-14.ファミリーマート 練馬高松五丁目北店,4,0,4,35.761038,139.623148,2024-02-08 13:08:04
1096,C3-29.高橋是清翁記念公園,5,2,7,35.674094,139.728895,2024-02-08 13:08:04
1097,K1-141.蒲田駅西口歩道,4,1,5,35.561291,139.715076,2024-02-08 13:08:04
1098,C3-35.ワールド北青山ビル,17,0,17,35.667069,139.713423,2024-02-08 13:08:04
1099,M5-03.代々木大山公園,9,7,16,35.671282,139.675307,2024-02-08 13:08:04
1100,E5-13.弥生二丁目,4,2,6,35.715592,139.76192,2024-02-08 13:08:04
1101,E5-12.NK本郷ビル,0,6,6,35.704475,139.763041,2024-02-08 13:08:04
1102,B3-18.銀座松竹スクエア,10,0,10,35.668395,139.769849,2024-02-08 13:08:04
1103,C1-44.三田Avanti,5,1,6,35.64115,139.741471,2024-02-08 13:08:04
1104,T2-31.ファミリーマート 石神井台二丁目店,0,9,9,35.739488,139.590273,2024-02-08 13:08:04
1105,H1-150.ホテルヴィラフォンテーヌ南側,8,1,9,35.636978,139.791858,2024-02-08 13:08:04
1106,H1-149.有明ガーデン 公園口,8,0,8,35.639132,139.793047,2024-02-08 13:08:04
1107,H1-148.大島七丁目団地,0,17,17,35.694104,139.840278,2024-02-08 13:08:04
1108,B4-26.東武ストア晴海三丁目店,1,14,15,35.654371,139.779545,2024-02-08 13:08:04
1109,J1-26.田向公園,3,4,7,35.623459,139.687128,2024-02-08 13:08:04
1110,J1-25.碑文谷公園,3,5,8,35.625081,139.682632,2024-02-08 13:08:04
1111,H1-195.東京アクアティクスセンター,5,14,19,35.65238,139.815613,2024-02-08 13:08:04
1112,T1-13.ファミリーマート 練馬土支田二丁目店,0,13,13,35.761613,139.61349,2024-02-08 13:08:04
1113,T2-34.ファミリーマート 練馬富士見台店,0,5,5,35.73969,139.62125,2024-02-08 13:08:04
1114,T2-35.ファミリーマート 石神井台六丁目店,0,5,5,35.738607,139.585331,2024-02-08 13:08:04
1115,C1-81.田町タワー,20,0,20,35.646534,139.748913,2024-02-08 13:08:04
1116,J1-07.目黒川船入場,14,1,15,35.641992,139.701588,2024-02-08 13:08:04
1117,J1-08.目黒区民センター公園,14,4,18,35.634533,139.708868,2024-02-08 13:08:04
1118,D4-01.市谷仲之町,2,4,6,35.695102,139.723345,2024-02-08 13:08:04
1119,M2-11.鉢山町,15,1,16,35.652151,139.698426,2024-02-08 13:08:04
1120,E4-08.ドコモ・バイクシェア向丘ポート,1,8,9,35.720546,139.756685,2024-02-08 13:08:04
1121,D4-03.市谷加賀町2丁目,0,10,10,35.695636,139.727882,2024-02-08 13:08:04
1122,N1-01.BeGood野方,0,11,11,35.719717,139.64785,2024-02-08 13:08:04
1123,C2-03.アークヒルズサウスタワー,9,2,11,35.666357,139.73923,2024-02-08 13:08:04
1124,C2-01.アークヒルズ（アーク森ビル）,7,4,11,35.667107,139.739565,2024-02-08 13:08:04
1125,C2-02.六本木ヒルズ,27,0,27,35.661158,139.728533,2024-02-08 13:08:04
1126,C5-03.港南公園C,7,19,26,35.624966,139.746657,2024-02-08 13:08:04
1127,C5-04.みなとパーク芝浦,10,1,11,35.646801,139.751208,2024-02-08 13:08:04
1128,C1-16.機械振興会館,6,0,6,35.659442,139.745549,2024-02-08 13:08:04
1129,C1-14.新橋プラザビル,0,4,4,35.664461,139.756082,2024-02-08 13:08:04
1130,H1-73.イシマビル,0,9,9,35.67386,139.79976,2024-02-08 13:08:04
1131,O7-01.西永福公園,4,1,5,35.67753,139.63667,2024-02-08 13:08:04
1132,O6-02.富士見ヶ丘南自転車駐車場,6,2,8,35.68296,139.60861,2024-02-08 13:08:04
1133,K1-50.テクノポートカマタ 第1,6,0,6,35.556199,139.721476,2024-02-08 13:08:04
1134,J1-14.二の橋自転車置場1,36,3,39,35.614856,139.678208,2024-02-08 13:08:04
1135,O3-08.NTT井草ビル第２ポート,0,3,3,35.714077,139.61694,2024-02-08 13:08:04
1136,H1-124.セブン-イレブン 江東海辺店,1,12,13,35.680636,139.817977,2024-02-08 13:08:04
1137,D1-11.三井ガーデンホテル神宮外苑の杜プレミア,5,0,5,35.679807,139.715931,2024-02-08 13:08:04
1138,O7-07.ハレ永福,1,7,8,35.678913,139.639944,2024-02-08 13:08:04
1139,C5-32.トレードピアお台場,4,1,5,35.627891,139.776896,2024-02-08 13:08:04
1140,B4-18.豊海センタービル,0,6,6,35.653531,139.769431,2024-02-08 13:08:04
1141,D5-04.西戸山公園野球場,2,5,7,35.707388,139.700204,2024-02-08 13:08:04
1142,D5-03.北新宿公園,0,14,14,35.702288,139.68862,2024-02-08 13:08:04
1143,D3-04.鶴巻南公園,0,25,25,35.706182,139.723394,2024-02-08 13:08:04
1144,D3-03.甘泉園公園,0,15,15,35.712431,139.715418,2024-02-08 13:08:04
1145,K1-03.池上会館,0,7,7,35.576593,139.706597,2024-02-08 13:08:04
1146,K1-02.平和の森公園,11,4,15,35.579049,139.739878,2024-02-08 13:08:04
1147,K1-01.大森海苔のふるさと館,0,11,11,35.57685,139.742496,2024-02-08 13:08:04
1148,D6-13.新宿中央公園（ジャブジャブ池下）,8,1,9,35.687652,139.689254,2024-02-08 13:08:04
1149,T2-28.ファミリーマート 南大泉六丁目店,3,2,5,35.752217,139.571095,2024-02-08 13:08:04
1150,K1-05.平和島公園プール,13,4,17,35.581832,139.741581,2024-02-08 13:08:04
1151,K1-04.京急蒲田駅東口,20,1,21,35.559483,139.724273,2024-02-08 13:08:04
1152,E2-10.音羽パークロード（北入口）,13,2,15,35.716586,139.727705,2024-02-08 13:08:04
1153,E2-11.音羽パークロード（キャッチボール場横）,13,7,20,35.715382,139.728533,2024-02-08 13:08:04
1154,I1-21.大井競馬場(正門前),10,0,10,35.593887,139.741204,2024-02-08 13:08:04
1155,J1-27.衾町公園,1,0,1,35.623215,139.668472,2024-02-08 13:08:04
1156,T2-44.中島橋自転車駐車場,5,2,7,35.75372,139.584332,2024-02-08 13:08:04
1157,B3-15.ACホテル・バイ・マリオット東京銀座,8,0,8,35.668845,139.765144,2024-02-08 13:08:04
1158,D5-07.百人町1丁目,3,2,5,35.699252,139.697606,2024-02-08 13:08:04
1159,C4-04.ショパン高輪,0,11,11,35.632128,139.732097,2024-02-08 13:08:04
1160,B1-18.セブン-イレブン 日本橋小網町店,2,1,3,35.681352,139.781436,2024-02-08 13:08:04
1161,T2-71.わかば児童公園,4,3,7,35.7211,139.574669,2024-02-08 13:08:04
1162,M3-15.co-ba ebisu,6,0,6,35.647076,139.703964,2024-02-08 13:08:04
1163,C2-20.三井ガーデンホテル六本木プレミア,4,0,4,35.66206,139.735501,2024-02-08 13:08:04
1164,I1-70.五反田リバーステーション,4,4,8,35.624566,139.72448,2024-02-08 13:08:04
1165,E5-25.ジェノヴィア東大前グリーンヴェール,7,4,11,35.711875,139.759306,2024-02-08 13:08:04
1166,D1-12.ジェノヴィア新宿御苑グリーンヴェール,1,6,7,35.689017,139.714755,2024-02-08 13:08:04
1167,C5-33.msb Tamachi,37,1,38,35.645682,139.748768,2024-02-08 13:08:04
1168,G4-09.SYFORME MORISHITA Ⅱ 1,1,0,1,35.690348,139.796133,2024-02-08 13:08:04
1169,G4-10.SYFORME MORISHITA Ⅱ 2,1,4,5,35.690307,139.796128,2024-02-08 13:08:04
1170,N3-19.上高田パーキング,0,17,17,35.715878,139.673669,2024-02-08 13:08:04
1171,F6-01.松坂屋上野店,1,3,4,35.707305,139.773657,2024-02-08 13:08:04
1172,F4-01.SYFORME ASAKUSA,0,4,4,35.718832,139.791133,2024-02-08 13:08:04
1173,F2-02.アップルパーク浅草6丁目第3,0,3,3,35.716062,139.799552,2024-02-08 13:08:04
1174,F2-01.松が谷2丁目2,0,20,20,35.71283,139.787754,2024-02-08 13:08:04
1175,F1-02.台東デザイナーズビレッジ,1,6,7,35.706023,139.783751,2024-02-08 13:08:04
1176,F2-03.台東区生涯学習センター,0,6,6,35.717497,139.790055,2024-02-08 13:08:04
1177,K1-146.南馬込6丁目25-11,0,3,3,35.582743,139.710561,2024-02-08 13:08:04
1178,F3-01.清川1丁目18-11,0,17,17,35.724944,139.801684,2024-02-08 13:08:04
1179,F1-03.新御徒町駅自転車駐車場,4,12,16,35.706793,139.782985,2024-02-08 13:08:04
1180,F3-02.台東区リバーサイドスポーツセンター,0,7,7,35.717571,139.804216,2024-02-08 13:08:04
1181,I1-45.セブン-イレブン品川西五反田3丁目店,5,0,5,35.62541,139.718135,2024-02-08 13:08:04
1182,H1-135.北砂5丁目団地,0,35,35,35.684218,139.832843,2024-02-08 13:08:04
1183,C3-16.赤坂ガーデンシティ,0,10,10,35.6738,139.731525,2024-02-08 13:08:04
1184,J1-34.田道広場公園,7,3,10,35.636269,139.709073,2024-02-08 13:08:04
1185,O5-08.セシオン杉並,1,2,3,35.69714,139.65432,2024-02-08 13:08:04
1186,A2-04.ちよだプラットフォームスクウェア,10,0,10,35.691456,139.762228,2024-02-08 13:08:04
1187,I1-102.J.GRAN Court 品川西大井 EAST,2,5,7,35.598244,139.722447,2024-02-08 13:08:04
1188,H1-196.フットサルクラブ東京東陽町,5,1,6,35.665288,139.824294,2024-02-08 13:08:04
1189,F2-04.コンフォラス浅草マンション,0,3,3,35.717241,139.801674,2024-02-08 13:08:04
1190,G5-03.京成リッチモンドホテル東京錦糸町,3,2,5,35.693492,139.81506,2024-02-08 13:08:04
1191,K1-27.六郷文化センター,1,3,4,35.544715,139.707623,2024-02-08 13:08:04
1192,K1-147.トヨタモビリティ東京GRGarage東京蒲田店,2,0,2,35.552741,139.718404,2024-02-08 13:08:04
1193,K1-148.トヨタモビリティ東京 蒲田仲六郷店,6,0,6,35.552068,139.71747,2024-02-08 13:08:04
1194,K1-150.トヨタモビリティ東京 池上第二京浜店,1,4,5,35.568019,139.696379,2024-02-08 13:08:04
1195,K1-149.トヨタモビリティ東京 大田店,1,5,6,35.59336,139.715879,2024-02-08 13:08:04
1196,C1-82.トヨタモビリティ東京 港三田店,0,5,5,35.647831,139.739048,2024-02-08 13:08:04
1197,D4-11.トヨタモビリティ東京 新宿明治通り南店,2,0,2,35.699835,139.70808,2024-02-08 13:08:04
1198,C3-31.赤坂一丁目,13,4,17,35.670239,139.744285,2024-02-08 13:08:04
1199,E1-04.礫川公園,35,6,41,35.707853,139.751518,2024-02-08 13:08:04
1200,M3-23.円山町7-1,0,9,9,35.658229,139.694885,2024-02-08 13:08:04
1201,M3-24.渋谷道玄坂２丁目駐輪場,3,16,19,35.66026,139.69684,2024-02-08 13:08:04
1202,T3-32.練馬北町1丁目,1,4,5,35.764452,139.666299,2024-02-08 13:08:04
1203,H1-197.セブン-イレブン江東南砂葛西橋通り店,0,4,4,35.675361,139.825034,2024-02-08 13:08:04
1204,T2-84.石神井町二丁目緑地,0,3,3,35.748395,139.605958,2024-02-08 13:08:04
1205,T2-82.梅の木児童遊園,0,5,5,35.737899,139.576584,2024-02-08 13:08:04
1206,T2-83.西大泉さくら緑地,4,4,8,35.760442,139.573145,2024-02-08 13:08:04
1207,D7-05.西落合図書館,7,1,8,35.725818,139.678976,2024-02-08 13:08:04
1208,D6-28.東急ステイ新宿,3,0,3,35.690899,139.706348,2024-02-08 13:08:04
1209,T2-85.泉新公園,3,1,4,35.7547,139.601497,2024-02-08 13:08:04
1210,T2-86.石神井町八丁目緑地,2,1,3,35.746956,139.600798,2024-02-08 13:08:04
1211,T2-87.南大泉四丁目児童遊園,0,4,4,35.745607,139.573947,2024-02-08 13:08:04
1212,T2-88.南大泉かたまち緑地,0,4,4,35.739633,139.570457,2024-02-08 13:08:04
1213,T2-89.南大泉三丁目児童遊園,0,3,3,35.742755,139.568335,2024-02-08 13:08:04
1214,E2-05.護国寺駅西自転車駐車場,20,2,22,35.719421,139.725584,2024-02-08 13:08:04
1215,J1-59.第44興和ビル,3,1,4,35.647704,139.693671,2024-02-08 13:08:04
1216,C1-15.東京タワー,11,5,16,35.65928,139.744767,2024-02-08 13:08:04
1217,C5-20.ローソン芝浦二丁目店,3,1,4,35.645254,139.754765,2024-02-08 13:08:04
1218,C2-27.有栖川宮記念公園第一,17,0,17,35.651382,139.724392,2024-02-08 13:08:04
1219,C2-28.有栖川宮記念公園第二,4,4,8,35.651129,139.726003,2024-02-08 13:08:04
1220,C2-29.狸穴公園,4,1,5,35.658204,139.738935,2024-02-08 13:08:04
1221,T2-90.南田中四丁目緑地,2,2,4,35.733195,139.612327,2024-02-08 13:08:04
1222,T2-91.石神井町四丁目緑地,5,0,5,35.745272,139.604579,2024-02-08 13:08:04
1223,A3-41.秋葉原ダイビル,4,1,5,35.698917,139.771856,2024-02-08 13:08:04
1224,J1-54.田道住区センター三田分室,5,0,5,35.638904,139.712518,2024-02-08 13:08:04
1225,H1-140.キャナルパレス住吉,12,4,16,35.689896,139.815116,2024-02-08 13:08:04
1226,C1-57.虎ノ門ツインビルディング,7,0,7,35.667259,139.745643,2024-02-08 13:08:04
1227,K1-54.ファミリーマート大田久が原五丁目店,0,16,16,35.579435,139.698552,2024-02-08 13:08:04
1228,B1-29.ASTILE日本橋浜町,0,8,8,35.685504,139.790817,2024-02-08 13:08:04
1229,N3-20.SYFORME NAKANO-SAKAUE,2,3,5,35.701157,139.679617,2024-02-08 13:08:04
1230,D6-31.東急歌舞伎町タワー駐輪場,2,7,9,35.696207,139.700521,2024-02-08 13:08:04
1231,I1-30.ローソン 大井三丁目店,7,0,7,35.603327,139.729006,2024-02-08 13:08:04
1232,K1-151.PATH仲六郷,10,0,10,35.549465,139.711157,2024-02-08 13:08:04
1233,H1-198.Br Tower 有明 MID CROSS,3,4,7,35.63464,139.783445,2024-02-08 13:08:04
1234,H1-04.石と光の広場（国際展示場駅）,43,18,61,35.63363,139.79082,2024-02-08 13:08:04
1235,B4-24.ミュプレ月島,4,3,7,35.66288,139.78329,2024-02-08 13:08:04
1236,H1-199.ラ・ヴェール東陽町,1,9,10,35.664244,139.814506,2024-02-08 13:08:04
1237,H1-200.ヴェッセル木場南,0,14,14,35.662414,139.813333,2024-02-08 13:08:04
1238,F1-04.台東2丁目21,0,5,5,35.703465,139.780325,2024-02-08 13:08:04
1239,F3-03.ヴェルステージ南千住,0,5,5,35.728704,139.801867,2024-02-08 13:08:04
1240,J1-46.五本木西みどり街かど公園,0,6,6,35.632735,139.683899,2024-02-08 13:08:04
1241,K1-131.東急武蔵新田駅駐輪場,11,4,15,35.567146,139.693344,2024-02-08 13:08:04
1242,K1-152.アットホームスクエア前,0,8,8,35.543327,139.703223,2024-02-08 13:08:04
1243,B2-04.清水建設本社（都営地下鉄宝町駅 Ａ８出口）,14,1,15,35.676119,139.772895,2024-02-08 13:08:04
1244,H1-202.辰巳の森海浜公園,7,5,12,35.648107,139.813572,2024-02-08 13:08:04
1245,H1-201.ウエリスアーバン水天宮前2,1,5,6,35.678099,139.791831,2024-02-08 13:08:04
1246,I1-103.五反田ＪＰビルディング,3,0,3,35.622389,139.721552,2024-02-08 13:08:04
1247,L1-16.上祖師谷7丁目,13,1,14,35.65838,139.59231,2024-02-08 13:08:04
1248,O5-09.AppCruise中野,1,1,2,35.700772,139.66063,2024-02-08 13:08:04
1249,H1-203.セブン-イレブン江東木場３丁目店,0,10,10,35.67517,139.804087,2024-02-08 13:08:04
1250,H1-44.テプコ豊洲ビル,25,0,25,35.648726,139.790877,2024-02-08 13:08:04
1251,L1-17.赤堤3丁目,3,4,7,35.659787,139.636696,2024-02-08 13:08:04
1252,L1-18.上北沢1丁目,20,10,30,35.662796,139.626795,2024-02-08 13:08:04
1253,B3-16.明石町区民館,0,10,10,35.666001,139.778102,2024-02-08 13:08:04
1254,I1-104.源氏前ビル,5,0,5,35.603521,139.712345,2024-02-08 13:08:04
1255,J1-28.宮前公園,0,8,8,35.617699,139.664826,2024-02-08 13:08:04
1256,M6-18.セブン-イレブン渋谷本町3丁目店,0,3,3,35.686521,139.685017,2024-02-08 13:08:04
1257,O7-08.杉並区和泉2-3-17,0,4,4,35.67187,139.65474,2024-02-08 13:08:04
1258,T1-17.セブン-イレブン練馬田柄通店,6,1,7,35.75987,139.640474,2024-02-08 13:08:04
1259,H1-18.東京ビッグサイト,7,9,16,35.631192,139.79401,2024-02-08 13:08:04
1260,M3-01.渋谷マークシティ,11,2,13,35.657726,139.697802,2024-02-08 13:08:04
1261,H1-70.有明スポーツセンター,13,4,17,35.63403,139.784319,2024-02-08 13:08:04
1262,H1-41.深川北スポーツセンター,2,11,13,35.676475,139.804741,2024-02-08 13:08:04
1263,H1-55.深川江戸資料館,3,5,8,35.681089,139.800777,2024-02-08 13:08:04
1264,I1-61.五反田文化センター,3,4,7,35.622588,139.716159,2024-02-08 13:08:04
1265,N3-13.中部すこやか福祉センター,3,2,5,35.700052,139.673715,2024-02-08 13:08:04
1266,A4-02.東京サンケイビル,10,0,10,35.686847,139.765151,2024-02-08 13:08:04
1267,M3-09.ティップ.クロス TOKYO 渋谷,10,9,19,35.661475,139.699296,2024-02-08 13:08:04
1268,B3-02.サンクンガーデン,2,4,6,35.670336,139.771911,2024-02-08 13:08:04
1269,T2-10.勤労福祉会館,5,0,5,35.748153,139.58765,2024-02-08 13:08:04
1270,K1-133.東京港野鳥公園,13,0,13,35.584217,139.759232,2024-02-08 13:08:04
1271,K1-21.六郷特別出張所,0,8,8,35.55079,139.716517,2024-02-08 13:08:04
1272,H1-54.砂町文化センター,3,17,20,35.680052,139.831874,2024-02-08 13:08:04
1273,D1-08.新宿歴史博物館,3,1,4,35.689984,139.725261,2024-02-08 13:08:04
1274,E1-05.春日地下自転車駐車場,23,2,25,35.708291,139.753335,2024-02-08 13:08:04
1275,E1-15.播磨坂事業所,0,6,6,35.71724,139.74289,2024-02-08 13:08:04
1276,E5-02.不忍通りふれあい館,0,12,12,35.719356,139.764308,2024-02-08 13:08:04
1277,E4-02.向丘地域活動センター,8,5,13,35.717357,139.757817,2024-02-08 13:08:04
1278,C3-18.明治記念館,4,1,5,35.678509,139.721207,2024-02-08 13:08:04
1279,D5-05.中央図書館,13,2,15,35.705018,139.706841,2024-02-08 13:08:04
1280,E2-07.肥後細川庭園,10,3,13,35.713223,139.721699,2024-02-08 13:08:04
1281,A1-05.富士見出張所,0,4,4,35.699187,139.746348,2024-02-08 13:08:04
1282,E5-07.湯島三丁目児童遊園,3,5,8,35.707296,139.769393,2024-02-08 13:08:04
1283,D5-10.桜美林大学 新宿キャンパス,1,6,7,35.705154,139.697562,2024-02-08 13:08:04
1284,A3-08.神田明神（神田神社）,11,2,13,35.702029,139.768245,2024-02-08 13:08:04
1285,E2-14.永青文庫 ミュージアム,5,0,5,35.713145,139.723342,2024-02-08 13:08:04
1286,M5-17.小田急サザンタワー,8,1,9,35.6866,139.70014,2024-02-08 13:08:04
1287,K1-16.ファミリーマート 矢口二丁目店,3,3,6,35.563092,139.693548,2024-02-08 13:08:04
1288,H1-206.北砂5丁目団地2,0,9,9,35.683866,139.831809,2024-02-08 13:08:04
1289,G1-02.八広駅高架下,4,10,14,35.727495,139.828499,2024-02-08 13:08:04
1290,F4-02.Risingplace浅草四番館,0,4,4,35.717963,139.791025,2024-02-08 13:08:04
1291,H1-204.大島四丁目団地2,3,5,8,35.68832,139.828829,2024-02-08 13:08:04
1292,H1-205.大島四丁目団地3,5,5,10,35.688236,139.827711,2024-02-08 13:08:04
1293,H1-106.亀戸中央公園,12,7,19,35.699874,139.834263,2024-02-08 13:08:04
1294,E5-30.湯島3丁目15,0,12,12,35.705148,139.769314,2024-02-08 13:08:04
1295,B4-38.HARUMI FLAG SUN VILLAGE,0,24,24,35.650347,139.771785,2024-02-08 13:08:04
1296,B4-32.HARUMI FLAG SEA VILLAGE,0,10,10,35.648731,139.774995,2024-02-08 13:08:04
1297,B4-31.HARUMI FLAG PORT VILLAGE,0,19,19,35.650604,139.77724,2024-02-08 13:08:04
1298,B4-33.HARUMI FLAG SEA VILLAGE,0,15,15,35.649552,139.776369,2024-02-08 13:08:04
1299,B4-36.HARUMI FLAG SEA VILLAGE,2,10,12,35.650742,139.778097,2024-02-08 13:08:04
1300,B4-35.HARUMI FLAG SEA VILLAGE,1,11,12,35.650573,139.777908,2024-02-08 13:08:04
1301,B4-37.HARUMI FLAG SUN VILLAGE,0,17,17,35.649419,139.771447,2024-02-08 13:08:04
1302,B4-34.HARUMI FLAG SEA VILLAGE,2,10,12,35.649932,139.776958,2024-02-08 13:08:04
1303,B4-39.HARUMI FLAG SUN VILLAGE,0,18,18,35.650863,139.772549,2024-02-08 13:08:04
1304,B4-40.HARUMI FLAG SUN VILLAGE,0,15,15,35.651305,139.773379,2024-02-08 13:08:04
1305,B4-41.HARUMI FLAG SUN VILLAGE,0,16,16,35.649854,139.77334,2024-02-08 13:08:04
1306,B4-42.HARUMI FLAG SUN VILLAGE,0,11,11,35.649329,139.772656,2024-02-08 13:08:04
1307,B4-28.HARUMI FLAG PORT VILLAGE,4,7,11,35.651183,139.776119,2024-02-08 13:08:04
1308,B4-50.HARUMI FLAG PARK VILLAGE,1,8,9,35.648295,139.773973,2024-02-08 13:08:04
1309,B4-49.HARUMI FLAG PARK VILLAGE,3,13,16,35.648636,139.774251,2024-02-08 13:08:04
1310,B4-48.HARUMI FLAG PARK VILLAGE,0,5,5,35.649513,139.775287,2024-02-08 13:08:04
1311,B4-47.HARUMI FLAG PARK VILLAGE,2,4,6,35.649119,139.775138,2024-02-08 13:08:04
1312,B4-46.HARUMI FLAG PARK VILLAGE,0,26,26,35.649642,139.773859,2024-02-08 13:08:04
1313,B4-45.HARUMI FLAG PARK VILLAGE,0,25,25,35.649002,139.772764,2024-02-08 13:08:04
1314,B4-44.HARUMI FLAG PARK VILLAGE,3,10,13,35.648221,139.772666,2024-02-08 13:08:04
1315,B4-30.HARUMI FLAG PORT VILLAGE,1,10,11,35.651136,139.778218,2024-02-08 13:08:04
1316,B4-29.HARUMI FLAG PORT VILLAGE,0,18,18,35.651907,139.777391,2024-02-08 13:08:04
1317,L1-19.三軒茶屋1丁目駐輪場,1,3,4,35.639302,139.674744,2024-02-08 13:08:04
1318,O7-09.方南月極パーキング,8,10,18,35.678921,139.658289,2024-02-08 13:08:04
1319,O5-10.ローソン ツルハドラッグ杉並和田店,0,4,4,35.68942,139.662118,2024-02-08 13:08:04
1320,O2-04.西荻北1丁目,2,3,5,35.708082,139.607543,2024-02-08 13:08:04
1321,K1-75.三井不動産インダストリアルパーク羽田,6,4,10,35.556231,139.751408,2024-02-08 13:08:04
1322,F1-05.ホウエイコート秋葉原,0,2,2,35.703024,139.78052,2024-02-08 13:08:04
1323,C3-36.第35興和ビル,2,2,4,35.666349,139.741781,2024-02-08 13:08:04
1324,B4-53.晴海五丁目ターミナル,24,82,106,35.651627,139.773103,2024-02-08 13:08:04
1325,C5-44.ブランズタワー芝浦,9,0,9,35.643105,139.753039,2024-02-08 13:08:04
1326,A3-47.ホテルヴィラフォンテーヌ東京大手町,13,0,13,35.690602,139.766916,2024-02-08 13:08:04
1327,A1-20.菱和パレス九段,4,1,5,35.693021,139.740317,2024-02-08 13:08:04
0,E5-26.本郷4丁目,4,0,4,35.708596,139.758269,2024-02-08 18:52:03
1,A3-42.内神田3丁目,24,12,36,35.692599,139.770109,2024-02-08 18:52:03
2,T2-76.東中前の森緑地,3,2,5,35.748736,139.574839,2024-02-08 18:52:03
3,A2-20.神田スクエア,2,15,17,35.693408,139.762809,2024-02-08 18:52:03
4,K1-79.Tマークシティホテル東京大森,6,1,7,35.586993,139.736491,2024-02-08 18:52:03
5,K1-80.大森北6丁目,3,0,3,35.579849,139.731241,2024-02-08 18:52:03
6,H1-130.トヨタモビリティ東京 深川店,9,0,9,35.676643,139.816054,2024-02-08 18:52:03
7,H1-131.セブン-イレブン 江東佐賀2丁目店,2,3,5,35.679029,139.793535,2024-02-08 18:52:03
8,H1-132.セブン-イレブン 江東三好4丁目店,0,5,5,35.681418,139.809287,2024-02-08 18:52:03
9,A6-22.半蔵門PREX South,10,5,15,35.683433,139.740756,2024-02-08 18:52:03
10,I1-74.セブン-イレブン西五反田6丁目店,3,3,6,35.622403,139.71771,2024-02-08 18:52:03
11,G2-01.東京ソラマチ,3,4,7,35.709777,139.810189,2024-02-08 18:52:03
12,T2-59.平成公園,2,1,3,35.722917,139.587864,2024-02-08 18:52:03
13,I1-26.大崎西口公園,0,26,26,35.617475,139.729221,2024-02-08 18:52:03
14,I1-96.西五反田２丁目,6,4,10,35.627599,139.720463,2024-02-08 18:52:03
15,H1-172.サンヨーパシフィックマンション,0,4,4,35.668856,139.794069,2024-02-08 18:52:03
16,J1-56.青葉台四丁目街かど公園,2,2,4,35.654009,139.692727,2024-02-08 18:52:03
17,H1-173.森下駅前,40,0,40,35.687837,139.79654,2024-02-08 18:52:03
18,E3-01.大塚地域活動センター跡地,6,4,10,35.718656,139.734556,2024-02-08 18:52:03
19,E2-03.目白台運動公園,41,0,41,35.715556,139.721988,2024-02-08 18:52:03
20,T2-77.大泉なかよし緑地,4,0,4,35.759861,139.581682,2024-02-08 18:52:03
21,E2-01.江戸川橋Ｂ自転車駐車場,52,29,81,35.710381,139.732137,2024-02-08 18:52:03
22,E2-02.江戸川公園,15,4,19,35.710958,139.731165,2024-02-08 18:52:03
23,D7-14.大栄パーク西落合１丁目,6,0,6,35.720028,139.678936,2024-02-08 18:52:03
24,E1-07.礫川地域活動センター,9,0,9,35.712015,139.750284,2024-02-08 18:52:03
25,M6-05.七号通り公園,8,0,8,35.67917,139.67493,2024-02-08 18:52:03
26,H1-138.HW.HILLS新大橋,12,0,12,35.687416,139.795588,2024-02-08 18:52:03
27,B4-21.月島駅前第一駐輪場,15,19,34,35.663681,139.785651,2024-02-08 18:52:03
28,N2-03.野方1丁目,6,1,7,35.712179,139.65603,2024-02-08 18:52:03
29,C5-52.港南四丁目第3アパート駐車場,10,1,11,35.630109,139.747094,2024-02-08 18:52:03
30,E5-27.真正館駐車場,0,3,3,35.714875,139.76394,2024-02-08 18:52:03
31,C5-35.品川駅港南口,3,3,6,35.62822,139.741135,2024-02-08 18:52:03
32,N2-01.NTT野方ビル,3,2,5,35.710285,139.66173,2024-02-08 18:52:03
33,D6-27.新宿三井ビルディング二号館,1,8,9,35.686334,139.692881,2024-02-08 18:52:03
34,D1-10.曙橋駐輪場,12,4,16,35.691888,139.724365,2024-02-08 18:52:03
35,I1-39.MID POINT 目黒不動前,4,1,5,35.628116,139.713149,2024-02-08 18:52:03
36,E3-07.小日向1丁目,6,0,6,35.713388,139.737009,2024-02-08 18:52:03
37,C1-47.パークプレイス三田,9,0,9,35.641791,139.740734,2024-02-08 18:52:03
38,I1-38.ローソン 八潮三丁目店,4,41,45,35.594544,139.760423,2024-02-08 18:52:03
39,C2-24.Dash Living HigashiAzabu,6,0,6,35.655135,139.744449,2024-02-08 18:52:03
40,J1-04.菅刈公園,4,4,8,35.650351,139.692853,2024-02-08 18:52:03
41,O4-09.ローソン杉並本天沼一丁目店,1,2,3,35.712496,139.632778,2024-02-08 18:52:03
42,T3-29.平和台もものき緑地,1,2,3,35.755773,139.661913,2024-02-08 18:52:03
43,D2-10.市谷砂土原町3丁目,12,0,12,35.696242,139.735776,2024-02-08 18:52:03
44,C1-48.竹芝客船ターミナル,0,19,19,35.655139,139.762812,2024-02-08 18:52:03
45,B1-06.伊場仙ビル,5,0,5,35.687624,139.777125,2024-02-08 18:52:03
46,B2-01.鉄砲洲児童公園（西側）,6,0,6,35.67224,139.779348,2024-02-08 18:52:03
47,B1-04.産業会館,3,0,3,35.694164,139.787057,2024-02-08 18:52:03
48,B1-05.日本橋保健センター,0,10,10,35.687419,139.779053,2024-02-08 18:52:03
49,B2-05.ＮＴＴ東日本築地ビル,0,5,5,35.670674,139.775993,2024-02-08 18:52:03
50,B2-02.柳通り（東京スクエアガーデン前）,0,21,21,35.676393,139.768319,2024-02-08 18:52:03
51,B2-03.男女平等センター（ブーケ21）,4,7,11,35.673923,139.778671,2024-02-08 18:52:03
52,C2-13.麻布運動場,6,0,6,35.651718,139.728165,2024-02-08 18:52:03
53,D2-08.旧市ヶ谷商業高校,3,4,7,35.70074,139.731363,2024-02-08 18:52:03
54,C1-35.セブン-イレブン 三田駅北店,3,1,4,35.649032,139.750147,2024-02-08 18:52:03
55,B4-12.THE TOKYO TOWERS,3,1,4,35.655497,139.774556,2024-02-08 18:52:03
56,C5-21.セブン-イレブン 芝浦3丁目店,4,1,5,35.642399,139.746992,2024-02-08 18:52:03
57,H1-67.セブン-イレブン 江東亀戸9丁目店,9,5,14,35.69766,139.843408,2024-02-08 18:52:03
58,C2-15.住友不動産六本木グランドタワー,0,29,29,35.664367,139.737185,2024-02-08 18:52:03
59,C2-14.元麻布ヒルズ,7,3,10,35.653608,139.73138,2024-02-08 18:52:03
60,M6-14.ドコモショップ笹塚店,4,0,4,35.67323,139.66393,2024-02-08 18:52:03
61,N4-07.南台2丁目,12,0,12,35.68509,139.671102,2024-02-08 18:52:03
62,K1-68.ART FACTORY 城南島,0,13,13,35.580511,139.775957,2024-02-08 18:52:03
63,H1-178.北砂7丁目団地(第二),2,2,4,35.678031,139.837193,2024-02-08 18:52:03
64,H1-179.北砂7丁目団地(第三),7,4,11,35.678246,139.8366,2024-02-08 18:52:03
65,A1-17.雉子橋集積所,6,0,6,35.692605,139.755761,2024-02-08 18:52:03
66,H1-177.北砂7丁目団地(第一),1,4,5,35.678537,139.837391,2024-02-08 18:52:03
67,K1-95.城南島海浜公園,10,6,16,35.578259,139.783505,2024-02-08 18:52:03
68,B3-17.銀座6丁目-SQUARE,0,31,31,35.66711,139.76643,2024-02-08 18:52:03
69,J1-33.芳窪街かど公園,14,0,14,35.629861,139.666293,2024-02-08 18:52:03
70,N3-07.なかのZERO,5,0,5,35.70442,139.67141,2024-02-08 18:52:03
71,N4-04.弥生町5丁目,9,2,11,35.690897,139.668345,2024-02-08 18:52:03
72,A3-44.THE WAVES AKIHABARA,3,1,4,35.694679,139.779504,2024-02-08 18:52:03
73,K1-138.羽田エアポートガーデン,0,11,11,35.544534,139.763244,2024-02-08 18:52:03
74,C3-26.ホテルリブマックス赤坂,1,3,4,35.67011,139.733375,2024-02-08 18:52:03
75,C1-52.NTT三田ビル,6,0,6,35.652549,139.747789,2024-02-08 18:52:03
76,D1-07.Dash Living Shinjuku,2,2,4,35.689757,139.710091,2024-02-08 18:52:03
77,O4-07.ローソン成田西三丁目店,1,4,5,35.690311,139.62178,2024-02-08 18:52:03
78,H1-152.コンポジット亀戸ウエスト,0,6,6,35.699187,139.82429,2024-02-08 18:52:03
79,E1-13.エルアージュ小石川,8,1,9,35.71399,139.75137,2024-02-08 18:52:03
80,B4-22.リビオレゾン勝どきNEX,8,0,8,35.65554,139.77102,2024-02-08 18:52:03
81,H1-176.JMFビル東陽町02,0,9,9,35.667677,139.823552,2024-02-08 18:52:03
82,H1-102.ファミリーマート東砂七丁目店,6,1,7,35.672714,139.837914,2024-02-08 18:52:03
83,H1-101.ファミリーマート新木場一丁目店,0,13,13,35.642571,139.836766,2024-02-08 18:52:03
84,K1-67.京浜島防災広場,0,37,37,35.570508,139.764013,2024-02-08 18:52:03
85,K1-66.昭和島二丁目公園,0,17,17,35.575097,139.751446,2024-02-08 18:52:03
86,I1-80.リバーサイド品川港南ビル,9,1,10,35.622714,139.74471,2024-02-08 18:52:03
87,J1-10.NTTデータ駒場研修センター,11,0,11,35.655779,139.680948,2024-02-08 18:52:03
88,A2-17.竹橋ビル,0,11,11,35.692396,139.75639,2024-02-08 18:52:03
89,H1-91.亀戸駅北口第三自転車駐車場,16,1,17,35.696913,139.823911,2024-02-08 18:52:03
90,H1-92.亀戸駅東口第二自転車駐車場,5,9,14,35.69788,139.830559,2024-02-08 18:52:03
91,K1-59.京急梅屋敷第1駐車場,7,0,7,35.565768,139.727396,2024-02-08 18:52:03
92,K1-60.京急平和島第1駐車場,9,0,9,35.576336,139.733691,2024-02-08 18:52:03
93,I1-42.京急青横駐車場,3,0,3,35.611582,139.742528,2024-02-08 18:52:03
94,I1-43.京急南大井駐車場,8,1,9,35.594722,139.737101,2024-02-08 18:52:03
95,O7-05.ジーベック方南町,1,1,2,35.680849,139.65626,2024-02-08 18:52:03
96,H1-100.URアーバンライフ亀戸,26,3,29,35.697935,139.821855,2024-02-08 18:52:03
97,A6-10.紀尾井町ビル（西側）,5,7,12,35.682516,139.736494,2024-02-08 18:52:03
98,C3-02.赤坂地区総合支所,0,7,7,35.674788,139.731423,2024-02-08 18:52:03
99,C2-08.ファミリーマート西麻布霞町店,0,5,5,35.661673,139.721118,2024-02-08 18:52:03
100,A6-09.紀尾井町ビル（北側）,1,5,6,35.682902,139.736494,2024-02-08 18:52:03
101,H1-28.有明客船ターミナル,5,6,11,35.630063,139.792209,2024-02-08 18:52:03
102,B1-12.ファミリーマート堀留町二丁目店,0,16,16,35.687786,139.78205,2024-02-08 18:52:03
103,H1-26.青海客船ターミナル,0,28,28,35.619234,139.774485,2024-02-08 18:52:03
104,H1-27.パレットタウン乗船場,10,0,10,35.624467,139.781305,2024-02-08 18:52:03
105,O1-04.井草1-34,9,6,15,35.72758,139.62432,2024-02-08 18:52:03
106,C1-76.浜松町駅北口交通広場(ハマサイト前),10,7,17,35.656647,139.758301,2024-02-08 18:52:03
107,J1-52.駒沢一丁目公園前,9,0,9,35.629807,139.662398,2024-02-08 18:52:03
108,C1-75.虎ノ門PFビル,0,17,17,35.665466,139.748014,2024-02-08 18:52:03
109,B2-18.旭ビルディング,8,3,11,35.678291,139.78157,2024-02-08 18:52:03
110,N2-09.松山駐車場No.1,2,4,6,35.722991,139.673048,2024-02-08 18:52:03
111,I1-82.トミンハイム西五反田四丁目,4,2,6,35.627386,139.711182,2024-02-08 18:52:03
112,O4-03.ザ・ハウス,0,12,12,35.707035,139.633066,2024-02-08 18:52:03
113,O4-04.阿佐谷南3-43,13,3,16,35.704147,139.631955,2024-02-08 18:52:03
114,K1-83.北千束北児童公園,5,1,6,35.611085,139.68599,2024-02-08 18:52:03
115,I1-95.東京レールゲート EAST,0,17,17,35.584998,139.761055,2024-02-08 18:52:03
116,M5-19.グランリヴィエール代々木,1,5,6,35.68285,139.698528,2024-02-08 18:52:03
117,H1-192.ウエリスアーバン水天宮前,4,0,4,35.678296,139.791949,2024-02-08 18:52:03
118,N2-08.江古田区民活動センター,3,1,4,35.728893,139.670119,2024-02-08 18:52:03
119,D7-04.セブン-イレブン 新宿下落合3丁目店,3,1,4,35.722645,139.701982,2024-02-08 18:52:03
120,K1-82.西蒲田公園,5,2,7,35.561499,139.71123,2024-02-08 18:52:03
121,H1-68.芝浦工業大学附属中学高等学校,9,2,11,35.649274,139.792213,2024-02-08 18:52:03
122,K1-24.東糀谷防災公園,0,30,30,35.557074,139.74575,2024-02-08 18:52:03
123,H1-03.東雲駅,0,28,28,35.640736,139.804331,2024-02-08 18:52:03
124,K1-26.大森諏訪公園,1,2,3,35.574785,139.730762,2024-02-08 18:52:03
125,K1-25.鶴渡公園,4,0,4,35.56892,139.725082,2024-02-08 18:52:03
126,N3-10.エーエスホームズⅡ駐車場,2,5,7,35.702659,139.662563,2024-02-08 18:52:03
127,J1-37.中目黒公園,14,4,18,35.640398,139.704069,2024-02-08 18:52:03
128,A1-10.ヒューリック九段ビル,0,9,9,35.696449,139.750784,2024-02-08 18:52:03
129,K1-93.六間堀仲羽公園,0,4,4,35.548864,139.74484,2024-02-08 18:52:03
130,T2-53.上練馬公園,2,2,4,35.772863,139.626969,2024-02-08 18:52:03
131,M5-01.初台駅南口,7,5,12,35.680154,139.685937,2024-02-08 18:52:03
132,C1-60.専売ビル,9,5,14,35.647659,139.745055,2024-02-08 18:52:03
133,K1-85.大田区青少年交流センター ゆいっつ,0,10,10,35.583555,139.743381,2024-02-08 18:52:03
134,I1-64.株式会社ユアス ゆうパック取扱所：ポストのうしろ,3,5,8,35.622965,139.731014,2024-02-08 18:52:03
135,C4-09.ケーヨーデイツー三田店,6,0,6,35.646375,139.740061,2024-02-08 18:52:03
136,C1-61.環三浜松町駅南,16,22,38,35.653096,139.75739,2024-02-08 18:52:03
137,K1-84.佐伯山緑地,11,2,13,35.581698,139.71491,2024-02-08 18:52:03
138,C1-59.セレスティン芝三井ビルディング,11,2,13,35.650845,139.748346,2024-02-08 18:52:03
139,G2-07.レオーネ押上cube,4,0,4,35.706167,139.815955,2024-02-08 18:52:03
140,E1-06.文京シビックセンター,8,12,20,35.708265,139.751983,2024-02-08 18:52:03
141,D2-13.THE CENTER TOKYO,7,0,7,35.695646,139.725722,2024-02-08 18:52:03
142,E5-22.千駄木2丁目,3,2,5,35.724828,139.762583,2024-02-08 18:52:03
143,C4-07.品川プリンスホテル,7,3,10,35.628266,139.734171,2024-02-08 18:52:03
144,A3-43.unito CHIYODA,3,0,3,35.69474,139.77929,2024-02-08 18:52:03
145,C4-06.白金プラチナレジデンス,1,7,8,35.644134,139.723432,2024-02-08 18:52:03
146,I1-63.セブン-イレブン西五反田店,0,2,2,35.62765,139.719212,2024-02-08 18:52:03
147,H1-53.豊洲シビックセンター,10,7,17,35.653991,139.795513,2024-02-08 18:52:03
148,T3-16.練馬区役所東庁舎(第一),8,2,10,35.735428,139.652379,2024-02-08 18:52:03
149,T2-68.さくら原っぱ緑地,3,2,5,35.731372,139.619164,2024-02-08 18:52:03
150,T2-69.久保新田さくら公園,1,3,4,35.76525,139.575978,2024-02-08 18:52:03
151,H1-187.森下文化センター,5,0,5,35.685344,139.80234,2024-02-08 18:52:03
152,E4-04.セブン-イレブン 文京本駒込１丁目店,5,0,5,35.724707,139.750469,2024-02-08 18:52:03
153,M2-13.恵比寿プライムスクエアタワー南,8,0,8,35.649257,139.713272,2024-02-08 18:52:03
154,H1-48.セブン-イレブン 江東潮見２丁目店,0,11,11,35.658249,139.815775,2024-02-08 18:52:03
155,H1-51.豊洲交通広場　東,0,39,39,35.654958,139.795718,2024-02-08 18:52:03
156,H1-52.辰巳駅,0,73,73,35.646756,139.809295,2024-02-08 18:52:03
157,D7-01.下落合図書館,11,4,15,35.715894,139.698578,2024-02-08 18:52:03
158,H1-50.豊洲交通広場　北,0,68,68,35.655457,139.795161,2024-02-08 18:52:03
159,A6-14.MG市ヶ谷ビルディング,0,4,4,35.690861,139.736393,2024-02-08 18:52:03
160,T2-21.ファミリーマート 練馬大泉町一丁目店,2,2,4,35.768448,139.601679,2024-02-08 18:52:03
161,A6-15.東急番町ビル,2,3,5,35.688929,139.7358,2024-02-08 18:52:03
162,A1-18.東京区政会館別館(特別区研修所),3,2,5,35.696202,139.752351,2024-02-08 18:52:03
163,T3-18.練馬駅北,7,12,19,35.738585,139.653396,2024-02-08 18:52:03
164,C1-43.KDX浜松町プレイス,0,10,10,35.658169,139.752509,2024-02-08 18:52:03
165,C5-27.プレミア海岸ビル,16,4,20,35.648948,139.757895,2024-02-08 18:52:03
166,I1-29.ローソン 勝島一丁目店,0,10,10,35.599987,139.745195,2024-02-08 18:52:03
167,H1-72.ネクストサイト深川ビル,19,0,19,35.674578,139.797396,2024-02-08 18:52:03
168,T1-11.むつみ台,0,6,6,35.768528,139.639807,2024-02-08 18:52:03
169,H1-167.大島八丁目公園,11,0,11,35.688074,139.838932,2024-02-08 18:52:03
170,K1-36.セブン-イレブン 大田区南雪谷5丁目店,5,0,5,35.587815,139.691748,2024-02-08 18:52:03
171,L1-01.羽根木公園,6,7,13,35.66088,139.654546,2024-02-08 18:52:03
172,P1-02.雑司ヶ谷一丁目,8,0,8,35.721738,139.723103,2024-02-08 18:52:03
173,I1-66.南大井文化センター駐車場,6,0,6,35.596733,139.73804,2024-02-08 18:52:03
174,L1-05.NTT烏山ビル,0,3,3,35.669285,139.597931,2024-02-08 18:52:03
175,L1-04.下馬中央公園,4,1,5,35.63367,139.678139,2024-02-08 18:52:03
176,L1-03.世田谷城阯公園,2,4,6,35.645838,139.647799,2024-02-08 18:52:03
177,L1-02.若林公園,5,2,7,35.647075,139.654472,2024-02-08 18:52:03
178,T2-30.ファミリーマート 練馬東大泉四丁目店,2,2,4,35.750804,139.58243,2024-02-08 18:52:03
179,L1-07.NTT成城ビル,2,1,3,35.648021,139.606529,2024-02-08 18:52:03
180,L1-06.NTT瀬田ビル,0,11,11,35.618357,139.626191,2024-02-08 18:52:03
181,T3-13.平和台児童公園,2,2,4,35.757298,139.664139,2024-02-08 18:52:03
182,T2-38.ファミリーマート 練馬上石神井四丁目店,6,3,9,35.727195,139.590179,2024-02-08 18:52:03
183,B1-28.アイルイムーブル日本橋,8,1,9,35.684502,139.77906,2024-02-08 18:52:03
184,A2-28.NTTコミュニケーションズ一ツ橋ビル駐車場,4,4,8,35.6915,139.75685,2024-02-08 18:52:03
185,C3-32.乃木公園,0,3,3,35.667936,139.72745,2024-02-08 18:52:03
186,T3-14.わらべ児童遊園,2,2,4,35.759774,139.654529,2024-02-08 18:52:03
187,T2-52.田柄中央児童公園,4,1,5,35.762395,139.641522,2024-02-08 18:52:03
188,M4-06.THE SHARE 原宿,1,9,10,35.671823,139.708158,2024-02-08 18:52:03
189,K1-10.セブン‐イレブン 大田区西糀谷１丁目店,3,1,4,35.559647,139.730098,2024-02-08 18:52:03
190,K1-09.セブン‐イレブン 大田区西蒲田２丁目店,0,16,16,35.570763,139.705895,2024-02-08 18:52:03
191,H1-63.東京スイソミル,9,0,9,35.65637,139.811765,2024-02-08 18:52:03
192,B1-16.小網町児童遊園,5,1,6,35.683695,139.780043,2024-02-08 18:52:03
193,H1-61.Brilliaランニングスタジアムマギーズ東京前,0,13,13,35.648281,139.786112,2024-02-08 18:52:03
194,K1-08.セブン‐イレブン 大田区東蒲田キネマ通り店,5,0,5,35.562368,139.730143,2024-02-08 18:52:03
195,C1-34.城山ガーデン,0,12,12,35.664479,139.743731,2024-02-08 18:52:03
196,H1-62.扇橋一丁目公園南,17,2,19,35.683343,139.812161,2024-02-08 18:52:03
197,J1-23.清水池公園,23,0,23,35.623756,139.692517,2024-02-08 18:52:03
198,C5-18.パークタワー品川ベイワード,19,0,19,35.634529,139.748378,2024-02-08 18:52:03
199,E4-07.ファミリーマート 本駒込二丁目店,3,1,4,35.727279,139.74627,2024-02-08 18:52:03
200,C5-45.パークアクシス芝浦キャナル,9,0,9,35.644794,139.755688,2024-02-08 18:52:03
201,A2-02.西神田公園（北側）,4,5,9,35.698591,139.755113,2024-02-08 18:52:03
202,T2-49.善福寺公園テニスクラブ,5,4,9,35.719674,139.593696,2024-02-08 18:52:03
203,H1-193.ライフ豊洲店,27,0,27,35.651833,139.79962,2024-02-08 18:52:03
204,A2-01.神田駿河台下,18,35,53,35.695762,139.761585,2024-02-08 18:52:03
205,I1-51.京急鈴ヶ森駐車場,9,0,9,35.589573,139.735585,2024-02-08 18:52:03
206,T2-36.サントピア テニスパーク,7,3,10,35.75195,139.616028,2024-02-08 18:52:03
207,G4-13. Parking in 両国駅前第2,0,3,3,35.696492,139.791591,2024-02-08 18:52:03
208,K1-120.蒲田駅消費者生活センター横自転車駐車場 屋上部,6,0,6,35.560125,139.71569,2024-02-08 18:52:03
209,N3-18.藤和シティコープ新中野3,6,0,6,35.69942,139.673964,2024-02-08 18:52:03
210,K1-145.トヨタモビリティ東京馬込テクニカル研修センター,11,2,13,35.58209,139.701362,2024-02-08 18:52:03
211,K1-100.多摩川台公園,5,0,5,35.589794,139.666955,2024-02-08 18:52:03
212,C1-54.ニッセイ虎ノ門ビル,2,10,12,35.664344,139.746662,2024-02-08 18:52:03
213,I1-52.カスタリアタワー品川シーサイド,1,9,10,35.607557,139.746866,2024-02-08 18:52:03
214,I1-53.天王洲公園,0,7,7,35.620355,139.749339,2024-02-08 18:52:03
215,C2-18.ブランシェ東麻布,3,0,3,35.656769,139.743224,2024-02-08 18:52:03
216,A3-45.鍛冶町2丁目,6,13,19,35.691578,139.77138,2024-02-08 18:52:03
217,H1-87.パークアクシス木場キャナルウエスト,8,1,9,35.662514,139.803694,2024-02-08 18:52:03
218,D6-20.淀橋けやき橋公園,3,11,14,35.693544,139.685806,2024-02-08 18:52:03
219,A3-46.神田須田町2丁目,0,0,0,35.695457,139.772972,2024-02-08 18:52:03
220,B3-13.国立がん研究センター,7,3,10,35.664871,139.767188,2024-02-08 18:52:03
221,I1-35.シーフォートスクエア,2,15,17,35.622954,139.750593,2024-02-08 18:52:03
222,K1-55.カバヤビル,17,1,18,35.576275,139.713704,2024-02-08 18:52:03
223,C3-24.SHARE GREEN 南青山 西エントランス,0,8,8,35.668419,139.724676,2024-02-08 18:52:03
224,A5-06.APA HOTEL PRIDE〈国会議事堂前〉,10,0,10,35.674468,139.741328,2024-02-08 18:52:03
225,A6-17.東京ガーデンテラス紀尾井町（プリンス通り側）,5,7,12,35.680431,139.738203,2024-02-08 18:52:03
226,B4-07.勝どき駅地下駐輪場,53,9,62,35.658135,139.776131,2024-02-08 18:52:03
227,B4-08.東京ミッドベイ勝どき（西仲通り）,16,0,16,35.656449,139.771302,2024-02-08 18:52:03
228,B3-04.築地市場駅地下駐輪場,17,0,17,35.664265,139.767426,2024-02-08 18:52:03
229,C5-10.シーバンス,9,6,15,35.649959,139.756068,2024-02-08 18:52:03
230,H1-34.門前仲町駅,45,5,50,35.67391,139.796165,2024-02-08 18:52:03
231,C3-10.ファミリーマート特許庁前店,0,17,17,35.670364,139.744684,2024-02-08 18:52:03
232,A1-01.千代田区役所,6,2,8,35.693799,139.753281,2024-02-08 18:52:03
233,A1-03.東京区政会館（メトロA5出口）,5,2,7,35.701073,139.747525,2024-02-08 18:52:03
234,B3-06.朝日新聞東京本社,0,23,23,35.664457,139.767214,2024-02-08 18:52:03
235,A1-04.東京区政会館（西側駐輪場）,3,4,7,35.701347,139.746951,2024-02-08 18:52:03
236,T1-03.四季の香公園,4,1,5,35.760585,139.626284,2024-02-08 18:52:03
237,T1-04.春の風公園,3,0,3,35.75731,139.624922,2024-02-08 18:52:03
238,T1-05.夏の雲公園,4,1,5,35.753964,139.629116,2024-02-08 18:52:03
239,H1-194.セブン-イレブン江東北砂5丁目店,4,0,4,35.68268,139.8353,2024-02-08 18:52:03
240,O5-03.新高円寺地下自転車駐輪場,5,9,14,35.697265,139.649397,2024-02-08 18:52:03
241,O3-06.アミーズ荻窪,3,1,4,35.714616,139.625116,2024-02-08 18:52:03
242,T2-03.リヴィンオズ大泉店,6,2,8,35.752383,139.594855,2024-02-08 18:52:03
243,O6-06.上高井戸1丁目,1,6,7,35.673055,139.611293,2024-02-08 18:52:03
244,T2-05.石神井図書館,4,0,4,35.736076,139.599676,2024-02-08 18:52:03
245,O5-02.馬橋ハイツ,5,1,6,35.705686,139.642587,2024-02-08 18:52:03
246,N1-07.プランドール上鷺宮,2,5,7,35.733292,139.630369,2024-02-08 18:52:03
247,E1-18.アーバネックス小石川春日,8,0,8,35.709261,139.746374,2024-02-08 18:52:03
248,T3-03.新桜台駅自転車駐車場,5,2,7,35.740378,139.667502,2024-02-08 18:52:03
249,O3-05.Nちゃりパーク,7,16,23,35.70389,139.6185,2024-02-08 18:52:03
250,O5-01.朝霞ハイツ,9,2,11,35.71038,139.64519,2024-02-08 18:52:03
251,L1-11.アイムタウン上祖師谷,3,0,3,35.656849,139.594422,2024-02-08 18:52:03
252,L1-12.鈴木リースホーム駐車場,13,1,14,35.646648,139.633038,2024-02-08 18:52:03
253,L1-13.わびさびホステル,3,1,4,35.647393,139.667085,2024-02-08 18:52:03
254,G2-05.リアナスカイパーク押上,6,0,6,35.715733,139.815451,2024-02-08 18:52:03
255,T3-02.早宮第二自転車駐車場,6,5,11,35.756846,139.652154,2024-02-08 18:52:03
256,I1-37.ガーデンシティ品川御殿山,4,5,9,35.623466,139.734359,2024-02-08 18:52:03
257,T2-47.上石神井駅北第二自転車駐車場,4,6,10,35.726523,139.5905,2024-02-08 18:52:03
258,C1-51.環二新橋四丁目,11,0,11,35.663843,139.757697,2024-02-08 18:52:03
259,M6-07.笹塚東,20,0,20,35.675436,139.670594,2024-02-08 18:52:03
260,M3-10.ウノサワ東急ビル,6,2,8,35.647757,139.712981,2024-02-08 18:52:03
261,C2-26.一の橋公園,6,0,6,35.655367,139.738075,2024-02-08 18:52:03
262,H1-14.ホテルリブマックス東京潮見駅前,4,1,5,35.658351,139.818229,2024-02-08 18:52:03
263,D2-12.ヴィアイン飯田橋後楽園,4,4,8,35.705774,139.743366,2024-02-08 18:52:03
264,D3-08.ホテルリブマックス高田馬場駅前,6,2,8,35.712952,139.701356,2024-02-08 18:52:03
265,H1-103.清澄庭園,10,0,10,35.680948,139.796917,2024-02-08 18:52:03
266,H1-104.木場公園,13,1,14,35.676488,139.809616,2024-02-08 18:52:03
267,H1-105.猿江恩賜公園,7,2,9,35.692277,139.817491,2024-02-08 18:52:03
268,G4-07.ディアレイシャス両国,2,2,4,35.69955,139.803204,2024-02-08 18:52:03
269,T2-46.大泉郵便局バス停自転車駐車場,1,8,9,35.766491,139.587232,2024-02-08 18:52:03
270,I1-18.東品川公園,6,0,6,35.61379,139.746617,2024-02-08 18:52:03
271,J1-03.西郷山公園,4,2,6,35.650688,139.696696,2024-02-08 18:52:03
272,J1-02.駒場野公園,12,2,14,35.657718,139.681043,2024-02-08 18:52:03
273,D2-14.ローソン 神楽坂駅北店,1,4,5,35.704201,139.735815,2024-02-08 18:52:03
274,K1-65.下丸子3丁目,4,8,12,35.571711,139.685337,2024-02-08 18:52:03
275,T2-43.学園通り自転車駐車場,8,0,8,35.7547,139.5871,2024-02-08 18:52:03
276,I1-46.セブン-イレブン 品川東中延2丁目店,3,0,3,35.608721,139.714158,2024-02-08 18:52:03
277,T2-04.石神井公園駅南口,0,10,10,35.743354,139.606592,2024-02-08 18:52:03
278,J1-06.観音橋自転車置場,10,37,47,35.642251,139.69692,2024-02-08 18:52:03
279,J1-05.東山公園　北,0,8,8,35.64853,139.686309,2024-02-08 18:52:03
280,J1-45.プラウド中目黒,3,0,3,35.63767,139.7045,2024-02-08 18:52:03
281,H1-168.大島五丁目公園,13,0,13,35.68642,139.836151,2024-02-08 18:52:03
282,J1-47.本町みなみ街かど公園,11,7,18,35.61847,139.70019,2024-02-08 18:52:03
283,J1-48.グランドエクセル祐天寺,0,8,8,35.64372,139.68777,2024-02-08 18:52:03
284,K1-101.小池公園,2,3,5,35.599541,139.697962,2024-02-08 18:52:03
285,H1-171.LOGI’Q南砂町,8,1,9,35.672877,139.842339,2024-02-08 18:52:03
286,H1-153.三井リンクラボ新木場1,2,8,10,35.63851,139.823534,2024-02-08 18:52:03
287,H1-154.やぐら橋下,0,20,20,35.631132,139.792726,2024-02-08 18:52:03
288,D5-11.NTTコミュニケーションズ新宿ビル,0,11,11,35.699312,139.696468,2024-02-08 18:52:03
289,C5-31.ヒルトン東京お台場,0,10,10,35.626267,139.771438,2024-02-08 18:52:03
290,K1-78.城南鋳物団地協同組合,0,17,17,35.567562,139.766854,2024-02-08 18:52:03
291,I1-68.八潮公園第二,4,0,4,35.600003,139.754288,2024-02-08 18:52:03
292,I1-67.八潮公園第一,4,0,4,35.601149,139.754284,2024-02-08 18:52:03
293,H1-123.ダイワロイネットホテル東京有明,0,23,23,35.634316,139.793199,2024-02-08 18:52:03
294,J1-24.ボヌールREIWA,4,1,5,35.612389,139.676238,2024-02-08 18:52:03
295,B2-12.東京ダイヤビルディング（東側）,0,24,24,35.674835,139.785656,2024-02-08 18:52:03
296,J1-15.二の橋自転車置場2,16,0,16,35.614391,139.678396,2024-02-08 18:52:03
297,H1-77.ライフ東砂店,4,5,9,35.684641,139.844243,2024-02-08 18:52:03
298,D1-09.NTT四谷ビル,2,1,3,35.691188,139.712079,2024-02-08 18:52:03
299,E4-11.プライマル千石,0,4,4,35.727519,139.742815,2024-02-08 18:52:03
300,I1-23.東海橋防災船着場,12,0,12,35.616114,139.74033,2024-02-08 18:52:03
301,A4-12.東京ミッドタウン日比谷,0,20,20,35.674274,139.759111,2024-02-08 18:52:03
302,K1-46.池上駅前自転車駐車場,7,5,12,35.571478,139.702779,2024-02-08 18:52:03
303,I1-24.しながわ区民公園(中央口),13,1,14,35.593611,139.738056,2024-02-08 18:52:03
304,T2-13.セブン-イレブン 練馬石神井町8丁目店,3,1,4,35.750414,139.600011,2024-02-08 18:52:03
305,O3-04.アヴァンセ阿佐ヶ谷,1,1,2,35.712,139.62816,2024-02-08 18:52:03
306,B4-01.黎明橋公園（駐輪場）,8,3,11,35.656071,139.780068,2024-02-08 18:52:03
307,T2-32.セブン-イレブン 練馬東大泉NTTビル店,7,1,8,35.750761,139.594457,2024-02-08 18:52:03
308,K1-142.コーラル洗足池,10,0,10,35.604567,139.689096,2024-02-08 18:52:03
309,K1-28.鵜の木特別出張所,3,1,4,35.574886,139.685122,2024-02-08 18:52:03
310,T1-02.ホテルカデンツァ東京,3,9,12,35.755106,139.621675,2024-02-08 18:52:03
311,C2-16.ザ・ベルグレイヴィア麻布,3,0,3,35.657264,139.743821,2024-02-08 18:52:03
312,N3-11.上高田区民活動センター,5,0,5,35.711501,139.672761,2024-02-08 18:52:03
313,T3-30.北西大松公園,2,2,4,35.765979,139.64931,2024-02-08 18:52:03
314,D6-05.新宿中央公園（水の広場）,2,3,5,35.690474,139.690219,2024-02-08 18:52:03
315,D6-07.新宿フロントタワー,0,12,12,35.696387,139.689924,2024-02-08 18:52:03
316,T2-73.早実グラウンド記念公園,2,2,4,35.734615,139.576214,2024-02-08 18:52:03
317,O7-03.永福町西幸モータープール東,3,8,11,35.67156,139.64609,2024-02-08 18:52:03
318,D1-03.新左門児童遊園,4,0,4,35.684523,139.720519,2024-02-08 18:52:03
319,D1-04.四谷見附公園,12,3,15,35.683448,139.728425,2024-02-08 18:52:03
320,I1-54.天王洲オーシャンスクエア,0,53,53,35.622356,139.749468,2024-02-08 18:52:03
321,D6-01.新宿区役所本庁舎,26,24,50,35.693602,139.703229,2024-02-08 18:52:03
322,D6-02.新宿区役所第二分庁舎,30,5,35,35.693976,139.706134,2024-02-08 18:52:03
323,D6-03.新宿中央公園（ポケットパーク）,0,14,14,35.691559,139.690029,2024-02-08 18:52:03
324,D6-04.新宿中央公園（ちびっこ広場）,8,1,9,35.686649,139.689821,2024-02-08 18:52:03
325,A6-21.日本工営ビル,1,2,3,35.684584,139.734442,2024-02-08 18:52:03
326,I1-77.セブン-イレブン品川西中延1丁目店,4,0,4,35.612217,139.708164,2024-02-08 18:52:03
327,T1-01.光が丘駅前広場,0,12,12,35.759164,139.629466,2024-02-08 18:52:03
328,T2-37.上石神井2丁目,6,2,8,35.729615,139.59532,2024-02-08 18:52:03
329,I1-75.セブン-イレブン品川二葉4丁目店,4,1,5,35.603275,139.713428,2024-02-08 18:52:03
330,M5-13.セブン-イレブン初台店,3,0,3,35.675049,139.68444,2024-02-08 18:52:03
331,D6-24.ＮＴＴ東日本 本社ビル,9,3,12,35.683102,139.688852,2024-02-08 18:52:03
332,H1-134.豊洲ぐるり公園,1,21,22,35.643141,139.777821,2024-02-08 18:52:03
333,H1-133.北砂2丁目公園,15,3,18,35.679001,139.825809,2024-02-08 18:52:03
334,E3-08.サガラマンション,2,3,5,35.722833,139.734662,2024-02-08 18:52:03
335,O4-05.阿佐ヶ谷南1-30,1,1,2,35.700703,139.639985,2024-02-08 18:52:03
336,O5-06.EXAM高円寺南,5,0,5,35.70273,139.65864,2024-02-08 18:52:03
337,G2-03.押上１丁目２６-４,3,2,5,35.710323,139.815215,2024-02-08 18:52:03
338,K1-132.多摩川駅前自転車等駐車場,9,6,15,35.587232,139.669519,2024-02-08 18:52:03
339,C5-47.oak港南品川,19,6,25,35.62413,139.744831,2024-02-08 18:52:03
340,D3-15.カースルいずみ,6,6,12,35.711324,139.711976,2024-02-08 18:52:03
341,C5-15.セブン-イレブン 港区芝浦ふ頭店,3,0,3,35.640215,139.755971,2024-02-08 18:52:03
342,C5-14.セブン-イレブン 港区汐彩橋店,2,2,4,35.640481,139.753659,2024-02-08 18:52:03
343,D5-01.新宿コズミックセンター,0,8,8,35.705244,139.70841,2024-02-08 18:52:03
344,H1-45.夢の島競技場,19,1,20,35.648596,139.824936,2024-02-08 18:52:03
345,E1-01.後楽橋横,22,3,25,35.702746,139.752009,2024-02-08 18:52:03
346,B1-15.ロイヤルパークホテル,3,3,6,35.682332,139.78722,2024-02-08 18:52:03
347,C4-05.白金台駅自転車駐車場,13,2,15,35.638927,139.727083,2024-02-08 18:52:03
348,E1-02.東京ドーム（ミーツポート）,0,12,12,35.70311,139.754951,2024-02-08 18:52:03
349,M2-06.あいおいニッセイ同和損保恵比寿ビル,2,5,7,35.647237,139.71512,2024-02-08 18:52:03
350,J1-12.工大橋下流自転車置場,4,0,4,35.605828,139.680265,2024-02-08 18:52:03
351,C5-25.NEX-TEC芝浦,35,3,38,35.639571,139.755551,2024-02-08 18:52:03
352,H1-175.ダイアパレス大島駅前,2,0,2,35.689543,139.836394,2024-02-08 18:52:03
353,C1-65.東京ポートシティ竹芝,0,22,22,35.654757,139.761516,2024-02-08 18:52:03
354,O2-03.西荻北5-8-17,3,2,5,35.709712,139.601846,2024-02-08 18:52:03
355,B2-21.八重洲二丁目北地区広場,0,28,28,35.67942,139.77004,2024-02-08 18:52:03
356,I1-101.下神明駅前,25,0,25,35.60838,139.726587,2024-02-08 18:52:03
357,N2-04.野方2丁目,6,0,6,35.713018,139.656768,2024-02-08 18:52:03
358,N2-05.野方3丁目,9,4,13,35.717877,139.654732,2024-02-08 18:52:03
359,K1-88.大田久が原西郵便局,4,1,5,35.582756,139.6925,2024-02-08 18:52:03
360,C5-51.トミンタワー台場一番街,10,0,10,35.634627,139.77663,2024-02-08 18:52:03
361,C4-10.亀塚公園,6,4,10,35.642764,139.741174,2024-02-08 18:52:03
362,H1-190.福山通運 東京支店,12,7,19,35.664845,139.796643,2024-02-08 18:52:03
363,C1-80.浜松町262ビル,3,8,11,35.654289,139.75557,2024-02-08 18:52:03
364,B2-19.リエトコートアルクスタワー,6,3,9,35.670506,139.77854,2024-02-08 18:52:03
365,C1-79.髙松コンストラクショングループ 東京本社ビル,5,0,5,35.648765,139.753363,2024-02-08 18:52:03
366,C5-43.オアーゼ芝浦MJビル,9,0,9,35.644798,139.752697,2024-02-08 18:52:03
367,J1-44.五本木2丁目,3,5,8,35.634441,139.687186,2024-02-08 18:52:03
368,B2-17.アーバネックス八丁堀,0,3,3,35.67518,139.77364,2024-02-08 18:52:03
369,M6-16.パールマンション,2,0,2,35.67464,139.67876,2024-02-08 18:52:03
370,G4-06.ドムス・スタイル両国,7,1,8,35.700453,139.798978,2024-02-08 18:52:03
371,G2-04.ラ　ステュディオ押上,4,1,5,35.712157,139.815298,2024-02-08 18:52:03
372,T3-15.セブン-イレブン練馬北町8丁目店,2,4,6,35.768105,139.646049,2024-02-08 18:52:03
373,C1-77.芝公園,16,2,18,35.65513,139.749645,2024-02-08 18:52:03
374,I1-27.小関橋公園,0,27,27,35.620699,139.730904,2024-02-08 18:52:03
375,B3-01.中央区役所,0,14,14,35.670855,139.772052,2024-02-08 18:52:03
376,A6-08.二番町ガーデン,2,3,5,35.685489,139.734562,2024-02-08 18:52:03
377,B1-01.十思公園,0,9,9,35.691058,139.777915,2024-02-08 18:52:03
378,B4-02.月島特別出張所,24,4,28,35.662197,139.782719,2024-02-08 18:52:03
379,A4-05.大手町タワー,0,31,31,35.685938,139.764886,2024-02-08 18:52:03
380,H1-22.豊洲市場（7街区）,26,46,72,35.6447,139.784512,2024-02-08 18:52:03
381,A6-07.二番町センタービル,0,5,5,35.685966,139.736328,2024-02-08 18:52:03
382,A2-12.神保町三井ビルディング,0,14,14,35.694532,139.760695,2024-02-08 18:52:03
383,E2-06.oto no ha Cafe,1,1,2,35.713991,139.725665,2024-02-08 18:52:03
384,B4-10.リバーシティ,9,0,9,35.668795,139.784784,2024-02-08 18:52:03
385,B1-03.常盤公園（北側）,6,3,9,35.688405,139.770068,2024-02-08 18:52:03
386,C5-19.グランドメゾン田町,7,0,7,35.645537,139.754899,2024-02-08 18:52:03
387,K1-11.ファミリーマート かわだ多摩川２丁目店,0,3,3,35.558289,139.697403,2024-02-08 18:52:03
388,J1-43.アルコタワー・ホテル雅叙園東京,0,14,14,35.63237,139.712681,2024-02-08 18:52:03
389,N1-03.鷺宮南駐輪場,6,3,9,35.721827,139.635949,2024-02-08 18:52:03
390,N2-06.江古田1丁目B,6,0,6,35.72515,139.672614,2024-02-08 18:52:03
391,D7-12.プラウド高田馬場,2,3,5,35.715538,139.701683,2024-02-08 18:52:03
392,K1-118.久が原3丁目,2,7,9,35.580741,139.687152,2024-02-08 18:52:03
393,K1-125.池上駅南口第1,1,1,2,35.571866,139.703214,2024-02-08 18:52:03
394,K1-117.安詳寺,16,3,19,35.581798,139.695222,2024-02-08 18:52:03
395,I1-91.アクロス目黒タワー,4,6,10,35.634019,139.719749,2024-02-08 18:52:03
396,K1-126.池上駅南口第2,0,3,3,35.571815,139.702387,2024-02-08 18:52:03
397,C5-50.お台場レインボー公園,12,0,12,35.633133,139.777315,2024-02-08 18:52:03
398,T3-26.富士見ランド公園,0,8,8,35.73701,139.627244,2024-02-08 18:52:03
399,T1-15.つのの山緑地,3,1,4,35.765144,139.636606,2024-02-08 18:52:03
400,T1-16.ゆりの木通り南公園,3,1,4,35.767582,139.636304,2024-02-08 18:52:03
401,H1-185.UR大島六丁目団地(第二),3,0,3,35.690038,139.833252,2024-02-08 18:52:03
402,H1-186.セブン-イレブン亀戸昭和橋通り店,0,8,8,35.694804,139.831357,2024-02-08 18:52:03
403,K1-96.西馬込駅前自転車駐車場,0,14,14,35.586408,139.705425,2024-02-08 18:52:03
404,H1-184.UR大島六丁目団地(第一),5,0,5,35.689913,139.833279,2024-02-08 18:52:03
405,A6-25.麹町仮住宅,0,4,4,35.679192,139.74019,2024-02-08 18:52:03
406,C1-69.塩釜公園,0,5,5,35.662908,139.755014,2024-02-08 18:52:03
407,C1-68.桜田公園,26,3,29,35.665214,139.757008,2024-02-08 18:52:03
408,A2-14.興和一橋ビル,0,21,21,35.6927,139.759311,2024-02-08 18:52:03
409,C5-41.トヨタモビリティ東京 芝浦店,6,0,6,35.639644,139.745532,2024-02-08 18:52:03
410,T2-22.ファミリーマート 石神井台7丁目店,5,0,5,35.731909,139.579685,2024-02-08 18:52:03
411,A6-20.紀尾井町PREX,0,11,11,35.68369,139.736936,2024-02-08 18:52:03
412,C5-24.GLOBAL FRONT TOWER,15,0,15,35.647713,139.755534,2024-02-08 18:52:03
413,E5-09.文京区 男女平等センター,15,0,15,35.70861,139.75768,2024-02-08 18:52:03
414,K1-37.東京サーハウス前,5,16,21,35.563874,139.685011,2024-02-08 18:52:03
415,B4-15.リバーシティ　イーストタワーズ,6,2,8,35.669188,139.785301,2024-02-08 18:52:03
416,M6-08.Be Good 幡ヶ谷,11,0,11,35.682453,139.677687,2024-02-08 18:52:03
417,D5-09.ハウジングステージ新宿,14,1,15,35.702277,139.701214,2024-02-08 18:52:03
418,D6-21.新宿5丁目,5,2,7,35.691613,139.711233,2024-02-08 18:52:03
419,K1-39.東京モノレール 流通センター駅前,0,26,26,35.581752,139.748705,2024-02-08 18:52:03
420,K1-38.ネクストサイト蒲田ビル,8,1,9,35.558916,139.717253,2024-02-08 18:52:03
421,T3-17.練馬区役所東庁舎(第二),4,1,5,35.735585,139.652544,2024-02-08 18:52:03
422,H1-107.大島小松川公園,6,21,27,35.692641,139.846346,2024-02-08 18:52:03
423,B1-11.浜町川緑道,36,11,47,35.684158,139.787649,2024-02-08 18:52:03
424,A6-19.番町麹町ビルディング,11,0,11,35.685578,139.732078,2024-02-08 18:52:03
425,B3-12.築地場外市場,3,15,18,35.665254,139.769301,2024-02-08 18:52:03
426,I1-40.御殿山トラストタワー,20,6,26,35.622371,139.737457,2024-02-08 18:52:03
427,M5-08.古賀政男音楽博物館,1,0,1,35.668091,139.680243,2024-02-08 18:52:03
428,H1-90.富士倉庫運輸(株) FACE-1前,2,4,6,35.655102,139.805205,2024-02-08 18:52:03
429,A3-38.パークホームズ千代田淡路町,0,4,4,35.695163,139.769566,2024-02-08 18:52:03
430,D2-11.神楽坂アインスタワー,4,2,6,35.702833,139.739,2024-02-08 18:52:03
431,C2-04.飯倉いきいきプラザ,3,1,4,35.656991,139.740739,2024-02-08 18:52:03
432,B1-09.スマイルホテル日本橋三越前,10,7,17,35.686101,139.776089,2024-02-08 18:52:03
433,E5-15.文京千駄木の郷,10,1,11,35.726499,139.759884,2024-02-08 18:52:03
434,C2-05.ありすいきいきプラザ,11,2,13,35.651046,139.727745,2024-02-08 18:52:03
435,C5-06.品川シーズンテラス,6,13,19,35.632303,139.742393,2024-02-08 18:52:03
436,B1-10.箱崎川第二公園,0,20,20,35.680833,139.784267,2024-02-08 18:52:03
437,L1-15.ソフィア,0,3,3,35.663222,139.587803,2024-02-08 18:52:03
438,A3-12.秋葉原UDX北側駐輪場前,0,17,17,35.70111,139.772855,2024-02-08 18:52:03
439,A2-08.KDX御茶ノ水ビル,1,9,10,35.700568,139.76013,2024-02-08 18:52:03
440,A3-07.淡路公園,0,13,13,35.696942,139.767302,2024-02-08 18:52:03
441,A1-08.飯田橋サクラテラス（早稲田通り）,7,3,10,35.699132,139.74462,2024-02-08 18:52:03
442,A3-13.富士ソフトビル（駐車場入口横）,1,18,19,35.700486,139.774254,2024-02-08 18:52:03
443,A2-09.テラススクエア,0,8,8,35.6931,139.7599,2024-02-08 18:52:03
444,A6-11.東京ガーデンテラス紀尾井町,0,24,24,35.67962,139.7364,2024-02-08 18:52:03
445,K1-124.矢口2丁目,6,0,6,35.564161,139.695187,2024-02-08 18:52:03
446,N3-15.ライオンズマンション中野東,0,3,3,35.71046,139.6855,2024-02-08 18:52:03
447,M3-11.渋谷道玄坂東急ビル,9,1,10,35.65718,139.698687,2024-02-08 18:52:03
448,H1-180.シティコート大島,6,3,9,35.691954,139.836462,2024-02-08 18:52:03
449,B1-27.日本橋本町4丁目,20,8,28,35.68973,139.77598,2024-02-08 18:52:03
450,M3-22.森谷ビル,13,1,14,35.64514,139.71686,2024-02-08 18:52:03
451,N3-17.東中野3丁目,10,0,10,35.70862,139.680679,2024-02-08 18:52:03
452,N2-10.関根ビル,0,5,5,35.733432,139.671241,2024-02-08 18:52:03
453,T1-06.秋の陽公園,3,2,5,35.762326,139.635226,2024-02-08 18:52:03
454,N1-02.鷺宮東駐輪場,0,11,11,35.721556,139.640397,2024-02-08 18:52:03
455,K1-140.西馬込駅前自転車駐車場(奥),0,14,14,35.586382,139.705116,2024-02-08 18:52:03
456,H1-182.錦糸町プライムタワー,10,4,14,35.695695,139.820507,2024-02-08 18:52:03
457,E5-05.駒込地域活動センター,9,0,9,35.728644,139.752183,2024-02-08 18:52:03
458,M3-06.渋谷第一生命ビル,0,7,7,35.657556,139.704129,2024-02-08 18:52:03
459,T2-42.石神井公園駅北第二自転車駐車場,1,4,5,35.74553,139.608939,2024-02-08 18:52:03
460,K1-144.蒲田五丁目44番自転車駐車場,7,1,8,35.559809,139.716993,2024-02-08 18:52:03
461,M3-07.渋谷ファーストプレイス,4,6,10,35.65506,139.69384,2024-02-08 18:52:03
462,H1-74.タダノ教習センター,3,7,10,35.63848,139.832305,2024-02-08 18:52:03
463,H1-151.コスモリード錦糸町,7,2,9,35.701347,139.819973,2024-02-08 18:52:03
464,T2-23.セブン-イレブン 練馬南大泉5丁目店,6,0,6,35.750185,139.579216,2024-02-08 18:52:03
465,M4-13.J-cube,1,2,3,35.66616,139.70458,2024-02-08 18:52:03
466,T2-65.さくらの辻公園,4,1,5,35.734805,139.599906,2024-02-08 18:52:03
467,T2-24.セブン-イレブン 練馬インター店,0,23,23,35.754586,139.606409,2024-02-08 18:52:03
468,O5-05.モンテ・ベルテ,0,2,2,35.701454,139.650518,2024-02-08 18:52:03
469,J1-42.都立大学駅北口バス停前,7,2,9,35.618622,139.67596,2024-02-08 18:52:03
470,K1-97.トミンタワー多摩川二丁目,13,0,13,35.555561,139.704345,2024-02-08 18:52:03
471,D1-14.コモレ四谷,0,4,4,35.68752,139.72818,2024-02-08 18:52:03
472,K1-106.ファミリーマート上池台夫婦坂店,4,5,9,35.599329,139.703343,2024-02-08 18:52:03
473,J1-39.松見坂公園,3,4,7,35.655483,139.687325,2024-02-08 18:52:03
474,J1-40.西小山公園,6,2,8,35.616541,139.697369,2024-02-08 18:52:03
475,J1-38.林試の森公園 北,13,0,13,35.626355,139.700153,2024-02-08 18:52:03
476,I1-84.セブン-イレブン西品川2丁目店,0,4,4,35.613819,139.728418,2024-02-08 18:52:03
477,D6-26.セブン-イレブン新宿６丁目文化センター通り店,8,1,9,35.694951,139.708219,2024-02-08 18:52:03
478,T2-25.ファミリーマート 高野台二丁目店,0,5,5,35.746045,139.620087,2024-02-08 18:52:03
479,I1-85.GOODOFFICE品川,4,0,4,35.621081,139.741178,2024-02-08 18:52:03
480,K1-74.大田スタジアム,0,9,9,35.587423,139.753871,2024-02-08 18:52:03
481,C1-64.東京虎ノ門グローバルスクエア,0,5,5,35.669941,139.749261,2024-02-08 18:52:03
482,K1-72.ファミリーマート大森西四丁目店,4,0,4,35.573358,139.723105,2024-02-08 18:52:03
483,H1-118.ファミリーマート亀戸駅前店,5,6,11,35.69839,139.825484,2024-02-08 18:52:03
484,I1-62.天王洲Rim,3,1,4,35.622277,139.745638,2024-02-08 18:52:03
485,H1-40.深川東京モダン館,2,2,4,35.674076,139.795008,2024-02-08 18:52:03
486,H1-117.東京パークサイドビル,8,3,11,35.671225,139.808561,2024-02-08 18:52:03
487,J1-01.目黒区総合庁舎,7,2,9,35.640675,139.698088,2024-02-08 18:52:03
488,C5-16.品川インターシティ,0,25,25,35.626704,139.742174,2024-02-08 18:52:03
489,A1-12.北の丸スクエア,2,5,7,35.695515,139.750213,2024-02-08 18:52:03
490,H1-46.セブン-イレブン 江東枝川2丁目店,4,0,4,35.659287,139.807358,2024-02-08 18:52:03
491,A2-25.プラウド神田駿河台,3,10,13,35.698991,139.76091,2024-02-08 18:52:03
492,C5-49.プラウドタワー芝浦,9,0,9,35.638912,139.747422,2024-02-08 18:52:03
493,T3-25.北町みのり公園,2,2,4,35.767627,139.65243,2024-02-08 18:52:03
494,H1-75.ジオ深川住吉,11,0,11,35.684247,139.815638,2024-02-08 18:52:03
495,T1-09.ローソン練馬旭町一丁目店,4,1,5,35.765704,139.625178,2024-02-08 18:52:03
496,T2-26.ファミリーマート 大泉学園町四丁目店,5,0,5,35.767388,139.587625,2024-02-08 18:52:03
497,T2-27.ファミリーマート 大泉長久保通り店,4,1,5,35.773841,139.591456,2024-02-08 18:52:03
498,C3-19.明治記念館西,0,10,10,35.678179,139.720809,2024-02-08 18:52:03
499,I1-11.鮫洲入江広場,14,0,14,35.603984,139.744504,2024-02-08 18:52:03
500,I1-10.品川シーサイド公園第1,9,9,18,35.607717,139.749478,2024-02-08 18:52:03
501,I1-09.東品川海上公園第1,6,0,6,35.616633,139.748945,2024-02-08 18:52:03
502,D3-06.セブン-イレブン高田馬場3丁目中央店,3,3,6,35.713872,139.698301,2024-02-08 18:52:03
503,K1-40.大田文化の森,4,1,5,35.579649,139.720263,2024-02-08 18:52:03
504,C1-41.港区立エコプラザ,5,5,10,35.658709,139.757036,2024-02-08 18:52:03
505,I1-13.八潮北公園,0,13,13,35.613421,139.75375,2024-02-08 18:52:03
506,I1-12.しながわ区民公園（北側）,3,2,5,35.596091,139.740884,2024-02-08 18:52:03
507,T3-31.パークサイド関口,7,1,8,35.74097,139.63836,2024-02-08 18:52:03
508,H1-183.MFLP新木場1,0,6,6,35.643958,139.838358,2024-02-08 18:52:03
509,T2-33.ウインドヒルズ189,2,4,6,35.74642,139.581204,2024-02-08 18:52:03
510,T2-67.陽和病院,1,6,7,35.761211,139.603316,2024-02-08 18:52:03
511,H1-82.セブンｰイレブン 北砂3丁目明治通り店,0,6,6,35.683514,139.827081,2024-02-08 18:52:03
512,T2-60.武蔵関公園（第一）,9,0,9,35.724747,139.565817,2024-02-08 18:52:03
513,I1-48.NTT 東日本 関東病院(北側),7,2,9,35.632191,139.725002,2024-02-08 18:52:03
514,T2-58.立野公園,3,2,5,35.716776,139.577975,2024-02-08 18:52:03
515,I1-100.東急荏原中延駅駐輪場,7,0,7,35.610444,139.712333,2024-02-08 18:52:03
516,T2-56.大泉公園（第一）,3,1,4,35.77228,139.58325,2024-02-08 18:52:03
517,T2-55.大泉町もみじやま公園,1,2,3,35.767296,139.602321,2024-02-08 18:52:03
518,T2-54.土支田農業公園,4,5,9,35.760939,139.609264,2024-02-08 18:52:03
519,I1-44.大井三ツ又商店街入口,5,2,7,35.604606,139.734483,2024-02-08 18:52:03
520,T2-62.大泉井頭公園,6,4,10,35.746681,139.57754,2024-02-08 18:52:03
521,T2-61.武蔵関公園（第二）,4,0,4,35.727826,139.570056,2024-02-08 18:52:03
522,T3-09.学田公園,5,0,5,35.730428,139.648704,2024-02-08 18:52:03
523,K1-105.東糀谷二丁目児童公園,0,9,9,35.555702,139.740802,2024-02-08 18:52:03
524,T3-04.サンパレス平和台,8,4,12,35.759827,139.659121,2024-02-08 18:52:03
525,K1-104.六郷BASE,5,1,6,35.543573,139.714393,2024-02-08 18:52:03
526,M4-16.神宮前6丁目,2,0,2,35.668673,139.702816,2024-02-08 18:52:03
527,K1-69.京急平和島第2Bバイク駐輪場,4,0,4,35.585747,139.735242,2024-02-08 18:52:03
528,H1-155.メブクス豊洲,0,52,52,35.645726,139.784496,2024-02-08 18:52:03
529,C2-11.一の橋,25,28,53,35.654726,139.737491,2024-02-08 18:52:03
530,C4-11.ザ・パークハウス 三田ガーデン,13,0,13,35.64816,139.737991,2024-02-08 18:52:03
531,H1-161.昭文社制作本部ビル,5,1,6,35.684003,139.794983,2024-02-08 18:52:03
532,N2-07.新井区民活動センター,3,2,5,35.714292,139.663327,2024-02-08 18:52:03
533,K1-87.羽田イノベーションシティ,0,12,12,35.547061,139.756277,2024-02-08 18:52:03
534,N3-16.COURT 5,5,0,5,35.699743,139.664608,2024-02-08 18:52:03
535,C4-01.高輪地区総合支所(5F),5,6,11,35.641833,139.734519,2024-02-08 18:52:03
536,C5-48.セブンイレブン港区海岸三丁目店,5,3,8,35.636808,139.752517,2024-02-08 18:52:03
537,H1-42.江東区スポーツ会館,19,1,20,35.683961,139.821559,2024-02-08 18:52:03
538,B2-10.東京ダイヤビルディング（北側）,0,11,11,35.675702,139.785229,2024-02-08 18:52:03
539,H1-43.東京イースト21,1,8,9,35.675639,139.815255,2024-02-08 18:52:03
540,B3-20.歌舞伎座タワー駐輪場2F,0,8,8,35.670106,139.768041,2024-02-08 18:52:03
541,B3-21.歌舞伎座タワー駐輪場3F,0,10,10,35.6701,139.76801,2024-02-08 18:52:03
542,K1-139.プラットホステル京急 羽田ホーム,8,2,10,35.548104,139.748889,2024-02-08 18:52:03
543,J1-58.目黒女子会館前,3,1,4,35.629011,139.69716,2024-02-08 18:52:03
544,T2-18.ファミリーマート練馬西税務署前店,4,0,4,35.745505,139.580878,2024-02-08 18:52:03
545,C3-23.LIFORK 南青山 北エントランス,11,18,29,35.669916,139.725701,2024-02-08 18:52:03
546,C1-46.新虎通りCORE,6,11,17,35.665124,139.754054,2024-02-08 18:52:03
547,C1-45.浜松町クレアタワー,18,1,19,35.656324,139.755927,2024-02-08 18:52:03
548,K1-53.セブン-イレブン 田園調布郵便局前店,20,0,20,35.589309,139.678587,2024-02-08 18:52:03
549,K1-52.大田区総合体育館,7,0,7,35.564152,139.727422,2024-02-08 18:52:03
550,T1-12.ファミリーマート 高松六丁目店,0,4,4,35.756873,139.616612,2024-02-08 18:52:03
551,D7-07.ローソン 新宿西落合三丁目店,5,0,5,35.725171,139.675897,2024-02-08 18:52:03
552,A6-16.一番町第二TGビル,4,1,5,35.688351,139.744321,2024-02-08 18:52:03
553,C3-33.PASONA SQUARE,12,1,13,35.667462,139.716058,2024-02-08 18:52:03
554,A3-24.岩本町ほほえみプラザ,2,0,2,35.69441,139.777715,2024-02-08 18:52:03
555,H1-35.ヒューリック豊洲プライムスクエア,0,6,6,35.652376,139.797724,2024-02-08 18:52:03
556,C5-11.フェイバリッチタワー品川,16,0,16,35.631729,139.749767,2024-02-08 18:52:03
557,E2-13.デルックス文京神楽坂,5,0,5,35.70781,139.732227,2024-02-08 18:52:03
558,C5-01.こうなん星の公園,4,41,45,35.629697,139.742167,2024-02-08 18:52:03
559,C5-02.港南緑水公園,41,0,41,35.628955,139.750731,2024-02-08 18:52:03
560,A3-22.龍閑児童公園,8,0,8,35.693234,139.779702,2024-02-08 18:52:03
561,A3-21.神田ふれあい通り第３,12,1,13,35.695176,139.772832,2024-02-08 18:52:03
562,H1-30.江東区役所（北側）,0,11,11,35.67338,139.8164,2024-02-08 18:52:03
563,C1-17.港区役所,0,7,7,35.657866,139.751068,2024-02-08 18:52:03
564,H1-31.江東区役所（南側）,8,7,15,35.67214,139.8166,2024-02-08 18:52:03
565,C1-09.愛宕グリーンヒルズ,0,30,30,35.662051,139.748132,2024-02-08 18:52:03
566,D1-02.四谷特別出張所（新宿御苑大木戸門前）,11,6,17,35.687435,139.714169,2024-02-08 18:52:03
567,D1-01.花園西公園,2,3,5,35.690612,139.711631,2024-02-08 18:52:03
568,C1-04.虎ノ門ヒルズ,0,41,41,35.666527,139.748804,2024-02-08 18:52:03
569,C1-05.西新橋2丁目（新虎通り）,5,10,15,35.665593,139.752617,2024-02-08 18:52:03
570,C1-73.日比谷フォートタワー,0,13,13,35.669871,139.753147,2024-02-08 18:52:03
571,K1-102.上池台四丁目公園,5,2,7,35.595119,139.6996,2024-02-08 18:52:03
572,M2-01.恵比寿保健相談所（恵比寿社会教育館）,6,3,9,35.64524,139.71946,2024-02-08 18:52:03
573,I1-98.コーポ荏原,5,1,6,35.60411,139.709784,2024-02-08 18:52:03
574,C3-17.セブン-イレブン 港区溜池山王店,0,42,42,35.670308,139.743242,2024-02-08 18:52:03
575,T2-11.石神井松の風文化公園,3,0,3,35.739471,139.595578,2024-02-08 18:52:03
576,M2-03.サイカパーク恵比寿,3,11,14,35.646581,139.710613,2024-02-08 18:52:03
577,M2-02.アメリカ橋公園,0,10,10,35.643606,139.713099,2024-02-08 18:52:03
578,T2-50.North Ridge 吉祥寺,6,3,9,35.72305,139.579555,2024-02-08 18:52:03
579,J1-35.目黒川田道街かど公園,4,2,6,35.634574,139.710332,2024-02-08 18:52:03
580,H1-174.ジュネス(エントランス側),2,0,2,35.682712,139.823961,2024-02-08 18:52:03
581,M6-17.笹塚一丁目駐輪場,7,0,7,35.672922,139.668729,2024-02-08 18:52:03
582,C4-14.神応ほっとプラザ,7,3,10,35.643711,139.724753,2024-02-08 18:52:03
583,K1-107.馬込駅A2出口,6,3,9,35.596854,139.712139,2024-02-08 18:52:03
584,T3-11.ガラクタ公園,1,2,3,35.740321,139.631256,2024-02-08 18:52:03
585,T2-80.みその緑地,3,2,5,35.756825,139.590528,2024-02-08 18:52:03
586,T3-24.AZEST新桜台,5,2,7,35.743962,139.670315,2024-02-08 18:52:03
587,D4-07.新宿余丁町ビル,5,0,5,35.698512,139.716482,2024-02-08 18:52:03
588,T3-01.練馬春日町駅自転車駐車場,2,5,7,35.751438,139.641265,2024-02-08 18:52:03
589,H1-89.BUDDY スポーツアリーナ,0,26,26,35.637041,139.781088,2024-02-08 18:52:03
590,E5-14.上野広小路駅（湯島側）,5,8,13,35.707313,139.771857,2024-02-08 18:52:03
591,H1-109.Brillia ist 東雲キャナルコート東側,4,0,4,35.648008,139.803487,2024-02-08 18:52:03
592,H1-108.Brillia ist 東雲キャナルコート北側,7,0,7,35.648431,139.803125,2024-02-08 18:52:03
593,C1-53.ホテルリブマックス新橋,3,1,4,35.661149,139.754612,2024-02-08 18:52:03
594,D7-10.染の里 おちあい,6,0,6,35.715211,139.689788,2024-02-08 18:52:03
595,A1-15.富士見みらい館,3,0,3,35.697167,139.745629,2024-02-08 18:52:03
596,E4-15.千石4丁目,3,2,5,35.729153,139.741368,2024-02-08 18:52:03
597,H1-111.ファミリーマート木場六丁目店,1,1,2,35.66688,139.80779,2024-02-08 18:52:03
598,C5-36.お台場海浜公園駅,0,3,3,35.62974,139.778178,2024-02-08 18:52:03
599,H1-10.出会い橋,8,7,15,35.625029,139.777344,2024-02-08 18:52:03
600,H1-11.テレコムセンター駅,0,39,39,35.61813,139.778698,2024-02-08 18:52:03
601,H1-47.トピレックプラザ,0,16,16,35.672481,139.835877,2024-02-08 18:52:03
602,H1-13.アーバンドック ららぽーと豊洲,5,14,19,35.654067,139.792376,2024-02-08 18:52:03
603,T2-66.大泉学園町希望ヶ丘公園,0,4,4,35.778605,139.588883,2024-02-08 18:52:03
604,C5-37.台場駅,0,32,32,35.626388,139.772453,2024-02-08 18:52:03
605,H1-16.豊洲三丁目公園,0,77,77,35.657477,139.796629,2024-02-08 18:52:03
606,H1-17.東雲水辺公園,22,0,22,35.64704,139.80469,2024-02-08 18:52:03
607,C1-72.新田町ビル,10,0,10,35.646307,139.746428,2024-02-08 18:52:03
608,K1-98.鵜の木松山公園,4,3,7,35.577433,139.680752,2024-02-08 18:52:03
609,C1-71.芝商業高校前交差点,0,10,10,35.65583,139.759896,2024-02-08 18:52:03
610,H1-122.東砂スポーツセンター,4,7,11,35.679167,139.839746,2024-02-08 18:52:03
611,O6-05.コージーコート久我山,0,5,5,35.687531,139.60439,2024-02-08 18:52:03
612,T2-39.ローソン 練馬大泉町五丁目店,3,4,7,35.758929,139.597548,2024-02-08 18:52:03
613,J1-50.大岡山公園,3,1,4,35.609958,139.684087,2024-02-08 18:52:03
614,J1-51.池尻大橋駅東口駐輪場,1,4,5,35.650627,139.687228,2024-02-08 18:52:03
615,K1-99.東原くすのき公園,8,0,8,35.584086,139.67898,2024-02-08 18:52:03
616,N3-12.桃園区民活動センター,0,3,3,35.702414,139.667327,2024-02-08 18:52:03
617,H1-191.三井リンクラボ新木場2,0,25,25,35.644863,139.831107,2024-02-08 18:52:03
618,M5-09.代々木上原駅前,0,7,7,35.66865,139.679251,2024-02-08 18:52:03
619,O3-09.NTT井草ビル第3ポート,6,1,7,35.714151,139.61693,2024-02-08 18:52:03
620,T1-07.土支田一丁目（笹目通り）,5,5,10,35.765913,139.619285,2024-02-08 18:52:03
621,K1-22.矢口特別出張所,5,0,5,35.562324,139.690486,2024-02-08 18:52:03
622,T3-08.中新井川児童遊園,6,1,7,35.728268,139.649188,2024-02-08 18:52:03
623,H1-78.ローソン新木場一丁目店,8,6,14,35.645604,139.834941,2024-02-08 18:52:03
624,A6-13.番町会館,3,3,6,35.689131,139.733071,2024-02-08 18:52:03
625,H1-71.セブン-イレブン 江東東陽4丁目,3,0,3,35.670906,139.819386,2024-02-08 18:52:03
626,D2-09.セブン-イレブン 新宿岩戸町店,3,0,3,35.700993,139.736355,2024-02-08 18:52:03
627,I1-08.天王洲アイル第一水辺広場,1,30,31,35.622294,139.751644,2024-02-08 18:52:03
628,I1-07.しながわ水族館,16,0,16,35.590641,139.736354,2024-02-08 18:52:03
629,D3-09.西早稲田3丁目,4,0,4,35.712545,139.713319,2024-02-08 18:52:03
630,E1-16.小石川3丁目緑地,9,12,21,35.714338,139.746346,2024-02-08 18:52:03
631,C5-28.芝浦ルネサイトタワー,6,0,6,35.643683,139.7506,2024-02-08 18:52:03
632,I1-59.文庫の森第一,21,0,21,35.612357,139.721484,2024-02-08 18:52:03
633,I1-60.文庫の森第二,5,0,5,35.611368,139.720424,2024-02-08 18:52:03
634,C1-38.KDX西新橋ビル（西側）,5,0,5,35.66495,139.750459,2024-02-08 18:52:03
635,C1-37.KDX西新橋ビル（北側）,1,4,5,35.665218,139.750827,2024-02-08 18:52:03
636,T2-14.NPC24H東大泉第6パーキング,2,4,6,35.747807,139.593599,2024-02-08 18:52:03
637,C3-12.赤坂センタービルディング前（青山通り）,0,15,15,35.676732,139.733905,2024-02-08 18:52:03
638,H1-36.フジゴルフセンター,14,2,16,35.66605,139.806699,2024-02-08 18:52:03
639,C1-27.虎ノ門2丁目タワー,0,27,27,35.668547,139.747175,2024-02-08 18:52:03
640,C5-12.第2東運ビル,0,6,6,35.633742,139.748281,2024-02-08 18:52:03
641,D6-08.新宿イーストサイドスクエア,0,7,7,35.697158,139.707887,2024-02-08 18:52:03
642,A4-08.永代通り（大手町駅B2c出口前）,0,25,25,35.684349,139.766958,2024-02-08 18:52:03
643,H1-37.東雲駅（東京湾岸道路）,34,1,35,35.640618,139.802455,2024-02-08 18:52:03
644,C3-11.赤坂見附南,2,0,2,35.676566,139.737083,2024-02-08 18:52:03
645,M6-04.本町東べんてん橋公園,1,2,3,35.687126,139.680702,2024-02-08 18:52:03
646,I1-79.品川浦第二,13,0,13,35.621904,139.741429,2024-02-08 18:52:03
647,K1-81.コーナン本羽田萩中店,13,0,13,35.549568,139.731093,2024-02-08 18:52:03
648,D6-25.新宿駅東南口自転車駐輪場,30,3,33,35.689755,139.701323,2024-02-08 18:52:03
649,I1-78.セブン-イレブン西大井店,12,0,12,35.601431,139.718659,2024-02-08 18:52:03
650,H1-136.東砂一丁目公園,11,6,17,35.683542,139.839763,2024-02-08 18:52:03
651,A6-23.セブン-イレブン 千代田三番町店,0,1,1,35.689466,139.745316,2024-02-08 18:52:03
652,C5-34.五色橋ビル,1,0,1,35.636644,139.751798,2024-02-08 18:52:03
653,K1-41.郷土博物館,0,8,8,35.588644,139.710413,2024-02-08 18:52:03
654,G2-06.ディアレイシャス押上スカイヴィレッジ,3,2,5,35.71408,139.810588,2024-02-08 18:52:03
655,O3-11.ハイリビング関根,2,6,8,35.707877,139.618926,2024-02-08 18:52:03
656,O7-02.永福中央公園,6,0,6,35.67121,139.64145,2024-02-08 18:52:03
657,K1-29.萩中文化センター,3,6,9,35.55017,139.728146,2024-02-08 18:52:03
658,K1-30.テクノFRONT森ケ崎,0,8,8,35.567922,139.746181,2024-02-08 18:52:03
659,K1-130.COCOONひろば平和島,15,4,19,35.578728,139.735238,2024-02-08 18:52:03
660,H1-81.豊洲IHIビル（北側）,16,6,22,35.659829,139.793243,2024-02-08 18:52:03
661,E4-03.昭和小学校北側（不忍通り）,32,1,33,35.73166,139.748625,2024-02-08 18:52:03
662,C2-12.六本木ファーストビル,0,28,28,35.66249,139.741397,2024-02-08 18:52:03
663,D3-16.セジョリ江戸川橋,14,1,15,35.708734,139.730509,2024-02-08 18:52:03
664,A5-04.日比谷パークフロント前　日比谷公園南面向い歩道上,0,26,26,35.671514,139.753952,2024-02-08 18:52:03
665,C3-22.OMO3東京赤坂 by 星野リゾート,5,3,8,35.674929,139.736053,2024-02-08 18:52:03
666,B1-20.竜閑さくら橋際街角広場,0,34,34,35.688301,139.768958,2024-02-08 18:52:03
667,H1-83.ローソン江東東雲店,12,0,12,35.642165,139.800439,2024-02-08 18:52:03
668,H1-84.NTT東日本辰巳ビル,0,21,21,35.647091,139.817333,2024-02-08 18:52:03
669,C5-26.ピアシティ芝浦ビル,14,0,14,35.644155,139.756216,2024-02-08 18:52:03
670,T3-28.ほしぞら緑地,0,3,3,35.755137,139.661208,2024-02-08 18:52:03
671,I1-88.セブン-イレブン品川南大井3丁目店,0,3,3,35.58768,139.734515,2024-02-08 18:52:03
672,I1-87.セブン-イレブン西大井滝王子通り店,4,0,4,35.599774,139.723467,2024-02-08 18:52:03
673,G4-11.ホテルマイステイズ浅草,21,1,22,35.703972,139.797327,2024-02-08 18:52:03
674,C5-30.フェイム芝浦インターウェーブ,11,0,11,35.647872,139.75391,2024-02-08 18:52:03
675,M6-13.JICA東京,12,0,12,35.673409,139.675203,2024-02-08 18:52:03
676,A4-13.アーバンネット大手町ビル,0,13,13,35.68557,139.766929,2024-02-08 18:52:03
677,B4-27.リバーシティ西ブロック,17,1,18,35.670491,139.784447,2024-02-08 18:52:03
678,K1-143.大森北1丁目,58,2,60,35.584914,139.730504,2024-02-08 18:52:03
679,E5-24.本郷6丁目,5,0,5,35.712445,139.758157,2024-02-08 18:52:03
680,D2-17.genten市ヶ谷店,8,2,10,35.690657,139.73255,2024-02-08 18:52:03
681,A4-14.東京国際フォーラム（有楽町駅ガード側）,4,6,10,35.675739,139.763712,2024-02-08 18:52:03
682,A2-27.丸紅ビル,0,27,27,35.690958,139.759876,2024-02-08 18:52:03
683,K1-135.北千束2丁目,3,3,6,35.608633,139.693653,2024-02-08 18:52:03
684,A1-19.九段会館テラス,1,4,5,35.694065,139.751801,2024-02-08 18:52:03
685,K1-136.BIG FUN 平和島,0,12,12,35.585489,139.740194,2024-02-08 18:52:03
686,K1-137.京浜島つばさ公園,0,17,17,35.571578,139.770532,2024-02-08 18:52:03
687,D1-16.ルネ新宿御苑タワー,4,6,10,35.690155,139.713377,2024-02-08 18:52:03
688,G6-01.オーキッドレジデンス森下,7,0,7,35.692547,139.799231,2024-02-08 18:52:03
689,T2-63.三原台公園,2,5,7,35.751471,139.599835,2024-02-08 18:52:03
690,O4-01.阿佐ヶ谷南公園,2,0,2,35.70328,139.62981,2024-02-08 18:52:03
691,B4-11.ダンスキューブ勝どき,0,4,4,35.656565,139.775073,2024-02-08 18:52:03
692,D1-06.四谷第六小学校北,10,0,10,35.681754,139.715256,2024-02-08 18:52:03
693,T2-64.高野台中央公園,3,0,3,35.746768,139.613885,2024-02-08 18:52:03
694,H1-169.セブンイレブン江東亀戸7丁目東店,6,3,9,35.697157,139.839835,2024-02-08 18:52:03
695,H1-170.セブンイレブン江東亀戸7丁目南店,0,20,20,35.695937,139.838017,2024-02-08 18:52:03
696,B2-16.ホテルサードニクス東京,0,10,10,35.67684,139.77876,2024-02-08 18:52:03
697,I1-93.中央海浜公園前交差点（南側）,5,1,6,35.595498,139.750654,2024-02-08 18:52:03
698,I1-92.中央海浜公園前交差点（北側）,10,0,10,35.595873,139.75134,2024-02-08 18:52:03
699,B1-26.Dash Living Nihonbashi,3,3,6,35.68802,139.78112,2024-02-08 18:52:03
700,H1-158.東京国際交流館,10,2,12,35.621845,139.776833,2024-02-08 18:52:03
701,J1-32.緑が丘駅前高架下,4,3,7,35.606793,139.678372,2024-02-08 18:52:03
702,K1-90.ファミリーマート大田仲池上一丁目店,4,2,6,35.5873,139.701644,2024-02-08 18:52:03
703,K1-91.穴守稲荷神社,0,11,11,35.550027,139.74973,2024-02-08 18:52:03
704,C1-67.京阪神 虎ノ門ビル,0,36,36,35.669228,139.751668,2024-02-08 18:52:03
705,K1-89.ファミリーマート大田千鳥三丁目店,5,0,5,35.572086,139.68708,2024-02-08 18:52:03
706,I1-97.トミンハイム東品川三丁目第二,17,2,19,35.613387,139.749307,2024-02-08 18:52:03
707,T2-51.練馬区役所石神井庁舎,0,10,10,35.743772,139.603317,2024-02-08 18:52:03
708,T2-75.石神井台二丁目緑地,3,0,3,35.734684,139.593628,2024-02-08 18:52:03
709,E5-19.千駄木公園,7,0,7,35.728333,139.757629,2024-02-08 18:52:03
710,E5-18.団子坂上広場,8,2,10,35.724921,139.75903,2024-02-08 18:52:03
711,A5-07.富国生命ビル,0,15,15,35.670452,139.75557,2024-02-08 18:52:03
712,H1-156.つどい橋下,0,13,13,35.630791,139.787396,2024-02-08 18:52:03
713,H1-159.夢の大橋西,14,2,16,35.627599,139.782953,2024-02-08 18:52:03
714,H1-143.ダイバーシティ東京 プラザ,9,1,10,35.624619,139.776006,2024-02-08 18:52:03
715,I1-57.大井水神公園,26,50,76,35.589972,139.729368,2024-02-08 18:52:03
716,B2-15.KABUTO ONE,0,34,34,35.68168,139.77825,2024-02-08 18:52:03
717,K1-64.多摩川グリーンスクエア,5,5,10,35.545459,139.719489,2024-02-08 18:52:03
718,T2-57.大泉公園（第二）,5,1,6,35.771708,139.583551,2024-02-08 18:52:03
719,A4-06.大手町ファーストスクエア,0,36,36,35.686037,139.764472,2024-02-08 18:52:03
720,C1-50.NTT虎ノ門ビル,1,13,14,35.666075,139.748008,2024-02-08 18:52:03
721,C1-23.三田いきいきプラザ,8,1,9,35.648637,139.749834,2024-02-08 18:52:03
722,H1-29.スカイズタワー＆ガーデン,3,0,3,35.647618,139.792152,2024-02-08 18:52:03
723,C1-21.汐留ビルディング,1,9,10,35.657363,139.75918,2024-02-08 18:52:03
724,A3-16.地蔵橋東児童遊園,6,0,6,35.691069,139.775376,2024-02-08 18:52:03
725,A3-18.美倉橋北児童遊園,4,1,5,35.69703,139.779928,2024-02-08 18:52:03
726,A4-01.丸ビル（南側駐輪場）,4,9,13,35.680514,139.764002,2024-02-08 18:52:03
727,A3-11.練成公園,0,9,9,35.703735,139.770629,2024-02-08 18:52:03
728,A3-10.芳林公園（北側）,2,4,6,35.701978,139.7698,2024-02-08 18:52:03
729,A6-02.いきいきプラザ一番町（西側駐輪場）,6,1,7,35.687031,139.739327,2024-02-08 18:52:03
730,A6-01.東郷元帥記念公園（南側）,5,0,5,35.689879,139.740178,2024-02-08 18:52:03
731,A5-03.参議院第二別館（永田町駅2番出口）,6,9,15,35.677763,139.74271,2024-02-08 18:52:03
732,A4-03.東京国際フォーラム（メトロD5出口）,4,5,9,35.675843,139.763329,2024-02-08 18:52:03
733,K1-15.セブン‐イレブン 大田区西蒲田店,0,4,4,35.56694,139.716331,2024-02-08 18:52:03
734,K1-49.ローソン仲池上一丁目店,10,0,10,35.586585,139.698552,2024-02-08 18:52:03
735,A2-06.東光電気工事 別館（屋内駐輪場）,0,7,7,35.69919,139.75701,2024-02-08 18:52:03
736,M4-01.新宿タカシマヤ,6,0,6,35.68714,139.702775,2024-02-08 18:52:03
737,M4-03.NTTドコモ代々木ビル,6,4,10,35.684451,139.702884,2024-02-08 18:52:03
738,M3-03.代官山 T-SITE,0,9,9,35.649823,139.700139,2024-02-08 18:52:03
739,K1-14.大森地域庁舎,5,0,5,35.578239,139.723262,2024-02-08 18:52:03
740,C5-46.ウエリスアーバン品川タワー,12,0,12,35.630961,139.746875,2024-02-08 18:52:03
741,C4-13.コシダコネクトビル,7,7,14,35.637765,139.739128,2024-02-08 18:52:03
742,K1-127.第二石井ビル,0,9,9,35.559286,139.722611,2024-02-08 18:52:03
743,C1-74.札の辻スクエア,1,6,7,35.645155,139.744543,2024-02-08 18:52:03
744,H1-164.森下三丁目第三児童遊園,19,0,19,35.68546,139.80244,2024-02-08 18:52:03
745,C1-78.CIRCLES新橋,2,7,9,35.66646,139.752138,2024-02-08 18:52:03
746,C3-34.3rd MINAMI AOYAMA,0,5,5,35.668622,139.715957,2024-02-08 18:52:03
747,O4-06.杉並区役所本庁舎,1,4,5,35.699328,139.636343,2024-02-08 18:52:03
748,D3-14.コーシャハイム高田馬場,5,1,6,35.712413,139.70168,2024-02-08 18:52:03
749,D7-11.新宿清掃事務所,5,1,6,35.716359,139.704377,2024-02-08 18:52:03
750,D5-08.ウエリス新宿早稲田の森,3,5,8,35.704597,139.708397,2024-02-08 18:52:03
751,E2-12.水道2丁目,9,0,9,35.709147,139.739183,2024-02-08 18:52:03
752,M6-10.京王コインパーク幡ヶ谷,5,0,5,35.6772,139.678117,2024-02-08 18:52:03
753,E3-05.文京スポーツセンター,46,13,59,35.721045,139.735687,2024-02-08 18:52:03
754,J1-36.WJ Haus,3,1,4,35.629067,139.711779,2024-02-08 18:52:03
755,K1-51.テクノポートカマタ 第2,2,9,11,35.555808,139.722791,2024-02-08 18:52:03
756,D1-13.新宿御苑新宿門【西側】,0,21,21,35.688945,139.706536,2024-02-08 18:52:03
757,I1-31.セブン-イレブン 品川戸越5丁目店,6,0,6,35.608193,139.719139,2024-02-08 18:52:03
758,T3-27.貫井川緑地,1,3,4,35.738427,139.632251,2024-02-08 18:52:03
759,H1-147.大島四丁目団地,15,2,17,35.68744,139.827075,2024-02-08 18:52:03
760,O4-02.成宗さくら公園,2,0,2,35.69638,139.63482,2024-02-08 18:52:03
761,O1-01.上瀬戸公園,2,2,4,35.72077,139.6045,2024-02-08 18:52:03
762,T2-15.NPC24H大泉学園南口パーキング,1,8,9,35.748611,139.584251,2024-02-08 18:52:03
763,O3-03.桃井1丁目5番地,7,0,7,35.71013,139.61194,2024-02-08 18:52:03
764,H1-08.東京テレポート駅,41,2,43,35.627087,139.779779,2024-02-08 18:52:03
765,H1-05.相鉄グランドフレッサ 東京ベイ有明,5,9,14,35.632148,139.79017,2024-02-08 18:52:03
766,H1-06.武蔵野大学,0,22,22,35.630185,139.786618,2024-02-08 18:52:03
767,A4-15.TOKIWAブリッジ,0,30,30,35.686389,139.769237,2024-02-08 18:52:03
768,H1-160.花の広場,0,18,18,35.633908,139.793322,2024-02-08 18:52:03
769,H1-01.豊洲ＩＨＩビル前（晴海通り）,0,10,10,35.658911,139.792531,2024-02-08 18:52:03
770,H1-02.豊洲駅,0,64,64,35.654196,139.79626,2024-02-08 18:52:03
771,J1-19.NTT東日本自由が丘ビル,4,0,4,35.615098,139.675954,2024-02-08 18:52:03
772,C2-19.広尾駅,1,5,6,35.650732,139.72256,2024-02-08 18:52:03
773,H1-114.東京夢の島マリーナ,4,10,14,35.651987,139.830691,2024-02-08 18:52:03
774,K1-71.ファミリーマート大田大森南店,5,0,5,35.562769,139.74327,2024-02-08 18:52:03
775,J1-20.すずめのお宿緑地公園,8,0,8,35.617773,139.685351,2024-02-08 18:52:03
776,H1-115.東京夢の島マリーナ 第4駐車場,2,12,14,35.650235,139.835993,2024-02-08 18:52:03
777,M5-10.富ヶ谷2丁目,15,0,15,35.665961,139.686491,2024-02-08 18:52:03
778,J1-21.中央緑地公園,5,0,5,35.630694,139.690482,2024-02-08 18:52:03
779,H1-116.出会い橋高架下,26,23,49,35.625037,139.777646,2024-02-08 18:52:03
780,M3-12.渋谷南東急ビル,6,0,6,35.656228,139.706284,2024-02-08 18:52:03
781,T2-01.大泉学園駅北口,1,4,5,35.749918,139.58618,2024-02-08 18:52:03
782,K1-06.大森駅入新井自転車駐車場,3,3,6,35.585269,139.726279,2024-02-08 18:52:03
783,D6-06.新宿中央公園（エコギャラリー下）,0,18,18,35.691199,139.687966,2024-02-08 18:52:03
784,D6-14.新宿ファーストウエスト,6,8,14,35.689529,139.695995,2024-02-08 18:52:03
785,D6-15.住友不動産西新宿ビル,3,8,11,35.69465,139.695911,2024-02-08 18:52:03
786,H1-56.南砂三丁目緑地公園西,0,20,20,35.672361,139.829825,2024-02-08 18:52:03
787,T2-74.扇橋公園,3,2,5,35.731791,139.588844,2024-02-08 18:52:03
788,B2-20.SHビル,1,2,3,35.675398,139.779962,2024-02-08 18:52:03
789,I1-17.東品川海上公園第2,11,1,12,35.616364,139.749171,2024-02-08 18:52:03
790,I1-16.品川浦,14,0,14,35.6214,139.741958,2024-02-08 18:52:03
791,A4-11.二重橋前駅(メトロ4番出口),0,11,11,35.680753,139.762069,2024-02-08 18:52:03
792,H1-76.有明物流センター,11,8,19,35.638571,139.78829,2024-02-08 18:52:03
793,K1-43.北馬込わくわく公園,0,6,6,35.600707,139.703216,2024-02-08 18:52:03
794,K1-42.馬込西公園,10,3,13,35.58849,139.70376,2024-02-08 18:52:03
795,T1-08.セブン-イレブン 練馬高松6丁目店,0,4,4,35.756506,139.620347,2024-02-08 18:52:03
796,T2-17.ファミリーマート 練馬石神井町八丁目店,0,4,4,35.74755,139.597968,2024-02-08 18:52:03
797,K1-31.テクノWING,0,7,7,35.546252,139.731708,2024-02-08 18:52:03
798,K1-32.石川町文化センター,5,0,5,35.601958,139.682876,2024-02-08 18:52:03
799,I1-20.しおじ公園,20,0,20,35.59632,139.751279,2024-02-08 18:52:03
800,I1-19.品川シーサイド公園第2,0,8,8,35.607571,139.749108,2024-02-08 18:52:03
801,J1-29.カスタリア目黒鷹番,4,1,5,35.626121,139.688576,2024-02-08 18:52:03
802,H1-127.古石場川親水公園,17,6,23,35.669291,139.795364,2024-02-08 18:52:03
803,D4-05.カスタリア新宿7丁目,0,7,7,35.700732,139.711472,2024-02-08 18:52:03
804,I1-71.セブン-イレブン南大井浜川店,4,0,4,35.596483,139.7355,2024-02-08 18:52:03
805,I1-72.セブン-イレブン大井店,6,0,6,35.600081,139.728193,2024-02-08 18:52:03
806,T3-21.くまのやま緑地,4,1,5,35.747038,139.667965,2024-02-08 18:52:03
807,K1-110.萩中集会所裏,12,2,14,35.550479,139.739538,2024-02-08 18:52:03
808,O2-02.シエール荻窪,30,0,30,35.708265,139.612703,2024-02-08 18:52:03
809,H1-128.豊洲市場（5街区）,18,17,35,35.645162,139.785386,2024-02-08 18:52:03
810,N1-09.若宮レジデンス,2,3,5,35.716184,139.643905,2024-02-08 18:52:03
811,M6-12.LIVART SEASON 幡ヶ谷,5,2,7,35.683156,139.67338,2024-02-08 18:52:03
812,H1-142.東京ベイ潮見プリンスホテル,10,1,11,35.660632,139.817294,2024-02-08 18:52:03
813,G1-01.鐘ヶ淵駅南自転車駐車場,2,7,9,35.732291,139.82012,2024-02-08 18:52:03
814,M1-01.渋谷区役所,0,24,24,35.66362,139.69801,2024-02-08 18:52:03
815,I1-83.かもめ歩道橋,2,11,13,35.600161,139.749902,2024-02-08 18:52:03
816,N4-05.セブン-イレブン中野鍋横店,4,1,5,35.693815,139.668571,2024-02-08 18:52:03
817,D4-02.JICA市ヶ谷ビル（地球ひろば／研究所）,7,0,7,35.694927,139.731328,2024-02-08 18:52:03
818,T3-19.なかみや児童遊園,1,4,5,35.749388,139.651824,2024-02-08 18:52:03
819,N1-08.上鷺自転車保管場所,2,5,7,35.729056,139.627864,2024-02-08 18:52:03
820,O7-06.松木1丁目,2,11,13,35.686015,139.642784,2024-02-08 18:52:03
821,E4-16.ビレッジワン,7,0,7,35.723723,139.740143,2024-02-08 18:52:03
822,D1-15.フロンティア四谷,1,5,6,35.68768,139.71937,2024-02-08 18:52:03
823,K1-128.大森西3丁目,14,0,14,35.571975,139.732137,2024-02-08 18:52:03
824,N1-06.大和区民活動センター,4,1,5,35.713562,139.649075,2024-02-08 18:52:03
825,G4-01.両国ビューホテル1,2,5,7,35.69566,139.79214,2024-02-08 18:52:03
826,G4-02.両国ビューホテル2,6,2,8,35.69562,139.79206,2024-02-08 18:52:03
827,G4-05.両国駅西口臨時自転車駐車場,17,3,20,35.698588,139.792946,2024-02-08 18:52:03
828,G4-03.本所1-6-5,11,2,13,35.702525,139.796632,2024-02-08 18:52:03
829,G5-01.牡丹橋自転車駐車場,12,6,18,35.693059,139.813417,2024-02-08 18:52:03
830,G5-02.横川3-7-10,22,15,37,35.70378,139.814298,2024-02-08 18:52:03
831,G4-04.NTTドコモ墨田ビル,19,2,21,35.697898,139.795345,2024-02-08 18:52:03
832,G2-02.押上1-23-8,4,4,8,35.710111,139.81488,2024-02-08 18:52:03
833,C5-13.区立芝浦西運河沿緑地,40,0,40,35.638245,139.749754,2024-02-08 18:52:03
834,D6-12.東京ビジネスホテル,1,0,1,35.69342,139.710568,2024-02-08 18:52:03
835,D6-11.ホテルリステル新宿,1,2,3,35.693029,139.711327,2024-02-08 18:52:03
836,D6-10.ホテルサンライト新宿,0,5,5,35.694201,139.707047,2024-02-08 18:52:03
837,H1-39.辰巳駅東口自転車駐車場,17,8,25,35.645823,139.812178,2024-02-08 18:52:03
838,H1-38.辰巳駅西口自転車駐車場,89,0,89,35.646857,139.808912,2024-02-08 18:52:03
839,C2-10.元麻布三丁目,2,5,7,35.655865,139.730566,2024-02-08 18:52:03
840,C2-09.麻布地区総合支所,0,2,2,35.660614,139.734771,2024-02-08 18:52:03
841,M3-20.東急ステイ渋谷新南口,8,0,8,35.65494,139.70534,2024-02-08 18:52:03
842,I1-86.ファミリーマート二葉三丁目店,1,1,2,35.601694,139.719778,2024-02-08 18:52:03
843,A2-23.axle御茶ノ水,1,6,7,35.696126,139.763297,2024-02-08 18:52:03
844,C4-02.白金台いきいきプラザ,1,4,5,35.63756,139.724981,2024-02-08 18:52:03
845,N3-04.東中野駅地下駐輪場,0,23,23,35.707883,139.683284,2024-02-08 18:52:03
846,N3-05.中野坂上駅地下駐輪場,0,8,8,35.698068,139.682781,2024-02-08 18:52:03
847,N3-03.青桐公園,0,7,7,35.697024,139.677846,2024-02-08 18:52:03
848,N3-01.中野四季の森公園,0,15,15,35.708487,139.662135,2024-02-08 18:52:03
849,N4-01.本四公園,8,2,10,35.69693,139.672721,2024-02-08 18:52:03
850,N4-02.栄町公園,9,0,9,35.686474,139.671383,2024-02-08 18:52:03
851,K1-57.池上本門寺,5,1,6,35.579585,139.705377,2024-02-08 18:52:03
852,C1-49.汐留シティセンター,0,19,19,35.666213,139.760907,2024-02-08 18:52:03
853,C4-15.クロスレジデンス白金高輪,0,13,13,35.642771,139.733046,2024-02-08 18:52:03
854,K1-56.NTT馬込ビル,2,2,4,35.588106,139.718852,2024-02-08 18:52:03
855,J1-41.CASSIA目黒,7,2,9,35.631319,139.70237,2024-02-08 18:52:03
856,A2-22.専修大学,2,4,6,35.696147,139.753709,2024-02-08 18:52:03
857,T3-20.はやいち公園,1,3,4,35.75312,139.65661,2024-02-08 18:52:03
858,B3-19.本の森ちゅうおう,0,8,8,35.67363,139.77623,2024-02-08 18:52:03
859,K1-86.IMPREST STAY TOKYO 蒲田,21,1,22,35.556267,139.727246,2024-02-08 18:52:03
860,T3-23.氷川台二丁目緑地,3,1,4,35.756575,139.669689,2024-02-08 18:52:03
861,T3-22.氷川台三丁目ちびっこ公園,2,1,3,35.750547,139.66707,2024-02-08 18:52:03
862,B1-23.NANAEI日本橋,4,1,5,35.679616,139.784341,2024-02-08 18:52:03
863,B2-11.京橋エドグラン,0,33,33,35.677576,139.769822,2024-02-08 18:52:03
864,N1-05.大野ハイツ,3,2,5,35.7266,139.62948,2024-02-08 18:52:03
865,B2-09.茅場町一丁目平和ビル,0,11,11,35.680203,139.778679,2024-02-08 18:52:03
866,B2-08.共同ビル（茅場町交差点前）,4,6,10,35.681012,139.778569,2024-02-08 18:52:03
867,B2-07.東京証券会館（北側）,0,6,6,35.680864,139.779331,2024-02-08 18:52:03
868,O3-12.大宮前体育館,1,2,3,35.696567,139.610517,2024-02-08 18:52:03
869,B1-08.明治座,0,7,7,35.688038,139.786561,2024-02-08 18:52:03
870,B4-05.ドコモ・バイクシェア晴海ポート,0,56,56,35.654165,139.781568,2024-02-08 18:52:03
871,B4-04.ＫＤＸ晴海ビル,0,0,0,35.65443,139.77843,2024-02-08 18:52:03
872,B4-03.桜の散歩道（晴海トリトンスクエア前）,0,31,31,35.658665,139.782553,2024-02-08 18:52:03
873,E5-08.セブン-イレブン 文京動坂上店,5,0,5,35.727778,139.756296,2024-02-08 18:52:03
874,H1-65.ローソン南砂日曹橋店,15,0,15,35.669507,139.825553,2024-02-08 18:52:03
875,H1-66.中川船番所資料館,6,2,8,35.687732,139.846383,2024-02-08 18:52:03
876,K1-113.ファミリーマート大田上池台四丁目店,6,1,7,35.594658,139.700133,2024-02-08 18:52:03
877,H1-64.ローソン東雲駅前店,3,7,10,35.640228,139.804267,2024-02-08 18:52:03
878,E1-11.小石川運動場前,2,13,15,35.703914,139.747061,2024-02-08 18:52:03
879,T2-70.三ツ塚けやき緑地,2,2,4,35.720318,139.570762,2024-02-08 18:52:03
880,H1-137.住友不動産ショッピングシティ有明ガーデン,16,5,21,35.638985,139.793653,2024-02-08 18:52:03
881,C5-40.芝浦ふ頭駅前暫定自転車駐車場,0,6,6,35.64096,139.75754,2024-02-08 18:52:03
882,M3-21.渋谷ソラスタ,5,7,12,35.65618,139.69612,2024-02-08 18:52:03
883,D7-03.中井駅北,29,2,31,35.715645,139.687486,2024-02-08 18:52:03
884,K1-119.シーンズ大森パークサイド,4,0,4,35.58223,139.72763,2024-02-08 18:52:03
885,M6-15.cova Hatagaya,1,1,2,35.67741,139.67383,2024-02-08 18:52:03
886,C2-25.アパホテル＆リゾート＜六本木駅東＞,15,28,43,35.661783,139.737242,2024-02-08 18:52:03
887,D4-10.東新宿ポート(余丁町6番),6,0,6,35.696585,139.713081,2024-02-08 18:52:03
888,O1-02.井荻南地下自転車駐車場,5,9,14,35.72424,139.61431,2024-02-08 18:52:03
889,O1-03.LUCKY HOUSE,1,3,4,35.72489,139.62383,2024-02-08 18:52:03
890,D6-30.京王プラザホテル,4,3,7,35.6897,139.694823,2024-02-08 18:52:03
891,D6-29.都庁第二本庁舎前,11,3,14,35.688735,139.692249,2024-02-08 18:52:03
892,O3-02.アートメゾン荻窪,6,2,8,35.71355,139.6199,2024-02-08 18:52:03
893,J1-57.トレインチ自由が丘,4,1,5,35.606667,139.667324,2024-02-08 18:52:03
894,O2-01.サカエフラット荻窪,9,2,11,35.70535,139.61497,2024-02-08 18:52:03
895,O3-01.西田公園,7,0,7,35.69575,139.62065,2024-02-08 18:52:03
896,K1-47.NTT雪ヶ谷ビル,10,1,11,35.598601,139.684747,2024-02-08 18:52:03
897,O7-04.永福町西幸モータープール西,7,1,8,35.67161,139.64527,2024-02-08 18:52:03
898,K1-48.ファミリーマート大田上池台三丁目店,0,5,5,35.590934,139.696915,2024-02-08 18:52:03
899,K1-111.本羽田公園,6,1,7,35.546499,139.736761,2024-02-08 18:52:03
900,C1-58.ウォーターズ竹芝,0,10,10,35.655937,139.763251,2024-02-08 18:52:03
901,K1-109.萩中公園プール駐輪場,8,0,8,35.549323,139.737091,2024-02-08 18:52:03
902,K1-108.仲江名公園,4,0,4,35.557999,139.732564,2024-02-08 18:52:03
903,E1-17.小石川パークスクエア,10,0,10,35.713913,139.745416,2024-02-08 18:52:03
904,D6-23.アパホテル 東新宿 歌舞伎町西,0,2,2,35.697535,139.703633,2024-02-08 18:52:03
905,H1-98.洲崎川緑道公園,7,2,9,35.668705,139.810549,2024-02-08 18:52:03
906,H1-99.南砂三丁目公園,15,9,24,35.669695,139.831874,2024-02-08 18:52:03
907,H1-96.越中島公園,0,13,13,35.668757,139.790156,2024-02-08 18:52:03
908,H1-97.浜園公園,3,1,4,35.661852,139.802224,2024-02-08 18:52:03
909,H1-94.新木場一丁目緑地公園,1,8,9,35.64423,139.835823,2024-02-08 18:52:03
910,H1-95.若洲公園,5,19,24,35.619451,139.834429,2024-02-08 18:52:03
911,J1-09.ファミリーマート佐野久下目黒店,4,0,4,35.629252,139.712716,2024-02-08 18:52:03
912,H1-93.新木場一丁目公園,0,24,24,35.64143,139.835455,2024-02-08 18:52:03
913,I1-55.鈴ヶ森公園,6,1,7,35.593559,139.734704,2024-02-08 18:52:03
914,O6-04.柏の宮公園,1,4,5,35.67834,139.62711,2024-02-08 18:52:03
915,B4-14.Brillia ist Tower 勝どき,9,1,10,35.660526,139.776816,2024-02-08 18:52:03
916,D7-08.上落合3丁目,0,15,15,35.71115,139.68232,2024-02-08 18:52:03
917,H1-21.UR東雲キャナルコート,13,0,13,35.646041,139.804495,2024-02-08 18:52:03
918,H1-20.日本科学未来館,9,20,29,35.619377,139.777582,2024-02-08 18:52:03
919,H1-19.UR豊洲四丁目団地,18,1,19,35.653603,139.80144,2024-02-08 18:52:03
920,T2-45.風致地区バス停第三自転車駐車場,3,4,7,35.771068,139.586798,2024-02-08 18:52:03
921,H1-33.深川ギャザリア（ウエストスクエア）,6,4,10,35.66789,139.803,2024-02-08 18:52:03
922,H1-32.区営塩浜住宅前,4,18,22,35.664591,139.813954,2024-02-08 18:52:03
923,H1-23.KDX豊洲グランスクエア,1,13,14,35.648085,139.798986,2024-02-08 18:52:03
924,C2-22.飯倉公園,0,10,10,35.655649,139.74427,2024-02-08 18:52:03
925,I1-89.下神明駅自転車駐車場,5,0,5,35.608402,139.726118,2024-02-08 18:52:03
926,C5-39.お台場海浜公園東,12,0,12,35.631021,139.778109,2024-02-08 18:52:03
927,C5-38.お台場海浜公園乗船場,0,22,22,35.628743,139.773915,2024-02-08 18:52:03
928,O4-08.ローソン阿佐ヶ谷青梅街道店,0,5,5,35.703203,139.62804,2024-02-08 18:52:03
929,T2-72.高塚南緑地,5,1,6,35.733132,139.570311,2024-02-08 18:52:03
930,O6-03.みなみ荘,5,5,10,35.68073,139.62803,2024-02-08 18:52:03
931,K1-129.ローソン東糀谷一丁目店,0,6,6,35.557427,139.739126,2024-02-08 18:52:03
932,E1-03.東京ドーム（黄色いビル横）,4,4,8,35.70319,139.751888,2024-02-08 18:52:03
933,K1-23.大田区役所本庁舎前,8,1,9,35.561183,139.716339,2024-02-08 18:52:03
934,T2-78.北大泉くれはし公園,2,1,3,35.761474,139.592735,2024-02-08 18:52:03
935,J1-53.ボヌールAllamanda,2,3,5,35.612833,139.675047,2024-02-08 18:52:03
936,A3-39.トーシン東神田ビル,3,1,4,35.694834,139.780333,2024-02-08 18:52:03
937,O6-01.高井戸みどり公園,5,4,9,35.67912,139.61074,2024-02-08 18:52:03
938,T2-79.大泉学園町八丁目緑地,5,1,6,35.774457,139.596182,2024-02-08 18:52:03
939,O5-04.リヴィエール,18,2,20,35.70104,139.65839,2024-02-08 18:52:03
940,N3-08.中野区役所(西側),4,2,6,35.707968,139.663519,2024-02-08 18:52:03
941,I1-99.北品川２丁目,7,0,7,35.61663,139.74192,2024-02-08 18:52:03
942,P1-01.サンシャインシティ,2,4,6,35.728846,139.718577,2024-02-08 18:52:03
943,N3-14.ヴィラソンサ落合,0,6,6,35.713227,139.680966,2024-02-08 18:52:03
944,H1-49.セブン-イレブン 江東新砂３丁目店,0,19,19,35.667892,139.8311,2024-02-08 18:52:03
945,I1-06.大森貝塚遺跡庭園,7,2,9,35.593489,139.72967,2024-02-08 18:52:03
946,M2-12.恵比寿プライムスクエアタワー北,7,0,7,35.650541,139.713361,2024-02-08 18:52:03
947,H1-69.ファミリーマート 江東石島店,3,6,9,35.680474,139.812316,2024-02-08 18:52:03
948,B3-09.築地永谷コーポラス,8,5,13,35.66523,139.776313,2024-02-08 18:52:03
949,E4-10.白山四丁目第二児童遊園横,9,1,10,35.720349,139.746924,2024-02-08 18:52:03
950,I1-03.大井町駅中央口（西側）,5,2,7,35.605617,139.73472,2024-02-08 18:52:03
951,I1-04.大井町歩道橋,4,1,5,35.605146,139.734694,2024-02-08 18:52:03
952,I1-01.品川区役所 本庁舎前,11,0,11,35.609052,139.729825,2024-02-08 18:52:03
953,I1-02.品川区役所 第三庁舎前,9,0,9,35.608161,139.730048,2024-02-08 18:52:03
954,G4-08.ブオンサンヴァレンティーノ,6,0,6,35.691677,139.793857,2024-02-08 18:52:03
955,J1-13.洗足二丁目駐輪場,14,3,17,35.61061,139.693443,2024-02-08 18:52:03
956,J1-16.八雲橋自転車置場,5,0,5,35.617353,139.672256,2024-02-08 18:52:03
957,H1-189.MFLP新木場2,4,25,29,35.634453,139.824,2024-02-08 18:52:03
958,M6-09.ファミリーマート渋谷本町店,4,0,4,35.683756,139.684965,2024-02-08 18:52:03
959,H1-113.123+N東雲店,24,0,24,35.646366,139.801492,2024-02-08 18:52:03
960,J1-17.ファミリーマート原町二丁目店,5,1,6,35.613902,139.691476,2024-02-08 18:52:03
961,E5-21.動坂公園,9,2,11,35.73176,139.756669,2024-02-08 18:52:03
962,E5-20.本郷2丁目,0,7,7,35.704391,139.758575,2024-02-08 18:52:03
963,T2-48.武蔵関駅南第二自転車駐車場,2,2,4,35.726064,139.578015,2024-02-08 18:52:03
964,A6-26.相互半蔵門ビル,7,5,12,35.683378,139.743189,2024-02-08 18:52:03
965,J1-31.守屋図書館,18,2,20,35.634194,139.688833,2024-02-08 18:52:03
966,M3-19.渋谷キャスト,9,12,21,35.662146,139.702793,2024-02-08 18:52:03
967,N1-04.都立家政南駐輪場,2,5,7,35.721679,139.645265,2024-02-08 18:52:03
968,N2-02.江古田1丁目A,2,1,3,35.724988,139.672511,2024-02-08 18:52:03
969,C1-56.鈴与竹芝ビル,0,10,10,35.654873,139.762103,2024-02-08 18:52:03
970,D3-07.戸塚特別出張所,0,5,5,35.71429,139.70507,2024-02-08 18:52:03
971,G4-12.プレミアムキューブ両国,7,0,7,35.70103,139.803341,2024-02-08 18:52:03
972,A2-21.神田神保町3丁目,5,1,6,35.694578,139.754434,2024-02-08 18:52:03
973,B4-19.コーシャタワー佃,0,5,5,35.668044,139.785801,2024-02-08 18:52:03
974,I1-81.戸越6丁目,20,0,20,35.608127,139.717865,2024-02-08 18:52:03
975,A6-24.国立劇場,0,15,15,35.682218,139.743292,2024-02-08 18:52:03
976,E5-23.ビレッジ千駄木,3,3,6,35.722353,139.760966,2024-02-08 18:52:03
977,H1-119.榎戸材木店,0,22,22,35.638319,139.834741,2024-02-08 18:52:03
978,C5-29.Hi-NODE(ハイノード),8,0,8,35.651672,139.760549,2024-02-08 18:52:03
979,J1-22.NTTコミュニケーションズ唐ヶ崎ビル,4,0,4,35.627373,139.692044,2024-02-08 18:52:03
980,A2-18.猿楽町SSビル東,4,2,6,35.698654,139.759762,2024-02-08 18:52:03
981,A2-19.猿楽町SSビル西,0,5,5,35.698641,139.759306,2024-02-08 18:52:03
982,C1-55.アーバンネット内幸町ビル,12,8,20,35.669267,139.756018,2024-02-08 18:52:03
983,D4-06.グリーンフォート河田,6,0,6,35.697143,139.718739,2024-02-08 18:52:03
984,K1-134.東調布公園,10,0,10,35.588363,139.69042,2024-02-08 18:52:03
985,M5-18.Luxe初台,4,1,5,35.679182,139.68596,2024-02-08 18:52:03
986,D7-06.エムアイセミナーハウス,4,1,5,35.721064,139.677128,2024-02-08 18:52:03
987,A3-37.ポータル秋葉原,3,1,4,35.695737,139.78162,2024-02-08 18:52:03
988,M5-11.あおい通り,6,2,8,35.688154,139.698975,2024-02-08 18:52:03
989,E5-04.保健サービスセンター本郷支所,5,0,5,35.727046,139.760439,2024-02-08 18:52:03
990,E5-03.汐見地域活動センター（本郷図書館）,3,2,5,35.725538,139.76116,2024-02-08 18:52:03
991,E5-01.文京総合体育館,23,8,31,35.708121,139.763583,2024-02-08 18:52:03
992,E4-01.千石南自転車駐車場,18,6,24,35.72707,139.746112,2024-02-08 18:52:03
993,E3-03.大塚公園,10,11,21,35.724286,139.730954,2024-02-08 18:52:03
994,E3-02.教育の森公園,10,7,17,35.719345,139.736198,2024-02-08 18:52:03
995,I1-25.セブン-イレブン 品川旗の台2丁目店,3,0,3,35.607084,139.705007,2024-02-08 18:52:03
996,B1-21.日本橋二丁目街角広場,0,10,10,35.680861,139.774493,2024-02-08 18:52:03
997,C3-30.東京赤坂NKビル (ヴィアインプライム赤坂),1,8,9,35.672652,139.738908,2024-02-08 18:52:03
998,A3-36.クロックカフェ東神田,2,2,4,35.694943,139.782718,2024-02-08 18:52:03
999,E1-14.いきいき礫川,9,0,9,35.711147,139.747386,2024-02-08 18:52:03
1000,D4-09.トミンハイム仲之町,1,2,3,35.69617,139.722021,2024-02-08 18:52:03
1001,L1-08.NTT砧ビル,1,5,6,35.63534,139.601602,2024-02-08 18:52:03
1002,L1-09.コージーK・駒沢,1,2,3,35.632689,139.654804,2024-02-08 18:52:03
1003,L1-10.宮坂2-4-10,0,7,7,35.652913,139.644825,2024-02-08 18:52:03
1004,I1-22.ウィラ大井 (ショッピングモール),0,5,5,35.596579,139.745009,2024-02-08 18:52:03
1005,K1-76.グリーンベルト,8,2,10,35.585178,139.726339,2024-02-08 18:52:03
1006,H1-121.南砂5丁目,2,14,16,35.676603,139.829736,2024-02-08 18:52:03
1007,M3-02.文化総合センター大和田,1,3,4,35.65558,139.69966,2024-02-08 18:52:03
1008,D4-04.ジェノヴィア新宿早稲田グリーンヴェール,6,0,6,35.700033,139.71983,2024-02-08 18:52:03
1009,A3-20.神田ふれあい通り第２,0,2,2,35.695005,139.772747,2024-02-08 18:52:03
1010,H1-120.豊洲5丁目,17,1,18,35.650948,139.799711,2024-02-08 18:52:03
1011,C5-42.DHC芝浦2丁目ビル,7,0,7,35.644241,139.753834,2024-02-08 18:52:03
1012,I1-65.セブン-イレブン品川東大井1丁目店,7,0,7,35.605996,139.743037,2024-02-08 18:52:03
1013,M2-04.広尾東公園,6,0,6,35.653382,139.721059,2024-02-08 18:52:03
1014,M3-13.渋谷駅東口地下駐輪場,14,5,19,35.657682,139.703307,2024-02-08 18:52:03
1015,A3-19.神田ふれあい通り第１,3,2,5,35.694904,139.772712,2024-02-08 18:52:03
1016,O6-07.ローソン杉並宮前一丁目店,2,3,5,35.689639,139.613516,2024-02-08 18:52:03
1017,T3-10.貫井一丁目緑地,1,2,3,35.736378,139.632485,2024-02-08 18:52:03
1018,M2-05.日本赤十字医療センター,0,10,10,35.65519,139.718559,2024-02-08 18:52:03
1019,T2-20.パークサイド石神井,0,4,4,35.741769,139.591103,2024-02-08 18:52:03
1020,N4-06.ローソン中野本町新橋通り店,1,3,4,35.695819,139.674326,2024-02-08 18:52:03
1021,T3-07.徳殿公園,3,1,4,35.726728,139.65874,2024-02-08 18:52:03
1022,K1-35.セブン-イレブン 大田区西六郷2丁目店,5,0,5,35.549778,139.707362,2024-02-08 18:52:03
1023,A3-27.秋葉原駅中央口（ヨドバシカメラ前）,8,3,11,35.698986,139.774099,2024-02-08 18:52:03
1024,A3-28.秋葉原駅電気街口(西側交通広場),4,1,5,35.699173,139.772629,2024-02-08 18:52:03
1025,H1-57.新木場駅,43,23,66,35.64508,139.826456,2024-02-08 18:52:03
1026,H1-58.潮見駅,0,22,22,35.658703,139.817251,2024-02-08 18:52:03
1027,D7-02.セブン-イレブン 新宿中落合3丁目店,0,4,4,35.722202,139.691712,2024-02-08 18:52:03
1028,D2-06.飯田濠,6,9,15,35.70057,139.74301,2024-02-08 18:52:03
1029,C5-17.鈴与浜松町ビル,1,9,10,35.651103,139.759092,2024-02-08 18:52:03
1030,H1-59.LYURO 東京清澄,14,0,14,35.681316,139.792176,2024-02-08 18:52:03
1031,H1-60.荒川・砂町庭球場西,2,7,9,35.679678,139.844892,2024-02-08 18:52:03
1032,K1-44.中馬込貝塚公園,7,0,7,35.594795,139.704951,2024-02-08 18:52:03
1033,M6-11.京王サイクルパーク笹塚,5,0,5,35.674337,139.668801,2024-02-08 18:52:03
1034,J1-49.伊勢脇公園,2,0,2,35.638864,139.696568,2024-02-08 18:52:03
1035,K1-45.たぬき山公園,8,0,8,35.592801,139.715472,2024-02-08 18:52:03
1036,D2-01.あずさセンタービル,9,8,17,35.702286,139.741093,2024-02-08 18:52:03
1037,C1-02.西新橋1丁目（外堀通り）,1,4,5,35.668791,139.753582,2024-02-08 18:52:03
1038,O3-07.NTT井草ビル第1ポート,3,0,3,35.714044,139.61688,2024-02-08 18:52:03
1039,T2-41.ローソン 練馬東大泉五丁目店,2,2,4,35.74248,139.58715,2024-02-08 18:52:03
1040,H1-144.南砂住宅,7,0,7,35.674199,139.822018,2024-02-08 18:52:03
1041,C3-28.ヒューリックＪＰ赤坂ビル,0,10,10,35.672477,139.739743,2024-02-08 18:52:03
1042,H1-145.東雲都橋住宅,5,0,5,35.643131,139.797784,2024-02-08 18:52:03
1043,I1-58.品川区役所　第二庁舎前,18,0,18,35.609664,139.730006,2024-02-08 18:52:03
1044,K1-92.蒲田駅西口自転車駐車場,22,3,25,35.561101,139.715173,2024-02-08 18:52:03
1045,A2-24.水道橋駅西口前,3,3,6,35.702271,139.752619,2024-02-08 18:52:03
1046,K1-94.昭和島駅前,1,4,5,35.572188,139.749613,2024-02-08 18:52:03
1047,M5-15.新宿マインズタワー,12,8,20,35.686567,139.699355,2024-02-08 18:52:03
1048,D7-13.日本光電本社南側,15,0,15,35.71936,139.679083,2024-02-08 18:52:03
1049,N3-09.中野区役所(北側),0,4,4,35.708259,139.663829,2024-02-08 18:52:03
1050,H1-163.森下公園,4,0,4,35.68663,139.799529,2024-02-08 18:52:03
1051,B4-23.交通広場（豊海町）,1,9,10,35.653771,139.769295,2024-02-08 18:52:03
1052,D6-18.ヨドバシカメラ 新宿西口本店前,0,9,9,35.689689,139.698231,2024-02-08 18:52:03
1053,I1-47.NTT 東日本 関東病院(南側),0,9,9,35.630151,139.725215,2024-02-08 18:52:03
1054,H1-112.ファミリーマート江東塩浜二丁目店,0,2,2,35.66305,139.8087,2024-02-08 18:52:03
1055,K1-103.雪谷特別出張所,1,3,4,35.594515,139.691219,2024-02-08 18:52:03
1056,E5-17.Village藍染,5,0,5,35.720896,139.76422,2024-02-08 18:52:03
1057,I1-49.京急鮫洲バイク駐輪場,6,0,6,35.603815,139.741362,2024-02-08 18:52:03
1058,I1-50.京急立会川第2バイク駐輪場,5,3,8,35.599196,139.739158,2024-02-08 18:52:03
1059,E4-14.NTT東日本大塚ビル,1,4,5,35.726188,139.741375,2024-02-08 18:52:03
1060,M2-07.ファミリーマート恵比寿駅東店,3,4,7,35.6471,139.712818,2024-02-08 18:52:03
1061,M4-07.千駄ヶ谷駅前,2,3,5,35.68082,139.71188,2024-02-08 18:52:03
1062,O5-07.バーンホーフ キクチ,9,11,20,35.698169,139.655665,2024-02-08 18:52:03
1063,J1-11.コンフォリア目黒青葉台,0,8,8,35.649023,139.696086,2024-02-08 18:52:03
1064,L1-14.給田3丁目,0,12,12,35.664335,139.590114,2024-02-08 18:52:03
1065,B4-06.月島駅地下駐輪場,0,17,17,35.66291,139.782564,2024-02-08 18:52:03
1066,C5-09.グランパーク,20,1,21,35.643202,139.746244,2024-02-08 18:52:03
1067,C5-08.AQUACITY芝浦,7,3,10,35.637366,139.74844,2024-02-08 18:52:03
1068,C3-08.赤坂パークビルヂング,0,7,7,35.671792,139.733668,2024-02-08 18:52:03
1069,C3-07.新青山ビル,13,4,17,35.672659,139.725644,2024-02-08 18:52:03
1070,C3-06.ホテルアジア会館,1,8,9,35.67064,139.728166,2024-02-08 18:52:03
1071,C1-24.三田国際ビル,0,20,20,35.653159,139.744673,2024-02-08 18:52:03
1072,C5-07.港区立港南図書館,8,2,10,35.632842,139.7495,2024-02-08 18:52:03
1073,A3-04.秋葉原公園,18,2,20,35.697642,139.774867,2024-02-08 18:52:03
1074,A3-05.和泉公園（西側入口）,4,0,4,35.698817,139.778898,2024-02-08 18:52:03
1075,A3-02.絶滅メディア博物館（楓ビル）,0,8,8,35.689575,139.767848,2024-02-08 18:52:03
1076,O3-10.メゾンパークス,6,2,8,35.716265,139.618954,2024-02-08 18:52:03
1077,A2-05.神田橋公園,0,21,21,35.689665,139.764091,2024-02-08 18:52:03
1078,A3-01.神田児童公園（西側交番横）,0,7,7,35.692983,139.76773,2024-02-08 18:52:03
1079,A2-03.西神田公園（西側）,3,3,6,35.698338,139.754876,2024-02-08 18:52:03
1080,M6-03.十三号通り公園,6,0,6,35.675198,139.663587,2024-02-08 18:52:03
1081,M6-02.サイカパーク笹塚,7,0,7,35.673444,139.666553,2024-02-08 18:52:03
1082,H1-165.亀戸梅屋敷,0,8,8,35.701318,139.825916,2024-02-08 18:52:03
1083,H1-166.亀戸クロック,8,9,17,35.696574,139.82972,2024-02-08 18:52:03
1084,M5-02.あいおいニッセイ同和損保新宿ビル,0,6,6,35.684423,139.692262,2024-02-08 18:52:03
1085,M6-01.幡ヶ谷駅高架下第一,33,3,36,35.677175,139.676769,2024-02-08 18:52:03
1086,A5-02.山王パークタワー,0,18,18,35.673555,139.741293,2024-02-08 18:52:03
1087,K1-116.旧呑川緑地（大森東五丁目）,12,0,12,35.567176,139.742345,2024-02-08 18:52:03
1088,K1-115.旧呑川緑地（大森中三丁目）,4,0,4,35.565685,139.736195,2024-02-08 18:52:03
1089,K1-114.下丸子公園,8,0,8,35.568722,139.680736,2024-02-08 18:52:03
1090,T3-05.東武練馬駅南,3,7,10,35.767129,139.664365,2024-02-08 18:52:03
1091,T1-14.ファミリーマート 練馬高松五丁目北店,4,0,4,35.761038,139.623148,2024-02-08 18:52:03
1092,C3-29.高橋是清翁記念公園,5,1,6,35.674094,139.728895,2024-02-08 18:52:03
1093,K1-141.蒲田駅西口歩道,1,4,5,35.561291,139.715076,2024-02-08 18:52:03
1094,C3-35.ワールド北青山ビル,10,7,17,35.667069,139.713423,2024-02-08 18:52:03
1095,M5-03.代々木大山公園,16,0,16,35.671282,139.675307,2024-02-08 18:52:03
1096,E5-13.弥生二丁目,2,4,6,35.715592,139.76192,2024-02-08 18:52:03
1097,E5-12.NK本郷ビル,2,3,5,35.704475,139.763041,2024-02-08 18:52:03
1098,B3-18.銀座松竹スクエア,3,7,10,35.668395,139.769849,2024-02-08 18:52:03
1099,C1-44.三田Avanti,4,2,6,35.64115,139.741471,2024-02-08 18:52:03
1100,T2-31.ファミリーマート 石神井台二丁目店,0,6,6,35.739488,139.590273,2024-02-08 18:52:03
1101,H1-150.ホテルヴィラフォンテーヌ南側,9,0,9,35.636978,139.791858,2024-02-08 18:52:03
1102,H1-149.有明ガーデン 公園口,3,5,8,35.639132,139.793047,2024-02-08 18:52:03
1103,H1-148.大島七丁目団地,0,14,14,35.694104,139.840278,2024-02-08 18:52:03
1104,B4-26.東武ストア晴海三丁目店,10,3,13,35.654371,139.779545,2024-02-08 18:52:03
1105,J1-26.田向公園,6,1,7,35.623459,139.687128,2024-02-08 18:52:03
1106,J1-25.碑文谷公園,6,2,8,35.625081,139.682632,2024-02-08 18:52:03
1107,H1-195.東京アクアティクスセンター,7,12,19,35.65238,139.815613,2024-02-08 18:52:03
1108,T1-13.ファミリーマート 練馬土支田二丁目店,2,4,6,35.761613,139.61349,2024-02-08 18:52:03
1109,T2-34.ファミリーマート 練馬富士見台店,1,4,5,35.73969,139.62125,2024-02-08 18:52:03
1110,T2-35.ファミリーマート 石神井台六丁目店,1,3,4,35.738607,139.585331,2024-02-08 18:52:03
1111,C1-81.田町タワー,13,6,19,35.646534,139.748913,2024-02-08 18:52:03
1112,J1-07.目黒川船入場,12,3,15,35.641992,139.701588,2024-02-08 18:52:03
1113,J1-08.目黒区民センター公園,18,0,18,35.634533,139.708868,2024-02-08 18:52:03
1114,D4-01.市谷仲之町,6,0,6,35.695102,139.723345,2024-02-08 18:52:03
1115,M2-11.鉢山町,13,3,16,35.652151,139.698426,2024-02-08 18:52:03
1116,E4-08.ドコモ・バイクシェア向丘ポート,7,2,9,35.720546,139.756685,2024-02-08 18:52:03
1117,D4-03.市谷加賀町2丁目,4,0,4,35.695636,139.727882,2024-02-08 18:52:03
1118,N1-01.BeGood野方,1,8,9,35.719717,139.64785,2024-02-08 18:52:03
1119,C2-03.アークヒルズサウスタワー,0,18,18,35.666357,139.73923,2024-02-08 18:52:03
1120,C2-01.アークヒルズ（アーク森ビル）,0,20,20,35.667107,139.739565,2024-02-08 18:52:03
1121,C2-02.六本木ヒルズ,1,25,26,35.661158,139.728533,2024-02-08 18:52:03
1122,C5-03.港南公園C,2,24,26,35.624966,139.746657,2024-02-08 18:52:03
1123,C5-04.みなとパーク芝浦,9,0,9,35.646801,139.751208,2024-02-08 18:52:03
1124,C1-16.機械振興会館,4,2,6,35.659442,139.745549,2024-02-08 18:52:03
1125,C1-14.新橋プラザビル,5,0,5,35.664461,139.756082,2024-02-08 18:52:03
1126,H1-73.イシマビル,5,1,6,35.67386,139.79976,2024-02-08 18:52:03
1127,O7-01.西永福公園,5,0,5,35.67753,139.63667,2024-02-08 18:52:03
1128,O6-02.富士見ヶ丘南自転車駐車場,6,2,8,35.68296,139.60861,2024-02-08 18:52:03
1129,K1-50.テクノポートカマタ 第1,1,4,5,35.556199,139.721476,2024-02-08 18:52:03
1130,J1-14.二の橋自転車置場1,38,1,39,35.614856,139.678208,2024-02-08 18:52:03
1131,O3-08.NTT井草ビル第２ポート,3,0,3,35.714077,139.61694,2024-02-08 18:52:03
1132,H1-124.セブン-イレブン 江東海辺店,13,0,13,35.680636,139.817977,2024-02-08 18:52:03
1133,D1-11.三井ガーデンホテル神宮外苑の杜プレミア,0,5,5,35.679807,139.715931,2024-02-08 18:52:03
1134,O7-07.ハレ永福,3,5,8,35.678913,139.639944,2024-02-08 18:52:03
1135,C5-32.トレードピアお台場,0,20,20,35.627891,139.776896,2024-02-08 18:52:03
1136,B4-18.豊海センタービル,5,0,5,35.653531,139.769431,2024-02-08 18:52:03
1137,D5-04.西戸山公園野球場,5,2,7,35.707388,139.700204,2024-02-08 18:52:03
1138,D5-03.北新宿公園,0,6,6,35.702288,139.68862,2024-02-08 18:52:03
1139,D3-04.鶴巻南公園,7,0,7,35.706182,139.723394,2024-02-08 18:52:03
1140,D3-03.甘泉園公園,4,0,4,35.712431,139.715418,2024-02-08 18:52:03
1141,K1-03.池上会館,0,7,7,35.576593,139.706597,2024-02-08 18:52:03
1142,K1-02.平和の森公園,14,1,15,35.579049,139.739878,2024-02-08 18:52:03
1143,K1-01.大森海苔のふるさと館,0,16,16,35.57685,139.742496,2024-02-08 18:52:03
1144,D6-13.新宿中央公園（ジャブジャブ池下）,2,7,9,35.687652,139.689254,2024-02-08 18:52:03
1145,T2-28.ファミリーマート 南大泉六丁目店,4,1,5,35.752217,139.571095,2024-02-08 18:52:03
1146,K1-05.平和島公園プール,10,7,17,35.581832,139.741581,2024-02-08 18:52:03
1147,K1-04.京急蒲田駅東口,19,2,21,35.559483,139.724273,2024-02-08 18:52:03
1148,E2-10.音羽パークロード（北入口）,15,0,15,35.716586,139.727705,2024-02-08 18:52:03
1149,E2-11.音羽パークロード（キャッチボール場横）,18,0,18,35.715382,139.728533,2024-02-08 18:52:03
1150,I1-21.大井競馬場(正門前),10,0,10,35.593887,139.741204,2024-02-08 18:52:03
1151,J1-27.衾町公園,0,5,5,35.623215,139.668472,2024-02-08 18:52:03
1152,T2-44.中島橋自転車駐車場,5,2,7,35.75372,139.584332,2024-02-08 18:52:03
1153,B3-15.ACホテル・バイ・マリオット東京銀座,0,6,6,35.668845,139.765144,2024-02-08 18:52:03
1154,D5-07.百人町1丁目,4,3,7,35.699252,139.697606,2024-02-08 18:52:03
1155,C4-04.ショパン高輪,3,2,5,35.632128,139.732097,2024-02-08 18:52:03
1156,B1-18.セブン-イレブン 日本橋小網町店,0,2,2,35.681352,139.781436,2024-02-08 18:52:03
1157,T2-71.わかば児童公園,4,3,7,35.7211,139.574669,2024-02-08 18:52:03
1158,M3-15.co-ba ebisu,0,19,19,35.647076,139.703964,2024-02-08 18:52:03
1159,C2-20.三井ガーデンホテル六本木プレミア,0,8,8,35.66206,139.735501,2024-02-08 18:52:03
1160,I1-70.五反田リバーステーション,1,9,10,35.624566,139.72448,2024-02-08 18:52:03
1161,E5-25.ジェノヴィア東大前グリーンヴェール,11,0,11,35.711875,139.759306,2024-02-08 18:52:03
1162,D1-12.ジェノヴィア新宿御苑グリーンヴェール,3,2,5,35.689017,139.714755,2024-02-08 18:52:03
1163,C5-33.msb Tamachi,19,20,39,35.645682,139.748768,2024-02-08 18:52:03
1164,G4-09.SYFORME MORISHITA Ⅱ 1,1,0,1,35.690348,139.796133,2024-02-08 18:52:03
1165,G4-10.SYFORME MORISHITA Ⅱ 2,5,0,5,35.690307,139.796128,2024-02-08 18:52:03
1166,N3-19.上高田パーキング,2,10,12,35.715878,139.673669,2024-02-08 18:52:03
1167,F6-01.松坂屋上野店,1,5,6,35.707305,139.773657,2024-02-08 18:52:03
1168,F4-01.SYFORME ASAKUSA,3,1,4,35.718832,139.791133,2024-02-08 18:52:03
1169,F2-02.アップルパーク浅草6丁目第3,0,2,2,35.716062,139.799552,2024-02-08 18:52:03
1170,F2-01.松が谷2丁目2,3,17,20,35.71283,139.787754,2024-02-08 18:52:03
1171,F1-02.台東デザイナーズビレッジ,4,2,6,35.706023,139.783751,2024-02-08 18:52:03
1172,F2-03.台東区生涯学習センター,0,6,6,35.717497,139.790055,2024-02-08 18:52:03
1173,K1-146.南馬込6丁目25-11,3,0,3,35.582743,139.710561,2024-02-08 18:52:03
1174,F3-01.清川1丁目18-11,1,16,17,35.724944,139.801684,2024-02-08 18:52:03
1175,F1-03.新御徒町駅自転車駐車場,2,10,12,35.706793,139.782985,2024-02-08 18:52:03
1176,F3-02.台東区リバーサイドスポーツセンター,0,6,6,35.717571,139.804216,2024-02-08 18:52:03
1177,I1-45.セブン-イレブン品川西五反田3丁目店,0,6,6,35.62541,139.718135,2024-02-08 18:52:03
1178,H1-135.北砂5丁目団地,0,18,18,35.684218,139.832843,2024-02-08 18:52:03
1179,C3-16.赤坂ガーデンシティ,0,13,13,35.6738,139.731525,2024-02-08 18:52:03
1180,J1-34.田道広場公園,10,0,10,35.636269,139.709073,2024-02-08 18:52:03
1181,O5-08.セシオン杉並,1,2,3,35.69714,139.65432,2024-02-08 18:52:03
1182,A2-04.ちよだプラットフォームスクウェア,0,27,27,35.691456,139.762228,2024-02-08 18:52:03
1183,I1-102.J.GRAN Court 品川西大井 EAST,7,0,7,35.598244,139.722447,2024-02-08 18:52:03
1184,H1-196.フットサルクラブ東京東陽町,4,2,6,35.665288,139.824294,2024-02-08 18:52:03
1185,F2-04.コンフォラス浅草マンション,1,2,3,35.717241,139.801674,2024-02-08 18:52:03
1186,G5-03.京成リッチモンドホテル東京錦糸町,1,5,6,35.693492,139.81506,2024-02-08 18:52:03
1187,K1-27.六郷文化センター,4,0,4,35.544715,139.707623,2024-02-08 18:52:03
1188,K1-147.トヨタモビリティ東京GRGarage東京蒲田店,2,0,2,35.552741,139.718404,2024-02-08 18:52:03
1189,K1-148.トヨタモビリティ東京 蒲田仲六郷店,6,0,6,35.552068,139.71747,2024-02-08 18:52:03
1190,K1-150.トヨタモビリティ東京 池上第二京浜店,4,1,5,35.568019,139.696379,2024-02-08 18:52:03
1191,K1-149.トヨタモビリティ東京 大田店,6,0,6,35.59336,139.715879,2024-02-08 18:52:03
1192,C1-82.トヨタモビリティ東京 港三田店,4,0,4,35.647831,139.739048,2024-02-08 18:52:03
1193,D4-11.トヨタモビリティ東京 新宿明治通り南店,2,0,2,35.699835,139.70808,2024-02-08 18:52:03
1194,C3-31.赤坂一丁目,6,11,17,35.670239,139.744285,2024-02-08 18:52:03
1195,E1-04.礫川公園,25,14,39,35.707853,139.751518,2024-02-08 18:52:03
1196,M3-23.円山町7-1,2,7,9,35.658229,139.694885,2024-02-08 18:52:03
1197,M3-24.渋谷道玄坂２丁目駐輪場,1,17,18,35.66026,139.69684,2024-02-08 18:52:03
1198,T3-32.練馬北町1丁目,1,5,6,35.764452,139.666299,2024-02-08 18:52:03
1199,H1-197.セブン-イレブン江東南砂葛西橋通り店,2,2,4,35.675361,139.825034,2024-02-08 18:52:03
1200,T2-84.石神井町二丁目緑地,0,3,3,35.748395,139.605958,2024-02-08 18:52:03
1201,T2-82.梅の木児童遊園,2,3,5,35.737899,139.576584,2024-02-08 18:52:03
1202,T2-83.西大泉さくら緑地,5,3,8,35.760442,139.573145,2024-02-08 18:52:03
1203,D7-05.西落合図書館,7,0,7,35.725818,139.678976,2024-02-08 18:52:03
1204,D6-28.東急ステイ新宿,0,5,5,35.690899,139.706348,2024-02-08 18:52:03
1205,T2-85.泉新公園,3,1,4,35.7547,139.601497,2024-02-08 18:52:03
1206,T2-86.石神井町八丁目緑地,2,1,3,35.746956,139.600798,2024-02-08 18:52:03
1207,T2-87.南大泉四丁目児童遊園,1,3,4,35.745607,139.573947,2024-02-08 18:52:03
1208,T2-88.南大泉かたまち緑地,0,4,4,35.739633,139.570457,2024-02-08 18:52:03
1209,T2-89.南大泉三丁目児童遊園,0,3,3,35.742755,139.568335,2024-02-08 18:52:03
1210,E2-05.護国寺駅西自転車駐車場,23,0,23,35.719421,139.725584,2024-02-08 18:52:03
1211,J1-59.第44興和ビル,0,4,4,35.647704,139.693671,2024-02-08 18:52:03
1212,C1-15.東京タワー,9,7,16,35.65928,139.744767,2024-02-08 18:52:03
1213,C5-20.ローソン芝浦二丁目店,3,0,3,35.645254,139.754765,2024-02-08 18:52:03
1214,C2-27.有栖川宮記念公園第一,17,0,17,35.651382,139.724392,2024-02-08 18:52:03
1215,C2-28.有栖川宮記念公園第二,7,1,8,35.651129,139.726003,2024-02-08 18:52:03
1216,C2-29.狸穴公園,3,2,5,35.658204,139.738935,2024-02-08 18:52:03
1217,T2-90.南田中四丁目緑地,2,2,4,35.733195,139.612327,2024-02-08 18:52:03
1218,T2-91.石神井町四丁目緑地,4,1,5,35.745272,139.604579,2024-02-08 18:52:03
1219,A3-41.秋葉原ダイビル,2,5,7,35.698917,139.771856,2024-02-08 18:52:03
1220,J1-54.田道住区センター三田分室,2,2,4,35.638904,139.712518,2024-02-08 18:52:03
1221,H1-140.キャナルパレス住吉,11,5,16,35.689896,139.815116,2024-02-08 18:52:03
1222,C1-57.虎ノ門ツインビルディング,0,35,35,35.667259,139.745643,2024-02-08 18:52:03
1223,K1-54.ファミリーマート大田久が原五丁目店,3,2,5,35.579435,139.698552,2024-02-08 18:52:03
1224,B1-29.ASTILE日本橋浜町,8,0,8,35.685504,139.790817,2024-02-08 18:52:03
1225,N3-20.SYFORME NAKANO-SAKAUE,3,2,5,35.701157,139.679617,2024-02-08 18:52:03
1226,D6-31.東急歌舞伎町タワー駐輪場,4,5,9,35.696207,139.700521,2024-02-08 18:52:03
1227,I1-30.ローソン 大井三丁目店,7,0,7,35.603327,139.729006,2024-02-08 18:52:03
1228,K1-151.PATH仲六郷,10,0,10,35.549465,139.711157,2024-02-08 18:52:03
1229,H1-198.Br Tower 有明 MID CROSS,1,6,7,35.63464,139.783445,2024-02-08 18:52:03
1230,H1-04.石と光の広場（国際展示場駅）,41,22,63,35.63363,139.79082,2024-02-08 18:52:03
1231,B4-24.ミュプレ月島,4,3,7,35.66288,139.78329,2024-02-08 18:52:03
1232,H1-199.ラ・ヴェール東陽町,10,0,10,35.664244,139.814506,2024-02-08 18:52:03
1233,H1-200.ヴェッセル木場南,5,1,6,35.662414,139.813333,2024-02-08 18:52:03
1234,F1-04.台東2丁目21,3,2,5,35.703465,139.780325,2024-02-08 18:52:03
1235,F3-03.ヴェルステージ南千住,1,4,5,35.728704,139.801867,2024-02-08 18:52:03
1236,J1-46.五本木西みどり街かど公園,4,0,4,35.632735,139.683899,2024-02-08 18:52:03
1237,K1-131.東急武蔵新田駅駐輪場,10,5,15,35.567146,139.693344,2024-02-08 18:52:03
1238,K1-152.アットホームスクエア前,1,5,6,35.543327,139.703223,2024-02-08 18:52:03
1239,B2-04.清水建設本社（都営地下鉄宝町駅 Ａ８出口）,4,12,16,35.676119,139.772895,2024-02-08 18:52:03
1240,H1-202.辰巳の森海浜公園,7,5,12,35.648107,139.813572,2024-02-08 18:52:03
1241,H1-201.ウエリスアーバン水天宮前2,6,0,6,35.678099,139.791831,2024-02-08 18:52:03
1242,I1-103.五反田ＪＰビルディング,1,3,4,35.622389,139.721552,2024-02-08 18:52:03
1243,L1-16.上祖師谷7丁目,13,1,14,35.65838,139.59231,2024-02-08 18:52:03
1244,O5-09.AppCruise中野,1,1,2,35.700772,139.66063,2024-02-08 18:52:03
1245,H1-203.セブン-イレブン江東木場３丁目店,0,1,1,35.67517,139.804087,2024-02-08 18:52:03
1246,H1-44.テプコ豊洲ビル,25,0,25,35.648726,139.790877,2024-02-08 18:52:03
1247,L1-17.赤堤3丁目,2,5,7,35.659787,139.636696,2024-02-08 18:52:03
1248,L1-18.上北沢1丁目,20,10,30,35.662796,139.626795,2024-02-08 18:52:03
1249,B3-16.明石町区民館,0,20,20,35.666001,139.778102,2024-02-08 18:52:03
1250,I1-104.源氏前ビル,4,1,5,35.603521,139.712345,2024-02-08 18:52:03
1251,J1-28.宮前公園,2,1,3,35.617699,139.664826,2024-02-08 18:52:03
1252,M6-18.セブン-イレブン渋谷本町3丁目店,4,0,4,35.686521,139.685017,2024-02-08 18:52:03
1253,O7-08.杉並区和泉2-3-17,1,3,4,35.67187,139.65474,2024-02-08 18:52:03
1254,T1-17.セブン-イレブン練馬田柄通店,6,1,7,35.75987,139.640474,2024-02-08 18:52:03
1255,H1-18.東京ビッグサイト,8,8,16,35.631192,139.79401,2024-02-08 18:52:03
1256,M3-01.渋谷マークシティ,10,3,13,35.657726,139.697802,2024-02-08 18:52:03
1257,H1-70.有明スポーツセンター,9,8,17,35.63403,139.784319,2024-02-08 18:52:03
1258,H1-41.深川北スポーツセンター,13,0,13,35.676475,139.804741,2024-02-08 18:52:03
1259,H1-55.深川江戸資料館,0,9,9,35.681089,139.800777,2024-02-08 18:52:03
1260,I1-61.五反田文化センター,6,1,7,35.622588,139.716159,2024-02-08 18:52:03
1261,N3-13.中部すこやか福祉センター,4,0,4,35.700052,139.673715,2024-02-08 18:52:03
1262,A4-02.東京サンケイビル,0,22,22,35.686847,139.765151,2024-02-08 18:52:03
1263,M3-09.ティップ.クロス TOKYO 渋谷,10,9,19,35.661475,139.699296,2024-02-08 18:52:03
1264,B3-02.サンクンガーデン,3,2,5,35.670336,139.771911,2024-02-08 18:52:03
1265,T2-10.勤労福祉会館,3,2,5,35.748153,139.58765,2024-02-08 18:52:03
1266,K1-133.東京港野鳥公園,13,0,13,35.584217,139.759232,2024-02-08 18:52:03
1267,K1-21.六郷特別出張所,2,2,4,35.55079,139.716517,2024-02-08 18:52:03
1268,H1-54.砂町文化センター,7,13,20,35.680052,139.831874,2024-02-08 18:52:03
1269,D1-08.新宿歴史博物館,4,0,4,35.689984,139.725261,2024-02-08 18:52:03
1270,E1-05.春日地下自転車駐車場,23,4,27,35.708291,139.753335,2024-02-08 18:52:03
1271,E1-15.播磨坂事業所,4,1,5,35.71724,139.74289,2024-02-08 18:52:03
1272,E5-02.不忍通りふれあい館,9,2,11,35.719356,139.764308,2024-02-08 18:52:03
1273,E4-02.向丘地域活動センター,12,1,13,35.717357,139.757817,2024-02-08 18:52:03
1274,C3-18.明治記念館,0,5,5,35.678509,139.721207,2024-02-08 18:52:03
1275,D5-05.中央図書館,12,4,16,35.705018,139.706841,2024-02-08 18:52:03
1276,E2-07.肥後細川庭園,13,0,13,35.713223,139.721699,2024-02-08 18:52:03
1277,A1-05.富士見出張所,1,2,3,35.699187,139.746348,2024-02-08 18:52:03
1278,E5-07.湯島三丁目児童遊園,5,3,8,35.707296,139.769393,2024-02-08 18:52:03
1279,D5-10.桜美林大学 新宿キャンパス,1,6,7,35.705154,139.697562,2024-02-08 18:52:03
1280,A3-08.神田明神（神田神社）,9,4,13,35.702029,139.768245,2024-02-08 18:52:03
1281,E2-14.永青文庫 ミュージアム,5,0,5,35.713145,139.723342,2024-02-08 18:52:03
1282,M5-17.小田急サザンタワー,4,4,8,35.6866,139.70014,2024-02-08 18:52:03
1283,K1-16.ファミリーマート 矢口二丁目店,6,0,6,35.563092,139.693548,2024-02-08 18:52:03
1284,H1-206.北砂5丁目団地2,0,4,4,35.683866,139.831809,2024-02-08 18:52:03
1285,G1-02.八広駅高架下,4,10,14,35.727495,139.828499,2024-02-08 18:52:03
1286,F4-02.Risingplace浅草四番館,0,4,4,35.717963,139.791025,2024-02-08 18:52:03
1287,H1-204.大島四丁目団地2,8,0,8,35.68832,139.828829,2024-02-08 18:52:03
1288,H1-205.大島四丁目団地3,9,1,10,35.688236,139.827711,2024-02-08 18:52:03
1289,H1-106.亀戸中央公園,16,3,19,35.699874,139.834263,2024-02-08 18:52:03
1290,E5-30.湯島3丁目15,2,8,10,35.705148,139.769314,2024-02-08 18:52:03
1291,B4-38.HARUMI FLAG SUN VILLAGE,0,24,24,35.650347,139.771785,2024-02-08 18:52:03
1292,B4-32.HARUMI FLAG SEA VILLAGE,3,8,11,35.648731,139.774995,2024-02-08 18:52:03
1293,B4-31.HARUMI FLAG PORT VILLAGE,0,18,18,35.650604,139.77724,2024-02-08 18:52:03
1294,B4-33.HARUMI FLAG SEA VILLAGE,0,12,12,35.649552,139.776369,2024-02-08 18:52:03
1295,B4-36.HARUMI FLAG SEA VILLAGE,5,7,12,35.650742,139.778097,2024-02-08 18:52:03
1296,B4-35.HARUMI FLAG SEA VILLAGE,6,6,12,35.650573,139.777908,2024-02-08 18:52:03
1297,B4-37.HARUMI FLAG SUN VILLAGE,0,16,16,35.649419,139.771447,2024-02-08 18:52:03
1298,B4-34.HARUMI FLAG SEA VILLAGE,5,7,12,35.649932,139.776958,2024-02-08 18:52:03
1299,B4-39.HARUMI FLAG SUN VILLAGE,0,15,15,35.650863,139.772549,2024-02-08 18:52:03
1300,B4-40.HARUMI FLAG SUN VILLAGE,0,15,15,35.651305,139.773379,2024-02-08 18:52:03
1301,B4-41.HARUMI FLAG SUN VILLAGE,0,13,13,35.649854,139.77334,2024-02-08 18:52:03
1302,B4-42.HARUMI FLAG SUN VILLAGE,3,8,11,35.649329,139.772656,2024-02-08 18:52:03
1303,B4-28.HARUMI FLAG PORT VILLAGE,0,12,12,35.651183,139.776119,2024-02-08 18:52:03
1304,B4-50.HARUMI FLAG PARK VILLAGE,3,6,9,35.648295,139.773973,2024-02-08 18:52:03
1305,B4-49.HARUMI FLAG PARK VILLAGE,7,9,16,35.648636,139.774251,2024-02-08 18:52:03
1306,B4-48.HARUMI FLAG PARK VILLAGE,1,3,4,35.649513,139.775287,2024-02-08 18:52:03
1307,B4-47.HARUMI FLAG PARK VILLAGE,3,3,6,35.649119,139.775138,2024-02-08 18:52:03
1308,B4-46.HARUMI FLAG PARK VILLAGE,0,24,24,35.649642,139.773859,2024-02-08 18:52:03
1309,B4-45.HARUMI FLAG PARK VILLAGE,0,24,24,35.649002,139.772764,2024-02-08 18:52:03
1310,B4-44.HARUMI FLAG PARK VILLAGE,3,10,13,35.648221,139.772666,2024-02-08 18:52:03
1311,B4-30.HARUMI FLAG PORT VILLAGE,3,8,11,35.651136,139.778218,2024-02-08 18:52:03
1312,B4-29.HARUMI FLAG PORT VILLAGE,7,5,12,35.651907,139.777391,2024-02-08 18:52:03
1313,L1-19.三軒茶屋1丁目駐輪場,0,5,5,35.639302,139.674744,2024-02-08 18:52:03
1314,O7-09.方南月極パーキング,11,6,17,35.678921,139.658289,2024-02-08 18:52:03
1315,O5-10.ローソン ツルハドラッグ杉並和田店,1,3,4,35.68942,139.662118,2024-02-08 18:52:03
1316,O2-04.西荻北1丁目,2,3,5,35.708082,139.607543,2024-02-08 18:52:03
1317,K1-75.三井不動産インダストリアルパーク羽田,0,13,13,35.556231,139.751408,2024-02-08 18:52:03
1318,F1-05.ホウエイコート秋葉原,2,1,3,35.703024,139.78052,2024-02-08 18:52:03
1319,C3-36.第35興和ビル,0,3,3,35.666349,139.741781,2024-02-08 18:52:03
1320,B4-53.晴海五丁目ターミナル,30,76,106,35.651627,139.773103,2024-02-08 18:52:03
1321,C5-44.ブランズタワー芝浦,9,0,9,35.643105,139.753039,2024-02-08 18:52:03
1322,A3-47.ホテルヴィラフォンテーヌ東京大手町,11,2,13,35.690602,139.766916,2024-02-08 18:52:03
1323,A1-20.菱和パレス九段,5,0,5,35.693021,139.740317,2024-02-08 18:52:03
0,E5-26.本郷4丁目,2,2,4,35.708596,139.758269,2024-02-08 16:46:05
1,A3-42.内神田3丁目,32,0,32,35.692599,139.770109,2024-02-08 16:46:05
2,T2-76.東中前の森緑地,3,2,5,35.748736,139.574839,2024-02-08 16:46:05
3,A2-20.神田スクエア,12,6,18,35.693408,139.762809,2024-02-08 16:46:05
4,K1-79.Tマークシティホテル東京大森,7,0,7,35.586993,139.736491,2024-02-08 16:46:05
5,K1-80.大森北6丁目,4,0,4,35.579849,139.731241,2024-02-08 16:46:05
6,H1-130.トヨタモビリティ東京 深川店,7,3,10,35.676643,139.816054,2024-02-08 16:46:05
7,H1-131.セブン-イレブン 江東佐賀2丁目店,1,1,2,35.679029,139.793535,2024-02-08 16:46:05
8,H1-132.セブン-イレブン 江東三好4丁目店,0,4,4,35.681418,139.809287,2024-02-08 16:46:05
9,A6-22.半蔵門PREX South,14,1,15,35.683433,139.740756,2024-02-08 16:46:05
10,I1-74.セブン-イレブン西五反田6丁目店,1,3,4,35.622403,139.71771,2024-02-08 16:46:05
11,G2-01.東京ソラマチ,6,1,7,35.709777,139.810189,2024-02-08 16:46:05
12,T2-59.平成公園,2,1,3,35.722917,139.587864,2024-02-08 16:46:05
13,I1-26.大崎西口公園,0,14,14,35.617475,139.729221,2024-02-08 16:46:05
14,I1-96.西五反田２丁目,9,1,10,35.627599,139.720463,2024-02-08 16:46:05
15,H1-172.サンヨーパシフィックマンション,0,4,4,35.668856,139.794069,2024-02-08 16:46:05
16,J1-56.青葉台四丁目街かど公園,3,1,4,35.654009,139.692727,2024-02-08 16:46:05
17,H1-173.森下駅前,34,3,37,35.687837,139.79654,2024-02-08 16:46:05
18,E3-01.大塚地域活動センター跡地,4,4,8,35.718656,139.734556,2024-02-08 16:46:05
19,E2-03.目白台運動公園,37,2,39,35.715556,139.721988,2024-02-08 16:46:05
20,T2-77.大泉なかよし緑地,3,1,4,35.759861,139.581682,2024-02-08 16:46:05
21,E2-01.江戸川橋Ｂ自転車駐車場,52,27,79,35.710381,139.732137,2024-02-08 16:46:05
22,E2-02.江戸川公園,16,1,17,35.710958,139.731165,2024-02-08 16:46:05
23,D7-14.大栄パーク西落合１丁目,6,0,6,35.720028,139.678936,2024-02-08 16:46:05
24,E1-07.礫川地域活動センター,7,0,7,35.712015,139.750284,2024-02-08 16:46:05
25,M6-05.七号通り公園,0,6,6,35.67917,139.67493,2024-02-08 16:46:05
26,H1-138.HW.HILLS新大橋,10,1,11,35.687416,139.795588,2024-02-08 16:46:05
27,B4-21.月島駅前第一駐輪場,3,24,27,35.663681,139.785651,2024-02-08 16:46:05
28,N2-03.野方1丁目,7,0,7,35.712179,139.65603,2024-02-08 16:46:05
29,C5-52.港南四丁目第3アパート駐車場,11,0,11,35.630109,139.747094,2024-02-08 16:46:05
30,E5-27.真正館駐車場,0,3,3,35.714875,139.76394,2024-02-08 16:46:05
31,C5-35.品川駅港南口,5,0,5,35.62822,139.741135,2024-02-08 16:46:05
32,N2-01.NTT野方ビル,4,1,5,35.710285,139.66173,2024-02-08 16:46:05
33,D6-27.新宿三井ビルディング二号館,4,5,9,35.686334,139.692881,2024-02-08 16:46:05
34,D1-10.曙橋駐輪場,11,3,14,35.691888,139.724365,2024-02-08 16:46:05
35,I1-39.MID POINT 目黒不動前,3,1,4,35.628116,139.713149,2024-02-08 16:46:05
36,E3-07.小日向1丁目,2,2,4,35.713388,139.737009,2024-02-08 16:46:05
37,C1-47.パークプレイス三田,9,0,9,35.641791,139.740734,2024-02-08 16:46:05
38,I1-38.ローソン 八潮三丁目店,6,32,38,35.594544,139.760423,2024-02-08 16:46:05
39,C2-24.Dash Living HigashiAzabu,6,0,6,35.655135,139.744449,2024-02-08 16:46:05
40,J1-04.菅刈公園,7,1,8,35.650351,139.692853,2024-02-08 16:46:05
41,O4-09.ローソン杉並本天沼一丁目店,1,2,3,35.712496,139.632778,2024-02-08 16:46:05
42,T3-29.平和台もものき緑地,1,2,3,35.755773,139.661913,2024-02-08 16:46:05
43,D2-10.市谷砂土原町3丁目,9,2,11,35.696242,139.735776,2024-02-08 16:46:05
44,C1-48.竹芝客船ターミナル,3,12,15,35.655139,139.762812,2024-02-08 16:46:05
45,B1-06.伊場仙ビル,0,5,5,35.687624,139.777125,2024-02-08 16:46:05
46,B2-01.鉄砲洲児童公園（西側）,5,0,5,35.67224,139.779348,2024-02-08 16:46:05
47,B1-04.産業会館,5,0,5,35.694164,139.787057,2024-02-08 16:46:05
48,B1-05.日本橋保健センター,0,8,8,35.687419,139.779053,2024-02-08 16:46:05
49,B2-05.ＮＴＴ東日本築地ビル,0,3,3,35.670674,139.775993,2024-02-08 16:46:05
50,B2-02.柳通り（東京スクエアガーデン前）,3,9,12,35.676393,139.768319,2024-02-08 16:46:05
51,B2-03.男女平等センター（ブーケ21）,5,2,7,35.673923,139.778671,2024-02-08 16:46:05
52,C2-13.麻布運動場,5,2,7,35.651718,139.728165,2024-02-08 16:46:05
53,D2-08.旧市ヶ谷商業高校,0,5,5,35.70074,139.731363,2024-02-08 16:46:05
54,C1-35.セブン-イレブン 三田駅北店,4,1,5,35.649032,139.750147,2024-02-08 16:46:05
55,B4-12.THE TOKYO TOWERS,0,18,18,35.655497,139.774556,2024-02-08 16:46:05
56,C5-21.セブン-イレブン 芝浦3丁目店,3,0,3,35.642399,139.746992,2024-02-08 16:46:05
57,H1-67.セブン-イレブン 江東亀戸9丁目店,6,8,14,35.69766,139.843408,2024-02-08 16:46:05
58,C2-15.住友不動産六本木グランドタワー,0,15,15,35.664367,139.737185,2024-02-08 16:46:05
59,C2-14.元麻布ヒルズ,3,7,10,35.653608,139.73138,2024-02-08 16:46:05
60,M6-14.ドコモショップ笹塚店,0,5,5,35.67323,139.66393,2024-02-08 16:46:05
61,N4-07.南台2丁目,10,0,10,35.68509,139.671102,2024-02-08 16:46:05
62,K1-68.ART FACTORY 城南島,0,13,13,35.580511,139.775957,2024-02-08 16:46:05
63,H1-178.北砂7丁目団地(第二),0,4,4,35.678031,139.837193,2024-02-08 16:46:05
64,H1-179.北砂7丁目団地(第三),2,9,11,35.678246,139.8366,2024-02-08 16:46:05
65,A1-17.雉子橋集積所,6,0,6,35.692605,139.755761,2024-02-08 16:46:05
66,H1-177.北砂7丁目団地(第一),0,6,6,35.678537,139.837391,2024-02-08 16:46:05
67,K1-95.城南島海浜公園,10,6,16,35.578259,139.783505,2024-02-08 16:46:05
68,B3-17.銀座6丁目-SQUARE,1,6,7,35.66711,139.76643,2024-02-08 16:46:05
69,J1-33.芳窪街かど公園,13,0,13,35.629861,139.666293,2024-02-08 16:46:05
70,N3-07.なかのZERO,5,0,5,35.70442,139.67141,2024-02-08 16:46:05
71,N4-04.弥生町5丁目,5,7,12,35.690897,139.668345,2024-02-08 16:46:05
72,A3-44.THE WAVES AKIHABARA,4,0,4,35.694679,139.779504,2024-02-08 16:46:05
73,K1-138.羽田エアポートガーデン,1,9,10,35.544534,139.763244,2024-02-08 16:46:05
74,C3-26.ホテルリブマックス赤坂,2,3,5,35.67011,139.733375,2024-02-08 16:46:05
75,C1-52.NTT三田ビル,4,0,4,35.652549,139.747789,2024-02-08 16:46:05
76,D1-07.Dash Living Shinjuku,0,3,3,35.689757,139.710091,2024-02-08 16:46:05
77,O4-07.ローソン成田西三丁目店,0,4,4,35.690311,139.62178,2024-02-08 16:46:05
78,H1-152.コンポジット亀戸ウエスト,0,6,6,35.699187,139.82429,2024-02-08 16:46:05
79,E1-13.エルアージュ小石川,0,8,8,35.71399,139.75137,2024-02-08 16:46:05
80,B4-22.リビオレゾン勝どきNEX,0,11,11,35.65554,139.77102,2024-02-08 16:46:05
81,H1-176.JMFビル東陽町02,0,7,7,35.667677,139.823552,2024-02-08 16:46:05
82,H1-102.ファミリーマート東砂七丁目店,5,1,6,35.672714,139.837914,2024-02-08 16:46:05
83,H1-101.ファミリーマート新木場一丁目店,0,12,12,35.642571,139.836766,2024-02-08 16:46:05
84,K1-67.京浜島防災広場,0,36,36,35.570508,139.764013,2024-02-08 16:46:05
85,K1-66.昭和島二丁目公園,0,16,16,35.575097,139.751446,2024-02-08 16:46:05
86,I1-80.リバーサイド品川港南ビル,10,0,10,35.622714,139.74471,2024-02-08 16:46:05
87,J1-10.NTTデータ駒場研修センター,11,0,11,35.655779,139.680948,2024-02-08 16:46:05
88,A2-17.竹橋ビル,2,6,8,35.692396,139.75639,2024-02-08 16:46:05
89,H1-91.亀戸駅北口第三自転車駐車場,15,3,18,35.696913,139.823911,2024-02-08 16:46:05
90,H1-92.亀戸駅東口第二自転車駐車場,5,9,14,35.69788,139.830559,2024-02-08 16:46:05
91,K1-59.京急梅屋敷第1駐車場,6,0,6,35.565768,139.727396,2024-02-08 16:46:05
92,K1-60.京急平和島第1駐車場,9,0,9,35.576336,139.733691,2024-02-08 16:46:05
93,I1-42.京急青横駐車場,1,0,1,35.611582,139.742528,2024-02-08 16:46:05
94,I1-43.京急南大井駐車場,8,1,9,35.594722,139.737101,2024-02-08 16:46:05
95,O7-05.ジーベック方南町,2,0,2,35.680849,139.65626,2024-02-08 16:46:05
96,H1-100.URアーバンライフ亀戸,25,4,29,35.697935,139.821855,2024-02-08 16:46:05
97,A6-10.紀尾井町ビル（西側）,8,4,12,35.682516,139.736494,2024-02-08 16:46:05
98,C3-02.赤坂地区総合支所,0,5,5,35.674788,139.731423,2024-02-08 16:46:05
99,C2-08.ファミリーマート西麻布霞町店,0,3,3,35.661673,139.721118,2024-02-08 16:46:05
100,A6-09.紀尾井町ビル（北側）,3,3,6,35.682902,139.736494,2024-02-08 16:46:05
101,H1-28.有明客船ターミナル,5,6,11,35.630063,139.792209,2024-02-08 16:46:05
102,B1-12.ファミリーマート堀留町二丁目店,0,10,10,35.687786,139.78205,2024-02-08 16:46:05
103,H1-26.青海客船ターミナル,5,10,15,35.619234,139.774485,2024-02-08 16:46:05
104,H1-27.パレットタウン乗船場,10,0,10,35.624467,139.781305,2024-02-08 16:46:05
105,O1-04.井草1-34,9,6,15,35.72758,139.62432,2024-02-08 16:46:05
106,C1-76.浜松町駅北口交通広場(ハマサイト前),10,4,14,35.656647,139.758301,2024-02-08 16:46:05
107,J1-52.駒沢一丁目公園前,8,1,9,35.629807,139.662398,2024-02-08 16:46:05
108,C1-75.虎ノ門PFビル,0,7,7,35.665466,139.748014,2024-02-08 16:46:05
109,B2-18.旭ビルディング,6,5,11,35.678291,139.78157,2024-02-08 16:46:05
110,N2-09.松山駐車場No.1,2,4,6,35.722991,139.673048,2024-02-08 16:46:05
111,I1-82.トミンハイム西五反田四丁目,3,2,5,35.627386,139.711182,2024-02-08 16:46:05
112,O4-03.ザ・ハウス,0,12,12,35.707035,139.633066,2024-02-08 16:46:05
113,O4-04.阿佐谷南3-43,14,2,16,35.704147,139.631955,2024-02-08 16:46:05
114,K1-83.北千束北児童公園,5,1,6,35.611085,139.68599,2024-02-08 16:46:05
115,I1-95.東京レールゲート EAST,0,15,15,35.584998,139.761055,2024-02-08 16:46:05
116,M5-19.グランリヴィエール代々木,3,1,4,35.68285,139.698528,2024-02-08 16:46:05
117,H1-192.ウエリスアーバン水天宮前,4,0,4,35.678296,139.791949,2024-02-08 16:46:05
118,N2-08.江古田区民活動センター,2,2,4,35.728893,139.670119,2024-02-08 16:46:05
119,D7-04.セブン-イレブン 新宿下落合3丁目店,3,0,3,35.722645,139.701982,2024-02-08 16:46:05
120,K1-82.西蒲田公園,5,2,7,35.561499,139.71123,2024-02-08 16:46:05
121,H1-68.芝浦工業大学附属中学高等学校,13,0,13,35.649274,139.792213,2024-02-08 16:46:05
122,K1-24.東糀谷防災公園,0,28,28,35.557074,139.74575,2024-02-08 16:46:05
123,H1-03.東雲駅,0,27,27,35.640736,139.804331,2024-02-08 16:46:05
124,K1-26.大森諏訪公園,0,4,4,35.574785,139.730762,2024-02-08 16:46:05
125,K1-25.鶴渡公園,0,3,3,35.56892,139.725082,2024-02-08 16:46:05
126,N3-10.エーエスホームズⅡ駐車場,4,2,6,35.702659,139.662563,2024-02-08 16:46:05
127,J1-37.中目黒公園,14,4,18,35.640398,139.704069,2024-02-08 16:46:05
128,A1-10.ヒューリック九段ビル,0,5,5,35.696449,139.750784,2024-02-08 16:46:05
129,K1-93.六間堀仲羽公園,0,4,4,35.548864,139.74484,2024-02-08 16:46:05
130,T2-53.上練馬公園,2,2,4,35.772863,139.626969,2024-02-08 16:46:05
131,M5-01.初台駅南口,4,7,11,35.680154,139.685937,2024-02-08 16:46:05
132,C1-60.専売ビル,10,1,11,35.647659,139.745055,2024-02-08 16:46:05
133,K1-85.大田区青少年交流センター ゆいっつ,0,6,6,35.583555,139.743381,2024-02-08 16:46:05
134,I1-64.株式会社ユアス ゆうパック取扱所：ポストのうしろ,2,7,9,35.622965,139.731014,2024-02-08 16:46:05
135,C4-09.ケーヨーデイツー三田店,4,0,4,35.646375,139.740061,2024-02-08 16:46:05
136,C1-61.環三浜松町駅南,21,17,38,35.653096,139.75739,2024-02-08 16:46:05
137,K1-84.佐伯山緑地,5,7,12,35.581698,139.71491,2024-02-08 16:46:05
138,C1-59.セレスティン芝三井ビルディング,9,1,10,35.650845,139.748346,2024-02-08 16:46:05
139,G2-07.レオーネ押上cube,3,1,4,35.706167,139.815955,2024-02-08 16:46:05
140,E1-06.文京シビックセンター,15,4,19,35.708265,139.751983,2024-02-08 16:46:05
141,D2-13.THE CENTER TOKYO,5,0,5,35.695646,139.725722,2024-02-08 16:46:05
142,E5-22.千駄木2丁目,2,4,6,35.724828,139.762583,2024-02-08 16:46:05
143,C4-07.品川プリンスホテル,9,0,9,35.628266,139.734171,2024-02-08 16:46:05
144,A3-43.unito CHIYODA,0,2,2,35.69474,139.77929,2024-02-08 16:46:05
145,C4-06.白金プラチナレジデンス,0,16,16,35.644134,139.723432,2024-02-08 16:46:05
146,I1-63.セブン-イレブン西五反田店,0,3,3,35.62765,139.719212,2024-02-08 16:46:05
147,H1-53.豊洲シビックセンター,2,15,17,35.653991,139.795513,2024-02-08 16:46:05
148,T3-16.練馬区役所東庁舎(第一),8,2,10,35.735428,139.652379,2024-02-08 16:46:05
149,T2-68.さくら原っぱ緑地,2,3,5,35.731372,139.619164,2024-02-08 16:46:05
150,T2-69.久保新田さくら公園,1,3,4,35.76525,139.575978,2024-02-08 16:46:05
151,H1-187.森下文化センター,4,0,4,35.685344,139.80234,2024-02-08 16:46:05
152,E4-04.セブン-イレブン 文京本駒込１丁目店,5,0,5,35.724707,139.750469,2024-02-08 16:46:05
153,M2-13.恵比寿プライムスクエアタワー南,6,1,7,35.649257,139.713272,2024-02-08 16:46:05
154,H1-48.セブン-イレブン 江東潮見２丁目店,0,6,6,35.658249,139.815775,2024-02-08 16:46:05
155,H1-51.豊洲交通広場　東,0,35,35,35.654958,139.795718,2024-02-08 16:46:05
156,H1-52.辰巳駅,0,86,86,35.646756,139.809295,2024-02-08 16:46:05
157,D7-01.下落合図書館,9,5,14,35.715894,139.698578,2024-02-08 16:46:05
158,H1-50.豊洲交通広場　北,0,42,42,35.655457,139.795161,2024-02-08 16:46:05
159,A6-14.MG市ヶ谷ビルディング,1,2,3,35.690861,139.736393,2024-02-08 16:46:05
160,T2-21.ファミリーマート 練馬大泉町一丁目店,2,2,4,35.768448,139.601679,2024-02-08 16:46:05
161,A6-15.東急番町ビル,5,0,5,35.688929,139.7358,2024-02-08 16:46:05
162,A1-18.東京区政会館別館(特別区研修所),1,4,5,35.696202,139.752351,2024-02-08 16:46:05
163,T3-18.練馬駅北,5,14,19,35.738585,139.653396,2024-02-08 16:46:05
164,C1-43.KDX浜松町プレイス,0,8,8,35.658169,139.752509,2024-02-08 16:46:05
165,C5-27.プレミア海岸ビル,15,6,21,35.648948,139.757895,2024-02-08 16:46:05
166,I1-29.ローソン 勝島一丁目店,0,11,11,35.599987,139.745195,2024-02-08 16:46:05
167,H1-72.ネクストサイト深川ビル,20,1,21,35.674578,139.797396,2024-02-08 16:46:05
168,T1-11.むつみ台,3,0,3,35.768528,139.639807,2024-02-08 16:46:05
169,T1-10.月見大橋下,4,0,4,35.758366,139.628982,2024-02-08 16:46:05
170,H1-167.大島八丁目公園,8,2,10,35.688074,139.838932,2024-02-08 16:46:05
171,K1-36.セブン-イレブン 大田区南雪谷5丁目店,3,1,4,35.587815,139.691748,2024-02-08 16:46:05
172,L1-01.羽根木公園,6,6,12,35.66088,139.654546,2024-02-08 16:46:05
173,P1-02.雑司ヶ谷一丁目,8,0,8,35.721738,139.723103,2024-02-08 16:46:05
174,I1-66.南大井文化センター駐車場,4,0,4,35.596733,139.73804,2024-02-08 16:46:05
175,L1-05.NTT烏山ビル,0,4,4,35.669285,139.597931,2024-02-08 16:46:05
176,L1-04.下馬中央公園,3,1,4,35.63367,139.678139,2024-02-08 16:46:05
177,L1-03.世田谷城阯公園,2,4,6,35.645838,139.647799,2024-02-08 16:46:05
178,L1-02.若林公園,5,2,7,35.647075,139.654472,2024-02-08 16:46:05
179,T2-30.ファミリーマート 練馬東大泉四丁目店,4,0,4,35.750804,139.58243,2024-02-08 16:46:05
180,L1-07.NTT成城ビル,2,1,3,35.648021,139.606529,2024-02-08 16:46:05
181,L1-06.NTT瀬田ビル,0,11,11,35.618357,139.626191,2024-02-08 16:46:05
182,T3-12.春日町西公園,4,0,4,35.748092,139.636587,2024-02-08 16:46:05
183,T3-13.平和台児童公園,2,2,4,35.757298,139.664139,2024-02-08 16:46:05
184,T2-38.ファミリーマート 練馬上石神井四丁目店,4,5,9,35.727195,139.590179,2024-02-08 16:46:05
185,B1-28.アイルイムーブル日本橋,7,2,9,35.684502,139.77906,2024-02-08 16:46:05
186,A2-28.NTTコミュニケーションズ一ツ橋ビル駐車場,6,2,8,35.6915,139.75685,2024-02-08 16:46:05
187,C3-32.乃木公園,1,1,2,35.667936,139.72745,2024-02-08 16:46:05
188,T3-14.わらべ児童遊園,2,2,4,35.759774,139.654529,2024-02-08 16:46:05
189,T2-52.田柄中央児童公園,4,1,5,35.762395,139.641522,2024-02-08 16:46:05
190,M4-06.THE SHARE 原宿,10,0,10,35.671823,139.708158,2024-02-08 16:46:05
191,K1-10.セブン‐イレブン 大田区西糀谷１丁目店,4,0,4,35.559647,139.730098,2024-02-08 16:46:05
192,K1-09.セブン‐イレブン 大田区西蒲田２丁目店,0,17,17,35.570763,139.705895,2024-02-08 16:46:05
193,H1-63.東京スイソミル,8,0,8,35.65637,139.811765,2024-02-08 16:46:05
194,B1-16.小網町児童遊園,0,5,5,35.683695,139.780043,2024-02-08 16:46:05
195,H1-61.Brilliaランニングスタジアムマギーズ東京前,0,13,13,35.648281,139.786112,2024-02-08 16:46:05
196,K1-08.セブン‐イレブン 大田区東蒲田キネマ通り店,5,0,5,35.562368,139.730143,2024-02-08 16:46:05
197,C1-34.城山ガーデン,0,14,14,35.664479,139.743731,2024-02-08 16:46:05
198,H1-62.扇橋一丁目公園南,13,4,17,35.683343,139.812161,2024-02-08 16:46:05
199,J1-23.清水池公園,21,2,23,35.623756,139.692517,2024-02-08 16:46:05
200,C5-18.パークタワー品川ベイワード,19,0,19,35.634529,139.748378,2024-02-08 16:46:05
201,E4-07.ファミリーマート 本駒込二丁目店,3,1,4,35.727279,139.74627,2024-02-08 16:46:05
202,C5-45.パークアクシス芝浦キャナル,9,0,9,35.644794,139.755688,2024-02-08 16:46:05
203,A2-02.西神田公園（北側）,7,0,7,35.698591,139.755113,2024-02-08 16:46:05
204,T2-49.善福寺公園テニスクラブ,6,3,9,35.719674,139.593696,2024-02-08 16:46:05
205,H1-193.ライフ豊洲店,25,2,27,35.651833,139.79962,2024-02-08 16:46:05
206,A2-01.神田駿河台下,51,1,52,35.695762,139.761585,2024-02-08 16:46:05
207,I1-51.京急鈴ヶ森駐車場,5,0,5,35.589573,139.735585,2024-02-08 16:46:05
208,T2-36.サントピア テニスパーク,5,5,10,35.75195,139.616028,2024-02-08 16:46:05
209,G4-13. Parking in 両国駅前第2,0,2,2,35.696492,139.791591,2024-02-08 16:46:05
210,K1-120.蒲田駅消費者生活センター横自転車駐車場 屋上部,6,0,6,35.560125,139.71569,2024-02-08 16:46:05
211,N3-18.藤和シティコープ新中野3,6,0,6,35.69942,139.673964,2024-02-08 16:46:05
212,K1-145.トヨタモビリティ東京馬込テクニカル研修センター,13,0,13,35.58209,139.701362,2024-02-08 16:46:05
213,K1-100.多摩川台公園,5,0,5,35.589794,139.666955,2024-02-08 16:46:05
214,C1-54.ニッセイ虎ノ門ビル,3,7,10,35.664344,139.746662,2024-02-08 16:46:05
215,I1-52.カスタリアタワー品川シーサイド,7,0,7,35.607557,139.746866,2024-02-08 16:46:05
216,I1-53.天王洲公園,0,8,8,35.620355,139.749339,2024-02-08 16:46:05
217,C2-18.ブランシェ東麻布,2,0,2,35.656769,139.743224,2024-02-08 16:46:05
218,A3-45.鍛冶町2丁目,15,0,15,35.691578,139.77138,2024-02-08 16:46:05
219,H1-87.パークアクシス木場キャナルウエスト,6,1,7,35.662514,139.803694,2024-02-08 16:46:05
220,D6-20.淀橋けやき橋公園,6,8,14,35.693544,139.685806,2024-02-08 16:46:05
221,A3-46.神田須田町2丁目,0,0,0,35.695457,139.772972,2024-02-08 16:46:05
222,B3-13.国立がん研究センター,9,2,11,35.664871,139.767188,2024-02-08 16:46:05
223,I1-35.シーフォートスクエア,2,13,15,35.622954,139.750593,2024-02-08 16:46:05
224,K1-55.カバヤビル,17,1,18,35.576275,139.713704,2024-02-08 16:46:05
225,C3-24.SHARE GREEN 南青山 西エントランス,0,6,6,35.668419,139.724676,2024-02-08 16:46:05
226,A5-06.APA HOTEL PRIDE〈国会議事堂前〉,10,0,10,35.674468,139.741328,2024-02-08 16:46:05
227,A6-17.東京ガーデンテラス紀尾井町（プリンス通り側）,10,1,11,35.680431,139.738203,2024-02-08 16:46:05
228,B4-07.勝どき駅地下駐輪場,53,7,60,35.658135,139.776131,2024-02-08 16:46:05
229,B4-08.東京ミッドベイ勝どき（西仲通り）,16,0,16,35.656449,139.771302,2024-02-08 16:46:05
230,B3-04.築地市場駅地下駐輪場,17,0,17,35.664265,139.767426,2024-02-08 16:46:05
231,C5-10.シーバンス,0,12,12,35.649959,139.756068,2024-02-08 16:46:05
232,H1-34.門前仲町駅,48,1,49,35.67391,139.796165,2024-02-08 16:46:05
233,C3-10.ファミリーマート特許庁前店,0,13,13,35.670364,139.744684,2024-02-08 16:46:05
234,A1-01.千代田区役所,0,7,7,35.693799,139.753281,2024-02-08 16:46:05
235,A1-03.東京区政会館（メトロA5出口）,3,4,7,35.701073,139.747525,2024-02-08 16:46:05
236,B3-06.朝日新聞東京本社,0,10,10,35.664457,139.767214,2024-02-08 16:46:05
237,A1-04.東京区政会館（西側駐輪場）,4,3,7,35.701347,139.746951,2024-02-08 16:46:05
238,T1-03.四季の香公園,5,0,5,35.760585,139.626284,2024-02-08 16:46:05
239,T1-04.春の風公園,3,0,3,35.75731,139.624922,2024-02-08 16:46:05
240,T1-05.夏の雲公園,4,1,5,35.753964,139.629116,2024-02-08 16:46:05
241,H1-194.セブン-イレブン江東北砂5丁目店,3,0,3,35.68268,139.8353,2024-02-08 16:46:05
242,O5-03.新高円寺地下自転車駐輪場,6,7,13,35.697265,139.649397,2024-02-08 16:46:05
243,O3-06.アミーズ荻窪,3,1,4,35.714616,139.625116,2024-02-08 16:46:05
244,T2-03.リヴィンオズ大泉店,7,1,8,35.752383,139.594855,2024-02-08 16:46:05
245,O6-06.上高井戸1丁目,0,7,7,35.673055,139.611293,2024-02-08 16:46:05
246,T2-05.石神井図書館,4,0,4,35.736076,139.599676,2024-02-08 16:46:05
247,T2-06.総合体育館,3,0,3,35.748957,139.621385,2024-02-08 16:46:05
248,O5-02.馬橋ハイツ,5,1,6,35.705686,139.642587,2024-02-08 16:46:05
249,N1-07.プランドール上鷺宮,1,6,7,35.733292,139.630369,2024-02-08 16:46:05
250,E1-18.アーバネックス小石川春日,5,2,7,35.709261,139.746374,2024-02-08 16:46:05
251,T3-03.新桜台駅自転車駐車場,5,2,7,35.740378,139.667502,2024-02-08 16:46:05
252,O3-05.Nちゃりパーク,14,7,21,35.70389,139.6185,2024-02-08 16:46:05
253,O5-01.朝霞ハイツ,10,1,11,35.71038,139.64519,2024-02-08 16:46:05
254,L1-11.アイムタウン上祖師谷,2,1,3,35.656849,139.594422,2024-02-08 16:46:05
255,L1-12.鈴木リースホーム駐車場,13,1,14,35.646648,139.633038,2024-02-08 16:46:05
256,L1-13.わびさびホステル,3,1,4,35.647393,139.667085,2024-02-08 16:46:05
257,G2-05.リアナスカイパーク押上,6,0,6,35.715733,139.815451,2024-02-08 16:46:05
258,T3-02.早宮第二自転車駐車場,6,5,11,35.756846,139.652154,2024-02-08 16:46:05
259,I1-37.ガーデンシティ品川御殿山,4,5,9,35.623466,139.734359,2024-02-08 16:46:05
260,T2-47.上石神井駅北第二自転車駐車場,7,3,10,35.726523,139.5905,2024-02-08 16:46:05
261,C1-51.環二新橋四丁目,12,0,12,35.663843,139.757697,2024-02-08 16:46:05
262,M6-07.笹塚東,18,1,19,35.675436,139.670594,2024-02-08 16:46:05
263,M3-10.ウノサワ東急ビル,7,1,8,35.647757,139.712981,2024-02-08 16:46:05
264,C2-26.一の橋公園,7,0,7,35.655367,139.738075,2024-02-08 16:46:05
265,H1-14.ホテルリブマックス東京潮見駅前,4,2,6,35.658351,139.818229,2024-02-08 16:46:05
266,D2-12.ヴィアイン飯田橋後楽園,3,3,6,35.705774,139.743366,2024-02-08 16:46:05
267,D3-08.ホテルリブマックス高田馬場駅前,6,2,8,35.712952,139.701356,2024-02-08 16:46:05
268,H1-103.清澄庭園,8,1,9,35.680948,139.796917,2024-02-08 16:46:05
269,H1-104.木場公園,15,0,15,35.676488,139.809616,2024-02-08 16:46:05
270,H1-105.猿江恩賜公園,7,1,8,35.692277,139.817491,2024-02-08 16:46:05
271,G4-07.ディアレイシャス両国,3,0,3,35.69955,139.803204,2024-02-08 16:46:05
272,T2-46.大泉郵便局バス停自転車駐車場,1,8,9,35.766491,139.587232,2024-02-08 16:46:05
273,I1-18.東品川公園,6,0,6,35.61379,139.746617,2024-02-08 16:46:05
274,J1-03.西郷山公園,6,0,6,35.650688,139.696696,2024-02-08 16:46:05
275,J1-02.駒場野公園,10,3,13,35.657718,139.681043,2024-02-08 16:46:05
276,D2-14.ローソン 神楽坂駅北店,0,5,5,35.704201,139.735815,2024-02-08 16:46:05
277,K1-65.下丸子3丁目,6,6,12,35.571711,139.685337,2024-02-08 16:46:05
278,T2-43.学園通り自転車駐車場,8,0,8,35.7547,139.5871,2024-02-08 16:46:05
279,I1-46.セブン-イレブン 品川東中延2丁目店,1,1,2,35.608721,139.714158,2024-02-08 16:46:05
280,T2-04.石神井公園駅南口,4,6,10,35.743354,139.606592,2024-02-08 16:46:05
281,J1-06.観音橋自転車置場,13,31,44,35.642251,139.69692,2024-02-08 16:46:05
282,J1-05.東山公園　北,0,8,8,35.64853,139.686309,2024-02-08 16:46:05
283,J1-45.プラウド中目黒,1,0,1,35.63767,139.7045,2024-02-08 16:46:05
284,H1-168.大島五丁目公園,13,0,13,35.68642,139.836151,2024-02-08 16:46:05
285,J1-47.本町みなみ街かど公園,12,3,15,35.61847,139.70019,2024-02-08 16:46:05
286,J1-48.グランドエクセル祐天寺,0,13,13,35.64372,139.68777,2024-02-08 16:46:05
287,K1-101.小池公園,2,3,5,35.599541,139.697962,2024-02-08 16:46:05
288,H1-171.LOGI’Q南砂町,8,1,9,35.672877,139.842339,2024-02-08 16:46:05
289,H1-153.三井リンクラボ新木場1,0,23,23,35.63851,139.823534,2024-02-08 16:46:05
290,H1-154.やぐら橋下,2,18,20,35.631132,139.792726,2024-02-08 16:46:05
291,D5-11.NTTコミュニケーションズ新宿ビル,0,9,9,35.699312,139.696468,2024-02-08 16:46:05
292,C5-31.ヒルトン東京お台場,2,8,10,35.626267,139.771438,2024-02-08 16:46:05
293,K1-78.城南鋳物団地協同組合,0,16,16,35.567562,139.766854,2024-02-08 16:46:05
294,I1-68.八潮公園第二,2,0,2,35.600003,139.754288,2024-02-08 16:46:05
295,I1-67.八潮公園第一,3,1,4,35.601149,139.754284,2024-02-08 16:46:05
296,H1-123.ダイワロイネットホテル東京有明,4,17,21,35.634316,139.793199,2024-02-08 16:46:05
297,J1-24.ボヌールREIWA,4,1,5,35.612389,139.676238,2024-02-08 16:46:05
298,B2-12.東京ダイヤビルディング（東側）,1,16,17,35.674835,139.785656,2024-02-08 16:46:05
299,J1-15.二の橋自転車置場2,14,2,16,35.614391,139.678396,2024-02-08 16:46:05
300,H1-77.ライフ東砂店,3,6,9,35.684641,139.844243,2024-02-08 16:46:05
301,D1-09.NTT四谷ビル,3,0,3,35.691188,139.712079,2024-02-08 16:46:05
302,E4-11.プライマル千石,0,8,8,35.727519,139.742815,2024-02-08 16:46:05
303,I1-23.東海橋防災船着場,10,0,10,35.616114,139.74033,2024-02-08 16:46:05
304,A4-12.東京ミッドタウン日比谷,0,11,11,35.674274,139.759111,2024-02-08 16:46:05
305,K1-46.池上駅前自転車駐車場,6,6,12,35.571478,139.702779,2024-02-08 16:46:05
306,I1-24.しながわ区民公園(中央口),6,5,11,35.593611,139.738056,2024-02-08 16:46:05
307,T2-13.セブン-イレブン 練馬石神井町8丁目店,3,1,4,35.750414,139.600011,2024-02-08 16:46:05
308,O3-04.アヴァンセ阿佐ヶ谷,1,1,2,35.712,139.62816,2024-02-08 16:46:05
309,B4-01.黎明橋公園（駐輪場）,1,8,9,35.656071,139.780068,2024-02-08 16:46:05
310,T2-32.セブン-イレブン 練馬東大泉NTTビル店,6,1,7,35.750761,139.594457,2024-02-08 16:46:05
311,K1-142.コーラル洗足池,10,0,10,35.604567,139.689096,2024-02-08 16:46:05
312,K1-28.鵜の木特別出張所,3,1,4,35.574886,139.685122,2024-02-08 16:46:05
313,T1-02.ホテルカデンツァ東京,9,3,12,35.755106,139.621675,2024-02-08 16:46:05
314,C2-16.ザ・ベルグレイヴィア麻布,1,0,1,35.657264,139.743821,2024-02-08 16:46:05
315,N3-11.上高田区民活動センター,4,1,5,35.711501,139.672761,2024-02-08 16:46:05
316,T3-30.北西大松公園,2,2,4,35.765979,139.64931,2024-02-08 16:46:05
317,D6-05.新宿中央公園（水の広場）,4,2,6,35.690474,139.690219,2024-02-08 16:46:05
318,D6-07.新宿フロントタワー,0,14,14,35.696387,139.689924,2024-02-08 16:46:05
319,T2-73.早実グラウンド記念公園,2,2,4,35.734615,139.576214,2024-02-08 16:46:05
320,O7-03.永福町西幸モータープール東,1,10,11,35.67156,139.64609,2024-02-08 16:46:05
321,D1-03.新左門児童遊園,3,0,3,35.684523,139.720519,2024-02-08 16:46:05
322,D1-04.四谷見附公園,2,11,13,35.683448,139.728425,2024-02-08 16:46:05
323,I1-54.天王洲オーシャンスクエア,0,25,25,35.622356,139.749468,2024-02-08 16:46:05
324,D6-01.新宿区役所本庁舎,33,15,48,35.693602,139.703229,2024-02-08 16:46:05
325,D6-02.新宿区役所第二分庁舎,32,3,35,35.693976,139.706134,2024-02-08 16:46:05
326,D6-03.新宿中央公園（ポケットパーク）,5,4,9,35.691559,139.690029,2024-02-08 16:46:05
327,D6-04.新宿中央公園（ちびっこ広場）,3,7,10,35.686649,139.689821,2024-02-08 16:46:05
328,A6-21.日本工営ビル,4,1,5,35.684584,139.734442,2024-02-08 16:46:05
329,I1-77.セブン-イレブン品川西中延1丁目店,3,0,3,35.612217,139.708164,2024-02-08 16:46:05
330,T1-01.光が丘駅前広場,6,7,13,35.759164,139.629466,2024-02-08 16:46:05
331,T2-37.上石神井2丁目,6,2,8,35.729615,139.59532,2024-02-08 16:46:05
332,I1-75.セブン-イレブン品川二葉4丁目店,1,1,2,35.603275,139.713428,2024-02-08 16:46:05
333,M5-13.セブン-イレブン初台店,0,0,0,35.675049,139.68444,2024-02-08 16:46:05
334,D6-24.ＮＴＴ東日本 本社ビル,8,3,11,35.683102,139.688852,2024-02-08 16:46:05
335,H1-134.豊洲ぐるり公園,6,16,22,35.643141,139.777821,2024-02-08 16:46:05
336,H1-133.北砂2丁目公園,10,6,16,35.679001,139.825809,2024-02-08 16:46:05
337,E3-08.サガラマンション,2,3,5,35.722833,139.734662,2024-02-08 16:46:05
338,O4-05.阿佐ヶ谷南1-30,1,1,2,35.700703,139.639985,2024-02-08 16:46:05
339,O5-06.EXAM高円寺南,5,0,5,35.70273,139.65864,2024-02-08 16:46:05
340,G2-03.押上１丁目２６-４,3,2,5,35.710323,139.815215,2024-02-08 16:46:05
341,K1-132.多摩川駅前自転車等駐車場,13,2,15,35.587232,139.669519,2024-02-08 16:46:05
342,C5-47.oak港南品川,24,0,24,35.62413,139.744831,2024-02-08 16:46:05
343,D3-15.カースルいずみ,12,2,14,35.711324,139.711976,2024-02-08 16:46:05
344,C5-15.セブン-イレブン 港区芝浦ふ頭店,1,2,3,35.640215,139.755971,2024-02-08 16:46:05
345,C5-14.セブン-イレブン 港区汐彩橋店,5,0,5,35.640481,139.753659,2024-02-08 16:46:05
346,D5-01.新宿コズミックセンター,0,8,8,35.705244,139.70841,2024-02-08 16:46:05
347,H1-45.夢の島競技場,18,2,20,35.648596,139.824936,2024-02-08 16:46:05
348,E1-01.後楽橋横,23,0,23,35.702746,139.752009,2024-02-08 16:46:05
349,B1-15.ロイヤルパークホテル,2,1,3,35.682332,139.78722,2024-02-08 16:46:05
350,C4-05.白金台駅自転車駐車場,15,0,15,35.638927,139.727083,2024-02-08 16:46:05
351,E1-02.東京ドーム（ミーツポート）,0,11,11,35.70311,139.754951,2024-02-08 16:46:05
352,M2-06.あいおいニッセイ同和損保恵比寿ビル,5,2,7,35.647237,139.71512,2024-02-08 16:46:05
353,J1-12.工大橋下流自転車置場,3,1,4,35.605828,139.680265,2024-02-08 16:46:05
354,C5-25.NEX-TEC芝浦,35,1,36,35.639571,139.755551,2024-02-08 16:46:05
355,H1-175.ダイアパレス大島駅前,1,1,2,35.689543,139.836394,2024-02-08 16:46:05
356,C1-65.東京ポートシティ竹芝,7,4,11,35.654757,139.761516,2024-02-08 16:46:05
357,O2-03.西荻北5-8-17,2,3,5,35.709712,139.601846,2024-02-08 16:46:05
358,B2-21.八重洲二丁目北地区広場,0,25,25,35.67942,139.77004,2024-02-08 16:46:05
359,I1-101.下神明駅前,25,0,25,35.60838,139.726587,2024-02-08 16:46:05
360,N2-04.野方2丁目,6,0,6,35.713018,139.656768,2024-02-08 16:46:05
361,N2-05.野方3丁目,7,5,12,35.717877,139.654732,2024-02-08 16:46:05
362,K1-88.大田久が原西郵便局,3,1,4,35.582756,139.6925,2024-02-08 16:46:05
363,C5-51.トミンタワー台場一番街,8,0,8,35.634627,139.77663,2024-02-08 16:46:05
364,C4-10.亀塚公園,6,3,9,35.642764,139.741174,2024-02-08 16:46:05
365,H1-190.福山通運 東京支店,6,13,19,35.664845,139.796643,2024-02-08 16:46:05
366,C1-80.浜松町262ビル,10,1,11,35.654289,139.75557,2024-02-08 16:46:05
367,B2-19.リエトコートアルクスタワー,9,0,9,35.670506,139.77854,2024-02-08 16:46:05
368,C1-79.髙松コンストラクショングループ 東京本社ビル,5,0,5,35.648765,139.753363,2024-02-08 16:46:05
369,C5-43.オアーゼ芝浦MJビル,8,0,8,35.644798,139.752697,2024-02-08 16:46:05
370,J1-44.五本木2丁目,0,9,9,35.634441,139.687186,2024-02-08 16:46:05
371,B2-17.アーバネックス八丁堀,1,2,3,35.67518,139.77364,2024-02-08 16:46:05
372,M6-16.パールマンション,2,0,2,35.67464,139.67876,2024-02-08 16:46:05
373,G4-06.ドムス・スタイル両国,3,1,4,35.700453,139.798978,2024-02-08 16:46:05
374,G2-04.ラ　ステュディオ押上,4,1,5,35.712157,139.815298,2024-02-08 16:46:05
375,T3-15.セブン-イレブン練馬北町8丁目店,6,0,6,35.768105,139.646049,2024-02-08 16:46:05
376,C1-77.芝公園,11,5,16,35.65513,139.749645,2024-02-08 16:46:05
377,I1-27.小関橋公園,0,11,11,35.620699,139.730904,2024-02-08 16:46:05
378,B3-01.中央区役所,0,10,10,35.670855,139.772052,2024-02-08 16:46:05
379,A6-08.二番町ガーデン,5,0,5,35.685489,139.734562,2024-02-08 16:46:05
380,B1-01.十思公園,0,13,13,35.691058,139.777915,2024-02-08 16:46:05
381,B4-02.月島特別出張所,9,17,26,35.662197,139.782719,2024-02-08 16:46:05
382,A4-05.大手町タワー,0,25,25,35.685938,139.764886,2024-02-08 16:46:05
383,H1-22.豊洲市場（7街区）,9,60,69,35.6447,139.784512,2024-02-08 16:46:05
384,A6-07.二番町センタービル,0,5,5,35.685966,139.736328,2024-02-08 16:46:05
385,A2-12.神保町三井ビルディング,1,8,9,35.694532,139.760695,2024-02-08 16:46:05
386,E2-06.oto no ha Cafe,0,4,4,35.713991,139.725665,2024-02-08 16:46:05
387,B4-10.リバーシティ,9,0,9,35.668795,139.784784,2024-02-08 16:46:05
388,B1-03.常盤公園（北側）,5,2,7,35.688405,139.770068,2024-02-08 16:46:05
389,C5-19.グランドメゾン田町,7,0,7,35.645537,139.754899,2024-02-08 16:46:05
390,K1-11.ファミリーマート かわだ多摩川２丁目店,0,2,2,35.558289,139.697403,2024-02-08 16:46:05
391,J1-43.アルコタワー・ホテル雅叙園東京,5,6,11,35.63237,139.712681,2024-02-08 16:46:05
392,N1-03.鷺宮南駐輪場,6,3,9,35.721827,139.635949,2024-02-08 16:46:05
393,N2-06.江古田1丁目B,5,1,6,35.72515,139.672614,2024-02-08 16:46:05
394,D7-12.プラウド高田馬場,4,1,5,35.715538,139.701683,2024-02-08 16:46:05
395,K1-118.久が原3丁目,3,6,9,35.580741,139.687152,2024-02-08 16:46:05
396,K1-125.池上駅南口第1,1,1,2,35.571866,139.703214,2024-02-08 16:46:05
397,K1-117.安詳寺,9,10,19,35.581798,139.695222,2024-02-08 16:46:05
398,I1-91.アクロス目黒タワー,8,0,8,35.634019,139.719749,2024-02-08 16:46:05
399,K1-126.池上駅南口第2,2,1,3,35.571815,139.702387,2024-02-08 16:46:05
400,C5-50.お台場レインボー公園,12,0,12,35.633133,139.777315,2024-02-08 16:46:05
401,T3-26.富士見ランド公園,1,7,8,35.73701,139.627244,2024-02-08 16:46:05
402,T1-15.つのの山緑地,4,0,4,35.765144,139.636606,2024-02-08 16:46:05
403,T1-16.ゆりの木通り南公園,3,1,4,35.767582,139.636304,2024-02-08 16:46:05
404,H1-185.UR大島六丁目団地(第二),2,1,3,35.690038,139.833252,2024-02-08 16:46:05
405,H1-186.セブン-イレブン亀戸昭和橋通り店,0,7,7,35.694804,139.831357,2024-02-08 16:46:05
406,K1-96.西馬込駅前自転車駐車場,1,11,12,35.586408,139.705425,2024-02-08 16:46:05
407,H1-184.UR大島六丁目団地(第一),4,0,4,35.689913,139.833279,2024-02-08 16:46:05
408,A6-25.麹町仮住宅,3,1,4,35.679192,139.74019,2024-02-08 16:46:05
409,C1-69.塩釜公園,0,0,0,35.662908,139.755014,2024-02-08 16:46:05
410,C1-68.桜田公園,26,0,26,35.665214,139.757008,2024-02-08 16:46:05
411,A2-14.興和一橋ビル,9,6,15,35.6927,139.759311,2024-02-08 16:46:05
412,C5-41.トヨタモビリティ東京 芝浦店,4,0,4,35.639644,139.745532,2024-02-08 16:46:05
413,T2-22.ファミリーマート 石神井台7丁目店,5,0,5,35.731909,139.579685,2024-02-08 16:46:05
414,A6-20.紀尾井町PREX,4,3,7,35.68369,139.736936,2024-02-08 16:46:05
415,C5-24.GLOBAL FRONT TOWER,16,0,16,35.647713,139.755534,2024-02-08 16:46:05
416,E5-09.文京区 男女平等センター,9,4,13,35.70861,139.75768,2024-02-08 16:46:05
417,K1-37.東京サーハウス前,19,1,20,35.563874,139.685011,2024-02-08 16:46:05
418,B4-15.リバーシティ　イーストタワーズ,1,5,6,35.669188,139.785301,2024-02-08 16:46:05
419,M6-08.Be Good 幡ヶ谷,12,0,12,35.682453,139.677687,2024-02-08 16:46:05
420,D5-09.ハウジングステージ新宿,13,0,13,35.702277,139.701214,2024-02-08 16:46:05
421,D6-21.新宿5丁目,6,1,7,35.691613,139.711233,2024-02-08 16:46:05
422,K1-39.東京モノレール 流通センター駅前,0,28,28,35.581752,139.748705,2024-02-08 16:46:05
423,K1-38.ネクストサイト蒲田ビル,8,1,9,35.558916,139.717253,2024-02-08 16:46:05
424,T3-17.練馬区役所東庁舎(第二),4,1,5,35.735585,139.652544,2024-02-08 16:46:05
425,H1-107.大島小松川公園,5,21,26,35.692641,139.846346,2024-02-08 16:46:05
426,B1-11.浜町川緑道,25,21,46,35.684158,139.787649,2024-02-08 16:46:05
427,A6-19.番町麹町ビルディング,7,3,10,35.685578,139.732078,2024-02-08 16:46:05
428,B3-12.築地場外市場,11,7,18,35.665254,139.769301,2024-02-08 16:46:05
429,I1-40.御殿山トラストタワー,21,4,25,35.622371,139.737457,2024-02-08 16:46:05
430,M5-08.古賀政男音楽博物館,2,0,2,35.668091,139.680243,2024-02-08 16:46:05
431,H1-90.富士倉庫運輸(株) FACE-1前,1,1,2,35.655102,139.805205,2024-02-08 16:46:05
432,A3-38.パークホームズ千代田淡路町,0,3,3,35.695163,139.769566,2024-02-08 16:46:05
433,D2-11.神楽坂アインスタワー,4,1,5,35.702833,139.739,2024-02-08 16:46:05
434,C2-04.飯倉いきいきプラザ,3,0,3,35.656991,139.740739,2024-02-08 16:46:05
435,B1-09.スマイルホテル日本橋三越前,3,14,17,35.686101,139.776089,2024-02-08 16:46:05
436,E5-15.文京千駄木の郷,9,2,11,35.726499,139.759884,2024-02-08 16:46:05
437,C2-05.ありすいきいきプラザ,10,3,13,35.651046,139.727745,2024-02-08 16:46:05
438,C5-06.品川シーズンテラス,11,8,19,35.632303,139.742393,2024-02-08 16:46:05
439,B1-10.箱崎川第二公園,7,2,9,35.680833,139.784267,2024-02-08 16:46:05
440,L1-15.ソフィア,0,3,3,35.663222,139.587803,2024-02-08 16:46:05
441,A3-12.秋葉原UDX北側駐輪場前,0,17,17,35.70111,139.772855,2024-02-08 16:46:05
442,A2-08.KDX御茶ノ水ビル,5,4,9,35.700568,139.76013,2024-02-08 16:46:05
443,A3-07.淡路公園,0,6,6,35.696942,139.767302,2024-02-08 16:46:05
444,A1-08.飯田橋サクラテラス（早稲田通り）,0,13,13,35.699132,139.74462,2024-02-08 16:46:05
445,A3-13.富士ソフトビル（駐車場入口横）,5,14,19,35.700486,139.774254,2024-02-08 16:46:05
446,A2-09.テラススクエア,1,7,8,35.6931,139.7599,2024-02-08 16:46:05
447,A6-11.東京ガーデンテラス紀尾井町,6,17,23,35.67962,139.7364,2024-02-08 16:46:05
448,K1-124.矢口2丁目,6,0,6,35.564161,139.695187,2024-02-08 16:46:05
449,N3-15.ライオンズマンション中野東,1,2,3,35.71046,139.6855,2024-02-08 16:46:05
450,M3-11.渋谷道玄坂東急ビル,9,0,9,35.65718,139.698687,2024-02-08 16:46:05
451,H1-180.シティコート大島,7,1,8,35.691954,139.836462,2024-02-08 16:46:05
452,B1-27.日本橋本町4丁目,24,1,25,35.68973,139.77598,2024-02-08 16:46:05
453,M3-22.森谷ビル,14,1,15,35.64514,139.71686,2024-02-08 16:46:05
454,N3-17.東中野3丁目,10,0,10,35.70862,139.680679,2024-02-08 16:46:05
455,N2-10.関根ビル,1,4,5,35.733432,139.671241,2024-02-08 16:46:05
456,T1-06.秋の陽公園,2,3,5,35.762326,139.635226,2024-02-08 16:46:05
457,N1-02.鷺宮東駐輪場,0,13,13,35.721556,139.640397,2024-02-08 16:46:05
458,K1-140.西馬込駅前自転車駐車場(奥),1,13,14,35.586382,139.705116,2024-02-08 16:46:05
459,H1-182.錦糸町プライムタワー,14,0,14,35.695695,139.820507,2024-02-08 16:46:05
460,E5-05.駒込地域活動センター,8,0,8,35.728644,139.752183,2024-02-08 16:46:05
461,M3-06.渋谷第一生命ビル,5,1,6,35.657556,139.704129,2024-02-08 16:46:05
462,T2-42.石神井公園駅北第二自転車駐車場,1,4,5,35.74553,139.608939,2024-02-08 16:46:05
463,K1-144.蒲田五丁目44番自転車駐車場,10,0,10,35.559809,139.716993,2024-02-08 16:46:05
464,M3-07.渋谷ファーストプレイス,9,0,9,35.65506,139.69384,2024-02-08 16:46:05
465,H1-74.タダノ教習センター,3,7,10,35.63848,139.832305,2024-02-08 16:46:05
466,H1-151.コスモリード錦糸町,5,3,8,35.701347,139.819973,2024-02-08 16:46:05
467,T2-23.セブン-イレブン 練馬南大泉5丁目店,6,0,6,35.750185,139.579216,2024-02-08 16:46:05
468,M4-13.J-cube,3,0,3,35.66616,139.70458,2024-02-08 16:46:05
469,T2-65.さくらの辻公園,2,2,4,35.734805,139.599906,2024-02-08 16:46:05
470,T2-24.セブン-イレブン 練馬インター店,0,23,23,35.754586,139.606409,2024-02-08 16:46:05
471,O5-05.モンテ・ベルテ,1,1,2,35.701454,139.650518,2024-02-08 16:46:05
472,J1-42.都立大学駅北口バス停前,5,3,8,35.618622,139.67596,2024-02-08 16:46:05
473,K1-97.トミンタワー多摩川二丁目,12,0,12,35.555561,139.704345,2024-02-08 16:46:05
474,D1-14.コモレ四谷,2,0,2,35.68752,139.72818,2024-02-08 16:46:05
475,K1-106.ファミリーマート上池台夫婦坂店,5,3,8,35.599329,139.703343,2024-02-08 16:46:05
476,J1-39.松見坂公園,0,7,7,35.655483,139.687325,2024-02-08 16:46:05
477,J1-40.西小山公園,6,1,7,35.616541,139.697369,2024-02-08 16:46:05
478,J1-38.林試の森公園 北,12,0,12,35.626355,139.700153,2024-02-08 16:46:05
479,I1-84.セブン-イレブン西品川2丁目店,0,0,0,35.613819,139.728418,2024-02-08 16:46:05
480,D6-26.セブン-イレブン新宿６丁目文化センター通り店,9,0,9,35.694951,139.708219,2024-02-08 16:46:05
481,T2-25.ファミリーマート 高野台二丁目店,0,5,5,35.746045,139.620087,2024-02-08 16:46:05
482,I1-85.GOODOFFICE品川,1,2,3,35.621081,139.741178,2024-02-08 16:46:05
483,K1-74.大田スタジアム,3,4,7,35.587423,139.753871,2024-02-08 16:46:05
484,C1-64.東京虎ノ門グローバルスクエア,1,4,5,35.669941,139.749261,2024-02-08 16:46:05
485,K1-72.ファミリーマート大森西四丁目店,0,2,2,35.573358,139.723105,2024-02-08 16:46:05
486,H1-118.ファミリーマート亀戸駅前店,4,6,10,35.69839,139.825484,2024-02-08 16:46:05
487,I1-62.天王洲Rim,2,1,3,35.622277,139.745638,2024-02-08 16:46:05
488,H1-40.深川東京モダン館,3,2,5,35.674076,139.795008,2024-02-08 16:46:05
489,H1-117.東京パークサイドビル,8,1,9,35.671225,139.808561,2024-02-08 16:46:05
490,J1-01.目黒区総合庁舎,9,0,9,35.640675,139.698088,2024-02-08 16:46:05
491,C5-16.品川インターシティ,2,21,23,35.626704,139.742174,2024-02-08 16:46:05
492,A1-12.北の丸スクエア,4,2,6,35.695515,139.750213,2024-02-08 16:46:05
493,H1-46.セブン-イレブン 江東枝川2丁目店,0,0,0,35.659287,139.807358,2024-02-08 16:46:05
494,A2-25.プラウド神田駿河台,6,7,13,35.698991,139.76091,2024-02-08 16:46:05
495,C5-49.プラウドタワー芝浦,6,0,6,35.638912,139.747422,2024-02-08 16:46:05
496,T3-25.北町みのり公園,1,3,4,35.767627,139.65243,2024-02-08 16:46:05
497,H1-75.ジオ深川住吉,8,1,9,35.684247,139.815638,2024-02-08 16:46:05
498,T1-09.ローソン練馬旭町一丁目店,4,1,5,35.765704,139.625178,2024-02-08 16:46:05
499,T2-26.ファミリーマート 大泉学園町四丁目店,0,6,6,35.767388,139.587625,2024-02-08 16:46:05
500,T2-27.ファミリーマート 大泉長久保通り店,4,1,5,35.773841,139.591456,2024-02-08 16:46:05
501,C3-19.明治記念館西,4,0,4,35.678179,139.720809,2024-02-08 16:46:05
502,I1-11.鮫洲入江広場,13,0,13,35.603984,139.744504,2024-02-08 16:46:05
503,I1-10.品川シーサイド公園第1,11,5,16,35.607717,139.749478,2024-02-08 16:46:05
504,I1-09.東品川海上公園第1,5,0,5,35.616633,139.748945,2024-02-08 16:46:05
505,D3-06.セブン-イレブン高田馬場3丁目中央店,0,7,7,35.713872,139.698301,2024-02-08 16:46:05
506,K1-40.大田文化の森,0,2,2,35.579649,139.720263,2024-02-08 16:46:05
507,C1-41.港区立エコプラザ,4,1,5,35.658709,139.757036,2024-02-08 16:46:05
508,I1-13.八潮北公園,0,13,13,35.613421,139.75375,2024-02-08 16:46:05
509,I1-12.しながわ区民公園（北側）,2,2,4,35.596091,139.740884,2024-02-08 16:46:05
510,T2-09.こぐれの森緑地,6,4,10,35.763741,139.588847,2024-02-08 16:46:05
511,T3-31.パークサイド関口,6,2,8,35.74097,139.63836,2024-02-08 16:46:05
512,H1-183.MFLP新木場1,0,6,6,35.643958,139.838358,2024-02-08 16:46:05
513,T2-33.ウインドヒルズ189,2,4,6,35.74642,139.581204,2024-02-08 16:46:05
514,T2-67.陽和病院,0,7,7,35.761211,139.603316,2024-02-08 16:46:05
515,H1-82.セブンｰイレブン 北砂3丁目明治通り店,0,4,4,35.683514,139.827081,2024-02-08 16:46:05
516,T2-60.武蔵関公園（第一）,9,0,9,35.724747,139.565817,2024-02-08 16:46:05
517,I1-48.NTT 東日本 関東病院(北側),4,5,9,35.632191,139.725002,2024-02-08 16:46:05
518,T2-58.立野公園,3,2,5,35.716776,139.577975,2024-02-08 16:46:05
519,I1-100.東急荏原中延駅駐輪場,6,0,6,35.610444,139.712333,2024-02-08 16:46:05
520,T2-56.大泉公園（第一）,2,2,4,35.77228,139.58325,2024-02-08 16:46:05
521,T2-55.大泉町もみじやま公園,2,0,2,35.767296,139.602321,2024-02-08 16:46:05
522,T2-54.土支田農業公園,4,5,9,35.760939,139.609264,2024-02-08 16:46:05
523,I1-44.大井三ツ又商店街入口,7,0,7,35.604606,139.734483,2024-02-08 16:46:05
524,T2-62.大泉井頭公園,6,4,10,35.746681,139.57754,2024-02-08 16:46:05
525,T2-61.武蔵関公園（第二）,4,0,4,35.727826,139.570056,2024-02-08 16:46:05
526,T3-09.学田公園,5,0,5,35.730428,139.648704,2024-02-08 16:46:05
527,K1-105.東糀谷二丁目児童公園,0,6,6,35.555702,139.740802,2024-02-08 16:46:05
528,T3-04.サンパレス平和台,8,4,12,35.759827,139.659121,2024-02-08 16:46:05
529,K1-104.六郷BASE,4,2,6,35.543573,139.714393,2024-02-08 16:46:05
530,M4-16.神宮前6丁目,3,0,3,35.668673,139.702816,2024-02-08 16:46:05
531,K1-69.京急平和島第2Bバイク駐輪場,4,0,4,35.585747,139.735242,2024-02-08 16:46:05
532,H1-155.メブクス豊洲,0,45,45,35.645726,139.784496,2024-02-08 16:46:05
533,C2-11.一の橋,18,34,52,35.654726,139.737491,2024-02-08 16:46:05
534,C4-11.ザ・パークハウス 三田ガーデン,12,0,12,35.64816,139.737991,2024-02-08 16:46:05
535,H1-161.昭文社制作本部ビル,6,0,6,35.684003,139.794983,2024-02-08 16:46:05
536,N2-07.新井区民活動センター,2,3,5,35.714292,139.663327,2024-02-08 16:46:05
537,K1-87.羽田イノベーションシティ,0,11,11,35.547061,139.756277,2024-02-08 16:46:05
538,N3-16.COURT 5,5,0,5,35.699743,139.664608,2024-02-08 16:46:05
539,C4-01.高輪地区総合支所(5F),3,8,11,35.641833,139.734519,2024-02-08 16:46:05
540,C5-48.セブンイレブン港区海岸三丁目店,5,1,6,35.636808,139.752517,2024-02-08 16:46:05
541,H1-42.江東区スポーツ会館,11,7,18,35.683961,139.821559,2024-02-08 16:46:05
542,B2-10.東京ダイヤビルディング（北側）,0,7,7,35.675702,139.785229,2024-02-08 16:46:05
543,H1-43.東京イースト21,0,14,14,35.675639,139.815255,2024-02-08 16:46:05
544,B3-20.歌舞伎座タワー駐輪場2F,4,3,7,35.670106,139.768041,2024-02-08 16:46:05
545,B3-21.歌舞伎座タワー駐輪場3F,9,1,10,35.6701,139.76801,2024-02-08 16:46:05
546,K1-139.プラットホステル京急 羽田ホーム,8,2,10,35.548104,139.748889,2024-02-08 16:46:05
547,J1-58.目黒女子会館前,4,0,4,35.629011,139.69716,2024-02-08 16:46:05
548,T2-18.ファミリーマート練馬西税務署前店,3,1,4,35.745505,139.580878,2024-02-08 16:46:05
549,C3-23.LIFORK 南青山 北エントランス,13,16,29,35.669916,139.725701,2024-02-08 16:46:05
550,C1-46.新虎通りCORE,15,1,16,35.665124,139.754054,2024-02-08 16:46:05
551,C1-45.浜松町クレアタワー,13,0,13,35.656324,139.755927,2024-02-08 16:46:05
552,K1-53.セブン-イレブン 田園調布郵便局前店,20,0,20,35.589309,139.678587,2024-02-08 16:46:05
553,K1-52.大田区総合体育館,6,1,7,35.564152,139.727422,2024-02-08 16:46:05
554,T1-12.ファミリーマート 高松六丁目店,0,5,5,35.756873,139.616612,2024-02-08 16:46:05
555,D7-07.ローソン 新宿西落合三丁目店,3,2,5,35.725171,139.675897,2024-02-08 16:46:05
556,A6-16.一番町第二TGビル,5,0,5,35.688351,139.744321,2024-02-08 16:46:05
557,C3-33.PASONA SQUARE,12,0,12,35.667462,139.716058,2024-02-08 16:46:05
558,A3-24.岩本町ほほえみプラザ,0,2,2,35.69441,139.777715,2024-02-08 16:46:05
559,H1-35.ヒューリック豊洲プライムスクエア,2,3,5,35.652376,139.797724,2024-02-08 16:46:05
560,C5-11.フェイバリッチタワー品川,13,0,13,35.631729,139.749767,2024-02-08 16:46:05
561,E2-13.デルックス文京神楽坂,2,2,4,35.70781,139.732227,2024-02-08 16:46:05
562,C5-01.こうなん星の公園,0,64,64,35.629697,139.742167,2024-02-08 16:46:05
563,C5-02.港南緑水公園,29,0,29,35.628955,139.750731,2024-02-08 16:46:05
564,A3-22.龍閑児童公園,2,1,3,35.693234,139.779702,2024-02-08 16:46:05
565,A3-21.神田ふれあい通り第３,9,3,12,35.695176,139.772832,2024-02-08 16:46:05
566,H1-30.江東区役所（北側）,0,12,12,35.67338,139.8164,2024-02-08 16:46:05
567,C1-17.港区役所,0,7,7,35.657866,139.751068,2024-02-08 16:46:05
568,H1-31.江東区役所（南側）,11,5,16,35.67214,139.8166,2024-02-08 16:46:05
569,C1-09.愛宕グリーンヒルズ,0,10,10,35.662051,139.748132,2024-02-08 16:46:05
570,D1-02.四谷特別出張所（新宿御苑大木戸門前）,13,3,16,35.687435,139.714169,2024-02-08 16:46:05
571,D1-01.花園西公園,4,0,4,35.690612,139.711631,2024-02-08 16:46:05
572,C1-04.虎ノ門ヒルズ,0,17,17,35.666527,139.748804,2024-02-08 16:46:05
573,C1-05.西新橋2丁目（新虎通り）,10,2,12,35.665593,139.752617,2024-02-08 16:46:05
574,C1-73.日比谷フォートタワー,10,4,14,35.669871,139.753147,2024-02-08 16:46:05
575,K1-102.上池台四丁目公園,4,3,7,35.595119,139.6996,2024-02-08 16:46:05
576,M2-01.恵比寿保健相談所（恵比寿社会教育館）,3,4,7,35.64524,139.71946,2024-02-08 16:46:05
577,I1-98.コーポ荏原,4,1,5,35.60411,139.709784,2024-02-08 16:46:05
578,C3-17.セブン-イレブン 港区溜池山王店,0,31,31,35.670308,139.743242,2024-02-08 16:46:05
579,T2-11.石神井松の風文化公園,3,0,3,35.739471,139.595578,2024-02-08 16:46:05
580,M2-03.サイカパーク恵比寿,13,2,15,35.646581,139.710613,2024-02-08 16:46:05
581,M2-02.アメリカ橋公園,6,0,6,35.643606,139.713099,2024-02-08 16:46:05
582,T2-50.North Ridge 吉祥寺,7,2,9,35.72305,139.579555,2024-02-08 16:46:05
583,J1-35.目黒川田道街かど公園,6,0,6,35.634574,139.710332,2024-02-08 16:46:05
584,H1-174.ジュネス(エントランス側),1,0,1,35.682712,139.823961,2024-02-08 16:46:05
585,M6-17.笹塚一丁目駐輪場,6,1,7,35.672922,139.668729,2024-02-08 16:46:05
586,C4-14.神応ほっとプラザ,5,5,10,35.643711,139.724753,2024-02-08 16:46:05
587,K1-107.馬込駅A2出口,7,2,9,35.596854,139.712139,2024-02-08 16:46:05
588,T3-11.ガラクタ公園,1,2,3,35.740321,139.631256,2024-02-08 16:46:05
589,T2-80.みその緑地,3,2,5,35.756825,139.590528,2024-02-08 16:46:05
590,T3-24.AZEST新桜台,5,2,7,35.743962,139.670315,2024-02-08 16:46:05
591,D4-07.新宿余丁町ビル,1,1,2,35.698512,139.716482,2024-02-08 16:46:05
592,T3-01.練馬春日町駅自転車駐車場,5,2,7,35.751438,139.641265,2024-02-08 16:46:05
593,H1-89.BUDDY スポーツアリーナ,0,15,15,35.637041,139.781088,2024-02-08 16:46:05
594,E5-14.上野広小路駅（湯島側）,0,15,15,35.707313,139.771857,2024-02-08 16:46:05
595,H1-109.Brillia ist 東雲キャナルコート東側,3,0,3,35.648008,139.803487,2024-02-08 16:46:05
596,H1-108.Brillia ist 東雲キャナルコート北側,2,0,2,35.648431,139.803125,2024-02-08 16:46:05
597,C1-53.ホテルリブマックス新橋,2,0,2,35.661149,139.754612,2024-02-08 16:46:05
598,D7-10.染の里 おちあい,4,1,5,35.715211,139.689788,2024-02-08 16:46:05
599,A1-15.富士見みらい館,3,0,3,35.697167,139.745629,2024-02-08 16:46:05
600,E4-15.千石4丁目,5,0,5,35.729153,139.741368,2024-02-08 16:46:05
601,H1-111.ファミリーマート木場六丁目店,0,0,0,35.66688,139.80779,2024-02-08 16:46:05
602,C5-36.お台場海浜公園駅,0,2,2,35.62974,139.778178,2024-02-08 16:46:05
603,H1-10.出会い橋,15,0,15,35.625029,139.777344,2024-02-08 16:46:05
604,H1-11.テレコムセンター駅,0,26,26,35.61813,139.778698,2024-02-08 16:46:05
605,H1-47.トピレックプラザ,0,20,20,35.672481,139.835877,2024-02-08 16:46:05
606,H1-13.アーバンドック ららぽーと豊洲,8,11,19,35.654067,139.792376,2024-02-08 16:46:05
607,T2-66.大泉学園町希望ヶ丘公園,0,4,4,35.778605,139.588883,2024-02-08 16:46:05
608,C5-37.台場駅,0,27,27,35.626388,139.772453,2024-02-08 16:46:05
609,H1-16.豊洲三丁目公園,0,31,31,35.657477,139.796629,2024-02-08 16:46:05
610,H1-17.東雲水辺公園,11,1,12,35.64704,139.80469,2024-02-08 16:46:05
611,C1-72.新田町ビル,9,2,11,35.646307,139.746428,2024-02-08 16:46:05
612,K1-98.鵜の木松山公園,3,4,7,35.577433,139.680752,2024-02-08 16:46:05
613,C1-71.芝商業高校前交差点,0,7,7,35.65583,139.759896,2024-02-08 16:46:05
614,H1-122.東砂スポーツセンター,5,7,12,35.679167,139.839746,2024-02-08 16:46:05
615,O6-05.コージーコート久我山,0,5,5,35.687531,139.60439,2024-02-08 16:46:05
616,T2-39.ローソン 練馬大泉町五丁目店,3,5,8,35.758929,139.597548,2024-02-08 16:46:05
617,J1-50.大岡山公園,4,0,4,35.609958,139.684087,2024-02-08 16:46:05
618,J1-51.池尻大橋駅東口駐輪場,2,3,5,35.650627,139.687228,2024-02-08 16:46:05
619,K1-99.東原くすのき公園,7,0,7,35.584086,139.67898,2024-02-08 16:46:05
620,N3-12.桃園区民活動センター,2,1,3,35.702414,139.667327,2024-02-08 16:46:05
621,H1-191.三井リンクラボ新木場2,14,0,14,35.644863,139.831107,2024-02-08 16:46:05
622,M5-09.代々木上原駅前,3,1,4,35.66865,139.679251,2024-02-08 16:46:05
623,O3-09.NTT井草ビル第3ポート,5,2,7,35.714151,139.61693,2024-02-08 16:46:05
624,T1-07.土支田一丁目（笹目通り）,4,6,10,35.765913,139.619285,2024-02-08 16:46:05
625,K1-22.矢口特別出張所,5,0,5,35.562324,139.690486,2024-02-08 16:46:05
626,T3-08.中新井川児童遊園,5,2,7,35.728268,139.649188,2024-02-08 16:46:05
627,H1-78.ローソン新木場一丁目店,10,3,13,35.645604,139.834941,2024-02-08 16:46:05
628,A6-13.番町会館,3,3,6,35.689131,139.733071,2024-02-08 16:46:05
629,H1-71.セブン-イレブン 江東東陽4丁目,0,11,11,35.670906,139.819386,2024-02-08 16:46:05
630,D2-09.セブン-イレブン 新宿岩戸町店,2,0,2,35.700993,139.736355,2024-02-08 16:46:05
631,I1-08.天王洲アイル第一水辺広場,6,24,30,35.622294,139.751644,2024-02-08 16:46:05
632,I1-07.しながわ水族館,15,0,15,35.590641,139.736354,2024-02-08 16:46:05
633,D3-09.西早稲田3丁目,3,1,4,35.712545,139.713319,2024-02-08 16:46:05
634,E1-16.小石川3丁目緑地,18,0,18,35.714338,139.746346,2024-02-08 16:46:05
635,C5-28.芝浦ルネサイトタワー,7,0,7,35.643683,139.7506,2024-02-08 16:46:05
636,I1-59.文庫の森第一,21,0,21,35.612357,139.721484,2024-02-08 16:46:05
637,I1-60.文庫の森第二,5,0,5,35.611368,139.720424,2024-02-08 16:46:05
638,C1-38.KDX西新橋ビル（西側）,2,3,5,35.66495,139.750459,2024-02-08 16:46:05
639,C1-37.KDX西新橋ビル（北側）,2,3,5,35.665218,139.750827,2024-02-08 16:46:05
640,T2-14.NPC24H東大泉第6パーキング,2,4,6,35.747807,139.593599,2024-02-08 16:46:05
641,C3-12.赤坂センタービルディング前（青山通り）,0,11,11,35.676732,139.733905,2024-02-08 16:46:05
642,H1-36.フジゴルフセンター,6,8,14,35.66605,139.806699,2024-02-08 16:46:05
643,C1-27.虎ノ門2丁目タワー,3,10,13,35.668547,139.747175,2024-02-08 16:46:05
644,C5-12.第2東運ビル,4,0,4,35.633742,139.748281,2024-02-08 16:46:05
645,D6-08.新宿イーストサイドスクエア,4,3,7,35.697158,139.707887,2024-02-08 16:46:05
646,A4-08.永代通り（大手町駅B2c出口前）,8,14,22,35.684349,139.766958,2024-02-08 16:46:05
647,H1-37.東雲駅（東京湾岸道路）,31,3,34,35.640618,139.802455,2024-02-08 16:46:05
648,C3-11.赤坂見附南,0,6,6,35.676566,139.737083,2024-02-08 16:46:05
649,M6-04.本町東べんてん橋公園,0,14,14,35.687126,139.680702,2024-02-08 16:46:05
650,I1-79.品川浦第二,13,1,14,35.621904,139.741429,2024-02-08 16:46:05
651,K1-81.コーナン本羽田萩中店,12,0,12,35.549568,139.731093,2024-02-08 16:46:05
652,D6-25.新宿駅東南口自転車駐輪場,23,8,31,35.689755,139.701323,2024-02-08 16:46:05
653,I1-78.セブン-イレブン西大井店,9,2,11,35.601431,139.718659,2024-02-08 16:46:05
654,H1-136.東砂一丁目公園,10,7,17,35.683542,139.839763,2024-02-08 16:46:05
655,A6-23.セブン-イレブン 千代田三番町店,0,8,8,35.689466,139.745316,2024-02-08 16:46:05
656,C5-34.五色橋ビル,0,8,8,35.636644,139.751798,2024-02-08 16:46:05
657,K1-41.郷土博物館,0,10,10,35.588644,139.710413,2024-02-08 16:46:05
658,G2-06.ディアレイシャス押上スカイヴィレッジ,2,3,5,35.71408,139.810588,2024-02-08 16:46:05
659,O3-11.ハイリビング関根,2,6,8,35.707877,139.618926,2024-02-08 16:46:05
660,O7-02.永福中央公園,6,0,6,35.67121,139.64145,2024-02-08 16:46:05
661,K1-29.萩中文化センター,5,3,8,35.55017,139.728146,2024-02-08 16:46:05
662,K1-30.テクノFRONT森ケ崎,0,4,4,35.567922,139.746181,2024-02-08 16:46:05
663,K1-130.COCOONひろば平和島,18,0,18,35.578728,139.735238,2024-02-08 16:46:05
664,H1-81.豊洲IHIビル（北側）,2,19,21,35.659829,139.793243,2024-02-08 16:46:05
665,E4-03.昭和小学校北側（不忍通り）,28,3,31,35.73166,139.748625,2024-02-08 16:46:05
666,C2-12.六本木ファーストビル,8,7,15,35.66249,139.741397,2024-02-08 16:46:05
667,D3-16.セジョリ江戸川橋,10,5,15,35.708734,139.730509,2024-02-08 16:46:05
668,A5-04.日比谷パークフロント前　日比谷公園南面向い歩道上,0,9,9,35.671514,139.753952,2024-02-08 16:46:05
669,C3-22.OMO3東京赤坂 by 星野リゾート,7,1,8,35.674929,139.736053,2024-02-08 16:46:05
670,B1-20.竜閑さくら橋際街角広場,0,28,28,35.688301,139.768958,2024-02-08 16:46:05
671,H1-83.ローソン江東東雲店,8,3,11,35.642165,139.800439,2024-02-08 16:46:05
672,H1-84.NTT東日本辰巳ビル,0,21,21,35.647091,139.817333,2024-02-08 16:46:05
673,C5-26.ピアシティ芝浦ビル,12,0,12,35.644155,139.756216,2024-02-08 16:46:05
674,T3-28.ほしぞら緑地,0,3,3,35.755137,139.661208,2024-02-08 16:46:05
675,I1-88.セブン-イレブン品川南大井3丁目店,2,0,2,35.58768,139.734515,2024-02-08 16:46:05
676,I1-87.セブン-イレブン西大井滝王子通り店,4,0,4,35.599774,139.723467,2024-02-08 16:46:05
677,G4-11.ホテルマイステイズ浅草,21,1,22,35.703972,139.797327,2024-02-08 16:46:05
678,C5-30.フェイム芝浦インターウェーブ,10,0,10,35.647872,139.75391,2024-02-08 16:46:05
679,M6-13.JICA東京,11,1,12,35.673409,139.675203,2024-02-08 16:46:05
680,A4-13.アーバンネット大手町ビル,0,11,11,35.68557,139.766929,2024-02-08 16:46:05
681,B4-27.リバーシティ西ブロック,14,2,16,35.670491,139.784447,2024-02-08 16:46:05
682,K1-143.大森北1丁目,60,0,60,35.584914,139.730504,2024-02-08 16:46:05
683,E5-24.本郷6丁目,5,0,5,35.712445,139.758157,2024-02-08 16:46:05
684,D2-17.genten市ヶ谷店,7,0,7,35.690657,139.73255,2024-02-08 16:46:05
685,A4-14.東京国際フォーラム（有楽町駅ガード側）,3,2,5,35.675739,139.763712,2024-02-08 16:46:05
686,A2-27.丸紅ビル,0,17,17,35.690958,139.759876,2024-02-08 16:46:05
687,K1-135.北千束2丁目,4,2,6,35.608633,139.693653,2024-02-08 16:46:05
688,A1-19.九段会館テラス,1,4,5,35.694065,139.751801,2024-02-08 16:46:05
689,K1-136.BIG FUN 平和島,0,9,9,35.585489,139.740194,2024-02-08 16:46:05
690,K1-137.京浜島つばさ公園,0,16,16,35.571578,139.770532,2024-02-08 16:46:05
691,D1-16.ルネ新宿御苑タワー,0,11,11,35.690155,139.713377,2024-02-08 16:46:05
692,G6-01.オーキッドレジデンス森下,5,0,5,35.692547,139.799231,2024-02-08 16:46:05
693,T2-63.三原台公園,2,5,7,35.751471,139.599835,2024-02-08 16:46:05
694,O4-01.阿佐ヶ谷南公園,2,0,2,35.70328,139.62981,2024-02-08 16:46:05
695,B4-11.ダンスキューブ勝どき,0,4,4,35.656565,139.775073,2024-02-08 16:46:05
696,D1-06.四谷第六小学校北,10,0,10,35.681754,139.715256,2024-02-08 16:46:05
697,T2-64.高野台中央公園,2,1,3,35.746768,139.613885,2024-02-08 16:46:05
698,H1-169.セブンイレブン江東亀戸7丁目東店,7,3,10,35.697157,139.839835,2024-02-08 16:46:05
699,H1-170.セブンイレブン江東亀戸7丁目南店,0,21,21,35.695937,139.838017,2024-02-08 16:46:05
700,B2-16.ホテルサードニクス東京,0,8,8,35.67684,139.77876,2024-02-08 16:46:05
701,I1-93.中央海浜公園前交差点（南側）,4,1,5,35.595498,139.750654,2024-02-08 16:46:05
702,I1-92.中央海浜公園前交差点（北側）,9,1,10,35.595873,139.75134,2024-02-08 16:46:05
703,B1-26.Dash Living Nihonbashi,2,3,5,35.68802,139.78112,2024-02-08 16:46:05
704,H1-158.東京国際交流館,10,2,12,35.621845,139.776833,2024-02-08 16:46:05
705,J1-32.緑が丘駅前高架下,5,2,7,35.606793,139.678372,2024-02-08 16:46:05
706,K1-90.ファミリーマート大田仲池上一丁目店,2,4,6,35.5873,139.701644,2024-02-08 16:46:05
707,K1-91.穴守稲荷神社,0,12,12,35.550027,139.74973,2024-02-08 16:46:05
708,C1-67.京阪神 虎ノ門ビル,12,8,20,35.669228,139.751668,2024-02-08 16:46:05
709,K1-89.ファミリーマート大田千鳥三丁目店,4,1,5,35.572086,139.68708,2024-02-08 16:46:05
710,I1-97.トミンハイム東品川三丁目第二,13,1,14,35.613387,139.749307,2024-02-08 16:46:05
711,T2-51.練馬区役所石神井庁舎,3,7,10,35.743772,139.603317,2024-02-08 16:46:05
712,T2-75.石神井台二丁目緑地,3,0,3,35.734684,139.593628,2024-02-08 16:46:05
713,E5-19.千駄木公園,7,0,7,35.728333,139.757629,2024-02-08 16:46:05
714,E5-18.団子坂上広場,4,7,11,35.724921,139.75903,2024-02-08 16:46:05
715,A5-07.富国生命ビル,0,7,7,35.670452,139.75557,2024-02-08 16:46:05
716,H1-156.つどい橋下,0,10,10,35.630791,139.787396,2024-02-08 16:46:05
717,H1-159.夢の大橋西,14,2,16,35.627599,139.782953,2024-02-08 16:46:05
718,H1-143.ダイバーシティ東京 プラザ,9,1,10,35.624619,139.776006,2024-02-08 16:46:05
719,I1-57.大井水神公園,46,27,73,35.589972,139.729368,2024-02-08 16:46:05
720,B2-15.KABUTO ONE,0,18,18,35.68168,139.77825,2024-02-08 16:46:05
721,K1-64.多摩川グリーンスクエア,3,5,8,35.545459,139.719489,2024-02-08 16:46:05
722,T2-57.大泉公園（第二）,5,1,6,35.771708,139.583551,2024-02-08 16:46:05
723,A4-06.大手町ファーストスクエア,0,23,23,35.686037,139.764472,2024-02-08 16:46:05
724,C1-50.NTT虎ノ門ビル,9,5,14,35.666075,139.748008,2024-02-08 16:46:05
725,C1-23.三田いきいきプラザ,10,0,10,35.648637,139.749834,2024-02-08 16:46:05
726,H1-29.スカイズタワー＆ガーデン,3,0,3,35.647618,139.792152,2024-02-08 16:46:05
727,C1-21.汐留ビルディング,5,5,10,35.657363,139.75918,2024-02-08 16:46:05
728,A3-16.地蔵橋東児童遊園,4,2,6,35.691069,139.775376,2024-02-08 16:46:05
729,A3-18.美倉橋北児童遊園,2,0,2,35.69703,139.779928,2024-02-08 16:46:05
730,A4-01.丸ビル（南側駐輪場）,6,5,11,35.680514,139.764002,2024-02-08 16:46:05
731,A3-11.練成公園,2,6,8,35.703735,139.770629,2024-02-08 16:46:05
732,A3-10.芳林公園（北側）,1,4,5,35.701978,139.7698,2024-02-08 16:46:05
733,A6-02.いきいきプラザ一番町（西側駐輪場）,8,0,8,35.687031,139.739327,2024-02-08 16:46:05
734,A6-01.東郷元帥記念公園（南側）,4,1,5,35.689879,139.740178,2024-02-08 16:46:05
735,A5-03.参議院第二別館（永田町駅2番出口）,10,4,14,35.677763,139.74271,2024-02-08 16:46:05
736,A4-03.東京国際フォーラム（メトロD5出口）,5,0,5,35.675843,139.763329,2024-02-08 16:46:05
737,K1-15.セブン‐イレブン 大田区西蒲田店,1,2,3,35.56694,139.716331,2024-02-08 16:46:05
738,K1-49.ローソン仲池上一丁目店,8,0,8,35.586585,139.698552,2024-02-08 16:46:05
739,A2-06.東光電気工事 別館（屋内駐輪場）,5,2,7,35.69919,139.75701,2024-02-08 16:46:05
740,M4-01.新宿タカシマヤ,1,4,5,35.68714,139.702775,2024-02-08 16:46:05
741,M4-03.NTTドコモ代々木ビル,6,3,9,35.684451,139.702884,2024-02-08 16:46:05
742,M3-03.代官山 T-SITE,0,8,8,35.649823,139.700139,2024-02-08 16:46:05
743,K1-14.大森地域庁舎,2,2,4,35.578239,139.723262,2024-02-08 16:46:05
744,C5-46.ウエリスアーバン品川タワー,11,0,11,35.630961,139.746875,2024-02-08 16:46:05
745,C4-13.コシダコネクトビル,5,7,12,35.637765,139.739128,2024-02-08 16:46:05
746,K1-127.第二石井ビル,1,4,5,35.559286,139.722611,2024-02-08 16:46:05
747,C1-74.札の辻スクエア,4,1,5,35.645155,139.744543,2024-02-08 16:46:05
748,H1-164.森下三丁目第三児童遊園,15,1,16,35.68546,139.80244,2024-02-08 16:46:05
749,C1-78.CIRCLES新橋,8,1,9,35.66646,139.752138,2024-02-08 16:46:05
750,C3-34.3rd MINAMI AOYAMA,2,4,6,35.668622,139.715957,2024-02-08 16:46:05
751,O4-06.杉並区役所本庁舎,2,3,5,35.699328,139.636343,2024-02-08 16:46:05
752,D3-14.コーシャハイム高田馬場,6,0,6,35.712413,139.70168,2024-02-08 16:46:05
753,D7-11.新宿清掃事務所,4,2,6,35.716359,139.704377,2024-02-08 16:46:05
754,D5-08.ウエリス新宿早稲田の森,0,8,8,35.704597,139.708397,2024-02-08 16:46:05
755,E2-12.水道2丁目,5,1,6,35.709147,139.739183,2024-02-08 16:46:05
756,M6-10.京王コインパーク幡ヶ谷,3,0,3,35.6772,139.678117,2024-02-08 16:46:05
757,E3-05.文京スポーツセンター,44,15,59,35.721045,139.735687,2024-02-08 16:46:05
758,J1-36.WJ Haus,3,1,4,35.629067,139.711779,2024-02-08 16:46:05
759,K1-51.テクノポートカマタ 第2,5,6,11,35.555808,139.722791,2024-02-08 16:46:05
760,D1-13.新宿御苑新宿門【西側】,0,22,22,35.688945,139.706536,2024-02-08 16:46:05
761,I1-31.セブン-イレブン 品川戸越5丁目店,6,0,6,35.608193,139.719139,2024-02-08 16:46:05
762,T3-27.貫井川緑地,1,2,3,35.738427,139.632251,2024-02-08 16:46:05
763,H1-147.大島四丁目団地,13,3,16,35.68744,139.827075,2024-02-08 16:46:05
764,O4-02.成宗さくら公園,2,0,2,35.69638,139.63482,2024-02-08 16:46:05
765,O1-01.上瀬戸公園,2,2,4,35.72077,139.6045,2024-02-08 16:46:05
766,T2-15.NPC24H大泉学園南口パーキング,0,9,9,35.748611,139.584251,2024-02-08 16:46:05
767,O3-03.桃井1丁目5番地,7,0,7,35.71013,139.61194,2024-02-08 16:46:05
768,H1-08.東京テレポート駅,11,27,38,35.627087,139.779779,2024-02-08 16:46:05
769,H1-05.相鉄グランドフレッサ 東京ベイ有明,8,6,14,35.632148,139.79017,2024-02-08 16:46:05
770,H1-06.武蔵野大学,0,18,18,35.630185,139.786618,2024-02-08 16:46:05
771,A4-15.TOKIWAブリッジ,0,16,16,35.686389,139.769237,2024-02-08 16:46:05
772,H1-160.花の広場,0,17,17,35.633908,139.793322,2024-02-08 16:46:05
773,H1-01.豊洲ＩＨＩビル前（晴海通り）,0,11,11,35.658911,139.792531,2024-02-08 16:46:05
774,H1-02.豊洲駅,0,63,63,35.654196,139.79626,2024-02-08 16:46:05
775,J1-19.NTT東日本自由が丘ビル,3,1,4,35.615098,139.675954,2024-02-08 16:46:05
776,C2-19.広尾駅,5,0,5,35.650732,139.72256,2024-02-08 16:46:05
777,H1-114.東京夢の島マリーナ,5,9,14,35.651987,139.830691,2024-02-08 16:46:05
778,K1-71.ファミリーマート大田大森南店,2,2,4,35.562769,139.74327,2024-02-08 16:46:05
779,J1-20.すずめのお宿緑地公園,5,3,8,35.617773,139.685351,2024-02-08 16:46:05
780,H1-115.東京夢の島マリーナ 第4駐車場,2,12,14,35.650235,139.835993,2024-02-08 16:46:05
781,M5-10.富ヶ谷2丁目,17,0,17,35.665961,139.686491,2024-02-08 16:46:05
782,J1-21.中央緑地公園,3,1,4,35.630694,139.690482,2024-02-08 16:46:05
783,H1-116.出会い橋高架下,27,22,49,35.625037,139.777646,2024-02-08 16:46:05
784,M3-12.渋谷南東急ビル,3,4,7,35.656228,139.706284,2024-02-08 16:46:05
785,T2-01.大泉学園駅北口,0,3,3,35.749918,139.58618,2024-02-08 16:46:05
786,K1-06.大森駅入新井自転車駐車場,4,1,5,35.585269,139.726279,2024-02-08 16:46:05
787,D6-06.新宿中央公園（エコギャラリー下）,0,18,18,35.691199,139.687966,2024-02-08 16:46:05
788,D6-14.新宿ファーストウエスト,9,5,14,35.689529,139.695995,2024-02-08 16:46:05
789,D6-15.住友不動産西新宿ビル,8,3,11,35.69465,139.695911,2024-02-08 16:46:05
790,H1-56.南砂三丁目緑地公園西,0,21,21,35.672361,139.829825,2024-02-08 16:46:05
791,T2-74.扇橋公園,3,2,5,35.731791,139.588844,2024-02-08 16:46:05
792,B2-20.SHビル,3,0,3,35.675398,139.779962,2024-02-08 16:46:05
793,I1-17.東品川海上公園第2,10,0,10,35.616364,139.749171,2024-02-08 16:46:05
794,I1-16.品川浦,14,0,14,35.6214,139.741958,2024-02-08 16:46:05
795,A4-11.二重橋前駅(メトロ4番出口),3,2,5,35.680753,139.762069,2024-02-08 16:46:05
796,H1-76.有明物流センター,12,7,19,35.638571,139.78829,2024-02-08 16:46:05
797,K1-43.北馬込わくわく公園,0,5,5,35.600707,139.703216,2024-02-08 16:46:05
798,K1-42.馬込西公園,12,2,14,35.58849,139.70376,2024-02-08 16:46:05
799,T1-08.セブン-イレブン 練馬高松6丁目店,3,1,4,35.756506,139.620347,2024-02-08 16:46:05
800,T2-17.ファミリーマート 練馬石神井町八丁目店,0,4,4,35.74755,139.597968,2024-02-08 16:46:05
801,K1-31.テクノWING,0,9,9,35.546252,139.731708,2024-02-08 16:46:05
802,K1-32.石川町文化センター,5,0,5,35.601958,139.682876,2024-02-08 16:46:05
803,I1-20.しおじ公園,16,4,20,35.59632,139.751279,2024-02-08 16:46:05
804,I1-19.品川シーサイド公園第2,6,1,7,35.607571,139.749108,2024-02-08 16:46:05
805,J1-29.カスタリア目黒鷹番,3,1,4,35.626121,139.688576,2024-02-08 16:46:05
806,H1-127.古石場川親水公園,9,11,20,35.669291,139.795364,2024-02-08 16:46:05
807,D4-05.カスタリア新宿7丁目,0,12,12,35.700732,139.711472,2024-02-08 16:46:05
808,I1-71.セブン-イレブン南大井浜川店,4,0,4,35.596483,139.7355,2024-02-08 16:46:05
809,I1-72.セブン-イレブン大井店,5,0,5,35.600081,139.728193,2024-02-08 16:46:05
810,T3-21.くまのやま緑地,4,1,5,35.747038,139.667965,2024-02-08 16:46:05
811,K1-110.萩中集会所裏,11,3,14,35.550479,139.739538,2024-02-08 16:46:05
812,O2-02.シエール荻窪,30,0,30,35.708265,139.612703,2024-02-08 16:46:05
813,H1-128.豊洲市場（5街区）,15,19,34,35.645162,139.785386,2024-02-08 16:46:05
814,N1-09.若宮レジデンス,2,3,5,35.716184,139.643905,2024-02-08 16:46:05
815,M6-12.LIVART SEASON 幡ヶ谷,2,1,3,35.683156,139.67338,2024-02-08 16:46:05
816,H1-142.東京ベイ潮見プリンスホテル,10,1,11,35.660632,139.817294,2024-02-08 16:46:05
817,G1-01.鐘ヶ淵駅南自転車駐車場,2,7,9,35.732291,139.82012,2024-02-08 16:46:05
818,M1-01.渋谷区役所,1,6,7,35.66362,139.69801,2024-02-08 16:46:05
819,I1-83.かもめ歩道橋,0,14,14,35.600161,139.749902,2024-02-08 16:46:05
820,N4-05.セブン-イレブン中野鍋横店,3,2,5,35.693815,139.668571,2024-02-08 16:46:05
821,D4-02.JICA市ヶ谷ビル（地球ひろば／研究所）,5,1,6,35.694927,139.731328,2024-02-08 16:46:05
822,T3-19.なかみや児童遊園,1,4,5,35.749388,139.651824,2024-02-08 16:46:05
823,N1-08.上鷺自転車保管場所,2,5,7,35.729056,139.627864,2024-02-08 16:46:05
824,O7-06.松木1丁目,2,11,13,35.686015,139.642784,2024-02-08 16:46:05
825,E4-16.ビレッジワン,6,1,7,35.723723,139.740143,2024-02-08 16:46:05
826,D1-15.フロンティア四谷,4,3,7,35.68768,139.71937,2024-02-08 16:46:05
827,K1-128.大森西3丁目,11,1,12,35.571975,139.732137,2024-02-08 16:46:05
828,N1-06.大和区民活動センター,3,2,5,35.713562,139.649075,2024-02-08 16:46:05
829,G4-01.両国ビューホテル1,0,7,7,35.69566,139.79214,2024-02-08 16:46:05
830,G4-02.両国ビューホテル2,5,2,7,35.69562,139.79206,2024-02-08 16:46:05
831,G4-05.両国駅西口臨時自転車駐車場,17,3,20,35.698588,139.792946,2024-02-08 16:46:05
832,G4-03.本所1-6-5,10,3,13,35.702525,139.796632,2024-02-08 16:46:05
833,G5-01.牡丹橋自転車駐車場,16,1,17,35.693059,139.813417,2024-02-08 16:46:05
834,G5-02.横川3-7-10,18,19,37,35.70378,139.814298,2024-02-08 16:46:05
835,G4-04.NTTドコモ墨田ビル,16,5,21,35.697898,139.795345,2024-02-08 16:46:05
836,G2-02.押上1-23-8,3,5,8,35.710111,139.81488,2024-02-08 16:46:05
837,C5-13.区立芝浦西運河沿緑地,39,0,39,35.638245,139.749754,2024-02-08 16:46:05
838,D6-12.東京ビジネスホテル,0,2,2,35.69342,139.710568,2024-02-08 16:46:05
839,D6-11.ホテルリステル新宿,0,3,3,35.693029,139.711327,2024-02-08 16:46:05
840,D6-10.ホテルサンライト新宿,2,1,3,35.694201,139.707047,2024-02-08 16:46:05
841,H1-39.辰巳駅東口自転車駐車場,16,9,25,35.645823,139.812178,2024-02-08 16:46:05
842,H1-38.辰巳駅西口自転車駐車場,89,0,89,35.646857,139.808912,2024-02-08 16:46:05
843,C2-10.元麻布三丁目,3,4,7,35.655865,139.730566,2024-02-08 16:46:05
844,C2-09.麻布地区総合支所,0,3,3,35.660614,139.734771,2024-02-08 16:46:05
845,M3-20.東急ステイ渋谷新南口,8,0,8,35.65494,139.70534,2024-02-08 16:46:05
846,I1-86.ファミリーマート二葉三丁目店,0,5,5,35.601694,139.719778,2024-02-08 16:46:05
847,A2-23.axle御茶ノ水,6,1,7,35.696126,139.763297,2024-02-08 16:46:05
848,C4-02.白金台いきいきプラザ,2,2,4,35.63756,139.724981,2024-02-08 16:46:05
849,N3-04.東中野駅地下駐輪場,0,24,24,35.707883,139.683284,2024-02-08 16:46:05
850,N3-05.中野坂上駅地下駐輪場,0,5,5,35.698068,139.682781,2024-02-08 16:46:05
851,N3-03.青桐公園,0,13,13,35.697024,139.677846,2024-02-08 16:46:05
852,N3-01.中野四季の森公園,0,15,15,35.708487,139.662135,2024-02-08 16:46:05
853,N4-01.本四公園,5,4,9,35.69693,139.672721,2024-02-08 16:46:05
854,N4-02.栄町公園,7,0,7,35.686474,139.671383,2024-02-08 16:46:05
855,K1-57.池上本門寺,6,0,6,35.579585,139.705377,2024-02-08 16:46:05
856,C1-49.汐留シティセンター,1,9,10,35.666213,139.760907,2024-02-08 16:46:05
857,C4-15.クロスレジデンス白金高輪,0,13,13,35.642771,139.733046,2024-02-08 16:46:05
858,K1-56.NTT馬込ビル,2,2,4,35.588106,139.718852,2024-02-08 16:46:05
859,J1-41.CASSIA目黒,5,1,6,35.631319,139.70237,2024-02-08 16:46:05
860,A2-22.専修大学,5,1,6,35.696147,139.753709,2024-02-08 16:46:05
861,T3-20.はやいち公園,2,2,4,35.75312,139.65661,2024-02-08 16:46:05
862,B3-19.本の森ちゅうおう,8,2,10,35.67363,139.77623,2024-02-08 16:46:05
863,K1-86.IMPREST STAY TOKYO 蒲田,20,2,22,35.556267,139.727246,2024-02-08 16:46:05
864,T3-23.氷川台二丁目緑地,3,1,4,35.756575,139.669689,2024-02-08 16:46:05
865,T3-22.氷川台三丁目ちびっこ公園,2,1,3,35.750547,139.66707,2024-02-08 16:46:05
866,B1-23.NANAEI日本橋,0,5,5,35.679616,139.784341,2024-02-08 16:46:05
867,B2-11.京橋エドグラン,0,14,14,35.677576,139.769822,2024-02-08 16:46:05
868,N1-05.大野ハイツ,1,4,5,35.7266,139.62948,2024-02-08 16:46:05
869,B2-09.茅場町一丁目平和ビル,1,8,9,35.680203,139.778679,2024-02-08 16:46:05
870,B2-08.共同ビル（茅場町交差点前）,2,7,9,35.681012,139.778569,2024-02-08 16:46:05
871,B2-07.東京証券会館（北側）,0,1,1,35.680864,139.779331,2024-02-08 16:46:05
872,O3-12.大宮前体育館,2,1,3,35.696567,139.610517,2024-02-08 16:46:05
873,B1-08.明治座,0,2,2,35.688038,139.786561,2024-02-08 16:46:05
874,B4-05.ドコモ・バイクシェア晴海ポート,0,33,33,35.654165,139.781568,2024-02-08 16:46:05
875,B4-04.ＫＤＸ晴海ビル,0,0,0,35.65443,139.77843,2024-02-08 16:46:05
876,B4-03.桜の散歩道（晴海トリトンスクエア前）,0,19,19,35.658665,139.782553,2024-02-08 16:46:05
877,E5-08.セブン-イレブン 文京動坂上店,5,0,5,35.727778,139.756296,2024-02-08 16:46:05
878,H1-65.ローソン南砂日曹橋店,12,2,14,35.669507,139.825553,2024-02-08 16:46:05
879,H1-66.中川船番所資料館,6,2,8,35.687732,139.846383,2024-02-08 16:46:05
880,K1-113.ファミリーマート大田上池台四丁目店,4,2,6,35.594658,139.700133,2024-02-08 16:46:05
881,H1-64.ローソン東雲駅前店,6,4,10,35.640228,139.804267,2024-02-08 16:46:05
882,E1-11.小石川運動場前,9,6,15,35.703914,139.747061,2024-02-08 16:46:05
883,T2-70.三ツ塚けやき緑地,2,2,4,35.720318,139.570762,2024-02-08 16:46:05
884,H1-137.住友不動産ショッピングシティ有明ガーデン,18,0,18,35.638985,139.793653,2024-02-08 16:46:05
885,C5-40.芝浦ふ頭駅前暫定自転車駐車場,0,1,1,35.64096,139.75754,2024-02-08 16:46:05
886,M3-21.渋谷ソラスタ,10,2,12,35.65618,139.69612,2024-02-08 16:46:05
887,D7-03.中井駅北,23,6,29,35.715645,139.687486,2024-02-08 16:46:05
888,K1-119.シーンズ大森パークサイド,4,0,4,35.58223,139.72763,2024-02-08 16:46:05
889,M6-15.cova Hatagaya,0,2,2,35.67741,139.67383,2024-02-08 16:46:05
890,C2-25.アパホテル＆リゾート＜六本木駅東＞,37,6,43,35.661783,139.737242,2024-02-08 16:46:05
891,D4-10.東新宿ポート(余丁町6番),5,0,5,35.696585,139.713081,2024-02-08 16:46:05
892,O1-02.井荻南地下自転車駐車場,5,9,14,35.72424,139.61431,2024-02-08 16:46:05
893,O1-03.LUCKY HOUSE,1,3,4,35.72489,139.62383,2024-02-08 16:46:05
894,D6-30.京王プラザホテル,6,1,7,35.6897,139.694823,2024-02-08 16:46:05
895,D6-29.都庁第二本庁舎前,11,2,13,35.688735,139.692249,2024-02-08 16:46:05
896,O3-02.アートメゾン荻窪,6,2,8,35.71355,139.6199,2024-02-08 16:46:05
897,J1-57.トレインチ自由が丘,4,0,4,35.606667,139.667324,2024-02-08 16:46:05
898,O2-01.サカエフラット荻窪,10,1,11,35.70535,139.61497,2024-02-08 16:46:05
899,O3-01.西田公園,4,2,6,35.69575,139.62065,2024-02-08 16:46:05
900,K1-47.NTT雪ヶ谷ビル,10,0,10,35.598601,139.684747,2024-02-08 16:46:05
901,O7-04.永福町西幸モータープール西,7,1,8,35.67161,139.64527,2024-02-08 16:46:05
902,K1-48.ファミリーマート大田上池台三丁目店,0,5,5,35.590934,139.696915,2024-02-08 16:46:05
903,K1-111.本羽田公園,7,0,7,35.546499,139.736761,2024-02-08 16:46:05
904,C1-58.ウォーターズ竹芝,2,7,9,35.655937,139.763251,2024-02-08 16:46:05
905,K1-109.萩中公園プール駐輪場,8,0,8,35.549323,139.737091,2024-02-08 16:46:05
906,K1-108.仲江名公園,3,1,4,35.557999,139.732564,2024-02-08 16:46:05
907,E1-17.小石川パークスクエア,9,0,9,35.713913,139.745416,2024-02-08 16:46:05
908,D6-23.アパホテル 東新宿 歌舞伎町西,0,1,1,35.697535,139.703633,2024-02-08 16:46:05
909,H1-98.洲崎川緑道公園,4,1,5,35.668705,139.810549,2024-02-08 16:46:05
910,H1-99.南砂三丁目公園,15,8,23,35.669695,139.831874,2024-02-08 16:46:05
911,H1-96.越中島公園,0,15,15,35.668757,139.790156,2024-02-08 16:46:05
912,H1-97.浜園公園,5,1,6,35.661852,139.802224,2024-02-08 16:46:05
913,H1-94.新木場一丁目緑地公園,1,7,8,35.64423,139.835823,2024-02-08 16:46:05
914,H1-95.若洲公園,5,19,24,35.619451,139.834429,2024-02-08 16:46:05
915,J1-09.ファミリーマート佐野久下目黒店,4,0,4,35.629252,139.712716,2024-02-08 16:46:05
916,H1-93.新木場一丁目公園,0,15,15,35.64143,139.835455,2024-02-08 16:46:05
917,I1-55.鈴ヶ森公園,7,0,7,35.593559,139.734704,2024-02-08 16:46:05
918,O6-04.柏の宮公園,1,4,5,35.67834,139.62711,2024-02-08 16:46:05
919,B4-14.Brillia ist Tower 勝どき,11,0,11,35.660526,139.776816,2024-02-08 16:46:05
920,D7-08.上落合3丁目,0,15,15,35.71115,139.68232,2024-02-08 16:46:05
921,H1-21.UR東雲キャナルコート,2,1,3,35.646041,139.804495,2024-02-08 16:46:05
922,H1-20.日本科学未来館,21,9,30,35.619377,139.777582,2024-02-08 16:46:05
923,H1-19.UR豊洲四丁目団地,20,0,20,35.653603,139.80144,2024-02-08 16:46:05
924,T2-45.風致地区バス停第三自転車駐車場,2,5,7,35.771068,139.586798,2024-02-08 16:46:05
925,H1-33.深川ギャザリア（ウエストスクエア）,6,3,9,35.66789,139.803,2024-02-08 16:46:05
926,H1-32.区営塩浜住宅前,18,0,18,35.664591,139.813954,2024-02-08 16:46:05
927,H1-23.KDX豊洲グランスクエア,6,5,11,35.648085,139.798986,2024-02-08 16:46:05
928,C2-22.飯倉公園,9,0,9,35.655649,139.74427,2024-02-08 16:46:05
929,I1-89.下神明駅自転車駐車場,5,0,5,35.608402,139.726118,2024-02-08 16:46:05
930,C5-39.お台場海浜公園東,11,2,13,35.631021,139.778109,2024-02-08 16:46:05
931,C5-38.お台場海浜公園乗船場,0,18,18,35.628743,139.773915,2024-02-08 16:46:05
932,O4-08.ローソン阿佐ヶ谷青梅街道店,0,5,5,35.703203,139.62804,2024-02-08 16:46:05
933,T2-72.高塚南緑地,5,1,6,35.733132,139.570311,2024-02-08 16:46:05
934,O6-03.みなみ荘,5,5,10,35.68073,139.62803,2024-02-08 16:46:05
935,K1-129.ローソン東糀谷一丁目店,0,7,7,35.557427,139.739126,2024-02-08 16:46:05
936,E1-03.東京ドーム（黄色いビル横）,8,0,8,35.70319,139.751888,2024-02-08 16:46:05
937,K1-23.大田区役所本庁舎前,5,1,6,35.561183,139.716339,2024-02-08 16:46:05
938,T2-78.北大泉くれはし公園,2,1,3,35.761474,139.592735,2024-02-08 16:46:05
939,J1-53.ボヌールAllamanda,3,2,5,35.612833,139.675047,2024-02-08 16:46:05
940,A3-39.トーシン東神田ビル,1,3,4,35.694834,139.780333,2024-02-08 16:46:05
941,O6-01.高井戸みどり公園,5,4,9,35.67912,139.61074,2024-02-08 16:46:05
942,T2-79.大泉学園町八丁目緑地,5,1,6,35.774457,139.596182,2024-02-08 16:46:05
943,O5-04.リヴィエール,18,2,20,35.70104,139.65839,2024-02-08 16:46:05
944,N3-08.中野区役所(西側),0,6,6,35.707968,139.663519,2024-02-08 16:46:05
945,I1-99.北品川２丁目,3,0,3,35.61663,139.74192,2024-02-08 16:46:05
946,P1-01.サンシャインシティ,5,2,7,35.728846,139.718577,2024-02-08 16:46:05
947,N3-14.ヴィラソンサ落合,0,6,6,35.713227,139.680966,2024-02-08 16:46:05
948,H1-49.セブン-イレブン 江東新砂３丁目店,0,19,19,35.667892,139.8311,2024-02-08 16:46:05
949,I1-06.大森貝塚遺跡庭園,9,0,9,35.593489,139.72967,2024-02-08 16:46:05
950,M2-12.恵比寿プライムスクエアタワー北,8,0,8,35.650541,139.713361,2024-02-08 16:46:05
951,H1-69.ファミリーマート 江東石島店,1,5,6,35.680474,139.812316,2024-02-08 16:46:05
952,B3-09.築地永谷コーポラス,9,2,11,35.66523,139.776313,2024-02-08 16:46:05
953,E4-10.白山四丁目第二児童遊園横,7,2,9,35.720349,139.746924,2024-02-08 16:46:05
954,I1-03.大井町駅中央口（西側）,3,3,6,35.605617,139.73472,2024-02-08 16:46:05
955,I1-04.大井町歩道橋,4,1,5,35.605146,139.734694,2024-02-08 16:46:05
956,I1-01.品川区役所 本庁舎前,10,0,10,35.609052,139.729825,2024-02-08 16:46:05
957,I1-02.品川区役所 第三庁舎前,9,0,9,35.608161,139.730048,2024-02-08 16:46:05
958,G4-08.ブオンサンヴァレンティーノ,6,0,6,35.691677,139.793857,2024-02-08 16:46:05
959,J1-13.洗足二丁目駐輪場,13,4,17,35.61061,139.693443,2024-02-08 16:46:05
960,J1-16.八雲橋自転車置場,2,1,3,35.617353,139.672256,2024-02-08 16:46:05
961,H1-189.MFLP新木場2,0,45,45,35.634453,139.824,2024-02-08 16:46:05
962,M6-09.ファミリーマート渋谷本町店,0,1,1,35.683756,139.684965,2024-02-08 16:46:05
963,H1-113.123+N東雲店,23,0,23,35.646366,139.801492,2024-02-08 16:46:05
964,J1-17.ファミリーマート原町二丁目店,3,3,6,35.613902,139.691476,2024-02-08 16:46:05
965,E5-21.動坂公園,11,0,11,35.73176,139.756669,2024-02-08 16:46:05
966,E5-20.本郷2丁目,0,6,6,35.704391,139.758575,2024-02-08 16:46:05
967,T2-48.武蔵関駅南第二自転車駐車場,2,2,4,35.726064,139.578015,2024-02-08 16:46:05
968,A6-26.相互半蔵門ビル,10,1,11,35.683378,139.743189,2024-02-08 16:46:05
969,J1-31.守屋図書館,16,4,20,35.634194,139.688833,2024-02-08 16:46:05
970,M3-19.渋谷キャスト,14,7,21,35.662146,139.702793,2024-02-08 16:46:05
971,N1-04.都立家政南駐輪場,0,7,7,35.721679,139.645265,2024-02-08 16:46:05
972,N2-02.江古田1丁目A,1,2,3,35.724988,139.672511,2024-02-08 16:46:05
973,C1-56.鈴与竹芝ビル,0,7,7,35.654873,139.762103,2024-02-08 16:46:05
974,D3-07.戸塚特別出張所,2,3,5,35.71429,139.70507,2024-02-08 16:46:05
975,G4-12.プレミアムキューブ両国,6,0,6,35.70103,139.803341,2024-02-08 16:46:05
976,A2-21.神田神保町3丁目,5,1,6,35.694578,139.754434,2024-02-08 16:46:05
977,B4-19.コーシャタワー佃,0,3,3,35.668044,139.785801,2024-02-08 16:46:05
978,I1-81.戸越6丁目,20,0,20,35.608127,139.717865,2024-02-08 16:46:05
979,A6-24.国立劇場,0,15,15,35.682218,139.743292,2024-02-08 16:46:05
980,E5-23.ビレッジ千駄木,2,4,6,35.722353,139.760966,2024-02-08 16:46:05
981,H1-119.榎戸材木店,0,24,24,35.638319,139.834741,2024-02-08 16:46:05
982,C5-29.Hi-NODE(ハイノード),7,1,8,35.651672,139.760549,2024-02-08 16:46:05
983,J1-22.NTTコミュニケーションズ唐ヶ崎ビル,3,0,3,35.627373,139.692044,2024-02-08 16:46:05
984,A2-18.猿楽町SSビル東,4,1,5,35.698654,139.759762,2024-02-08 16:46:05
985,A2-19.猿楽町SSビル西,3,0,3,35.698641,139.759306,2024-02-08 16:46:05
986,C1-55.アーバンネット内幸町ビル,16,2,18,35.669267,139.756018,2024-02-08 16:46:05
987,D4-06.グリーンフォート河田,0,8,8,35.697143,139.718739,2024-02-08 16:46:05
988,K1-134.東調布公園,10,0,10,35.588363,139.69042,2024-02-08 16:46:05
989,M5-18.Luxe初台,5,0,5,35.679182,139.68596,2024-02-08 16:46:05
990,D7-06.エムアイセミナーハウス,5,0,5,35.721064,139.677128,2024-02-08 16:46:05
991,A3-37.ポータル秋葉原,0,2,2,35.695737,139.78162,2024-02-08 16:46:05
992,M5-11.あおい通り,4,3,7,35.688154,139.698975,2024-02-08 16:46:05
993,E5-04.保健サービスセンター本郷支所,5,0,5,35.727046,139.760439,2024-02-08 16:46:05
994,E5-03.汐見地域活動センター（本郷図書館）,1,3,4,35.725538,139.76116,2024-02-08 16:46:05
995,E5-01.文京総合体育館,24,6,30,35.708121,139.763583,2024-02-08 16:46:05
996,E4-01.千石南自転車駐車場,14,11,25,35.72707,139.746112,2024-02-08 16:46:05
997,E3-03.大塚公園,6,15,21,35.724286,139.730954,2024-02-08 16:46:05
998,E3-02.教育の森公園,11,6,17,35.719345,139.736198,2024-02-08 16:46:05
999,I1-25.セブン-イレブン 品川旗の台2丁目店,1,1,2,35.607084,139.705007,2024-02-08 16:46:05
1000,B1-21.日本橋二丁目街角広場,2,8,10,35.680861,139.774493,2024-02-08 16:46:05
1001,C3-30.東京赤坂NKビル (ヴィアインプライム赤坂),7,2,9,35.672652,139.738908,2024-02-08 16:46:05
1002,A3-36.クロックカフェ東神田,0,5,5,35.694943,139.782718,2024-02-08 16:46:05
1003,E1-14.いきいき礫川,5,3,8,35.711147,139.747386,2024-02-08 16:46:05
1004,D4-09.トミンハイム仲之町,0,5,5,35.69617,139.722021,2024-02-08 16:46:05
1005,L1-08.NTT砧ビル,1,5,6,35.63534,139.601602,2024-02-08 16:46:05
1006,L1-09.コージーK・駒沢,2,1,3,35.632689,139.654804,2024-02-08 16:46:05
1007,L1-10.宮坂2-4-10,0,7,7,35.652913,139.644825,2024-02-08 16:46:05
1008,I1-22.ウィラ大井 (ショッピングモール),0,4,4,35.596579,139.745009,2024-02-08 16:46:05
1009,K1-76.グリーンベルト,7,2,9,35.585178,139.726339,2024-02-08 16:46:05
1010,H1-121.南砂5丁目,0,15,15,35.676603,139.829736,2024-02-08 16:46:05
1011,M3-02.文化総合センター大和田,4,1,5,35.65558,139.69966,2024-02-08 16:46:05
1012,D4-04.ジェノヴィア新宿早稲田グリーンヴェール,4,0,4,35.700033,139.71983,2024-02-08 16:46:05
1013,A3-20.神田ふれあい通り第２,0,2,2,35.695005,139.772747,2024-02-08 16:46:05
1014,H1-120.豊洲5丁目,16,1,17,35.650948,139.799711,2024-02-08 16:46:05
1015,C5-42.DHC芝浦2丁目ビル,6,0,6,35.644241,139.753834,2024-02-08 16:46:05
1016,I1-65.セブン-イレブン品川東大井1丁目店,6,0,6,35.605996,139.743037,2024-02-08 16:46:05
1017,M2-04.広尾東公園,4,1,5,35.653382,139.721059,2024-02-08 16:46:05
1018,M3-13.渋谷駅東口地下駐輪場,18,1,19,35.657682,139.703307,2024-02-08 16:46:05
1019,A3-19.神田ふれあい通り第１,2,3,5,35.694904,139.772712,2024-02-08 16:46:05
1020,O6-07.ローソン杉並宮前一丁目店,2,3,5,35.689639,139.613516,2024-02-08 16:46:05
1021,T3-10.貫井一丁目緑地,3,0,3,35.736378,139.632485,2024-02-08 16:46:05
1022,M2-05.日本赤十字医療センター,0,12,12,35.65519,139.718559,2024-02-08 16:46:05
1023,T2-20.パークサイド石神井,0,6,6,35.741769,139.591103,2024-02-08 16:46:05
1024,N4-06.ローソン中野本町新橋通り店,0,5,5,35.695819,139.674326,2024-02-08 16:46:05
1025,T3-07.徳殿公園,4,0,4,35.726728,139.65874,2024-02-08 16:46:05
1026,K1-35.セブン-イレブン 大田区西六郷2丁目店,5,0,5,35.549778,139.707362,2024-02-08 16:46:05
1027,A3-27.秋葉原駅中央口（ヨドバシカメラ前）,11,0,11,35.698986,139.774099,2024-02-08 16:46:05
1028,A3-28.秋葉原駅電気街口(西側交通広場),3,2,5,35.699173,139.772629,2024-02-08 16:46:05
1029,H1-57.新木場駅,61,1,62,35.64508,139.826456,2024-02-08 16:46:05
1030,H1-58.潮見駅,0,24,24,35.658703,139.817251,2024-02-08 16:46:05
1031,D7-02.セブン-イレブン 新宿中落合3丁目店,0,5,5,35.722202,139.691712,2024-02-08 16:46:05
1032,D2-06.飯田濠,8,4,12,35.70057,139.74301,2024-02-08 16:46:05
1033,C5-17.鈴与浜松町ビル,0,10,10,35.651103,139.759092,2024-02-08 16:46:05
1034,H1-59.LYURO 東京清澄,10,1,11,35.681316,139.792176,2024-02-08 16:46:05
1035,H1-60.荒川・砂町庭球場西,0,16,16,35.679678,139.844892,2024-02-08 16:46:05
1036,K1-44.中馬込貝塚公園,5,0,5,35.594795,139.704951,2024-02-08 16:46:05
1037,M6-11.京王サイクルパーク笹塚,3,2,5,35.674337,139.668801,2024-02-08 16:46:05
1038,J1-49.伊勢脇公園,3,0,3,35.638864,139.696568,2024-02-08 16:46:05
1039,K1-45.たぬき山公園,7,0,7,35.592801,139.715472,2024-02-08 16:46:05
1040,D2-01.あずさセンタービル,11,5,16,35.702286,139.741093,2024-02-08 16:46:05
1041,C1-02.西新橋1丁目（外堀通り）,4,2,6,35.668791,139.753582,2024-02-08 16:46:05
1042,O3-07.NTT井草ビル第1ポート,3,0,3,35.714044,139.61688,2024-02-08 16:46:05
1043,T2-41.ローソン 練馬東大泉五丁目店,0,4,4,35.74248,139.58715,2024-02-08 16:46:05
1044,H1-144.南砂住宅,4,1,5,35.674199,139.822018,2024-02-08 16:46:05
1045,C3-28.ヒューリックＪＰ赤坂ビル,5,5,10,35.672477,139.739743,2024-02-08 16:46:05
1046,H1-145.東雲都橋住宅,5,0,5,35.643131,139.797784,2024-02-08 16:46:05
1047,I1-58.品川区役所　第二庁舎前,12,5,17,35.609664,139.730006,2024-02-08 16:46:05
1048,K1-92.蒲田駅西口自転車駐車場,23,1,24,35.561101,139.715173,2024-02-08 16:46:05
1049,A2-24.水道橋駅西口前,5,1,6,35.702271,139.752619,2024-02-08 16:46:05
1050,K1-94.昭和島駅前,2,3,5,35.572188,139.749613,2024-02-08 16:46:05
1051,M5-15.新宿マインズタワー,14,6,20,35.686567,139.699355,2024-02-08 16:46:05
1052,D7-13.日本光電本社南側,15,0,15,35.71936,139.679083,2024-02-08 16:46:05
1053,N3-09.中野区役所(北側),0,5,5,35.708259,139.663829,2024-02-08 16:46:05
1054,H1-163.森下公園,3,1,4,35.68663,139.799529,2024-02-08 16:46:05
1055,B4-23.交通広場（豊海町）,4,6,10,35.653771,139.769295,2024-02-08 16:46:05
1056,D6-18.ヨドバシカメラ 新宿西口本店前,8,0,8,35.689689,139.698231,2024-02-08 16:46:05
1057,I1-47.NTT 東日本 関東病院(南側),0,7,7,35.630151,139.725215,2024-02-08 16:46:05
1058,H1-112.ファミリーマート江東塩浜二丁目店,1,0,1,35.66305,139.8087,2024-02-08 16:46:05
1059,K1-103.雪谷特別出張所,0,6,6,35.594515,139.691219,2024-02-08 16:46:05
1060,E5-17.Village藍染,4,0,4,35.720896,139.76422,2024-02-08 16:46:05
1061,I1-49.京急鮫洲バイク駐輪場,5,1,6,35.603815,139.741362,2024-02-08 16:46:05
1062,I1-50.京急立会川第2バイク駐輪場,7,0,7,35.599196,139.739158,2024-02-08 16:46:05
1063,E4-14.NTT東日本大塚ビル,0,8,8,35.726188,139.741375,2024-02-08 16:46:05
1064,M2-07.ファミリーマート恵比寿駅東店,6,1,7,35.6471,139.712818,2024-02-08 16:46:05
1065,M4-07.千駄ヶ谷駅前,2,0,2,35.68082,139.71188,2024-02-08 16:46:05
1066,O5-07.バーンホーフ キクチ,8,11,19,35.698169,139.655665,2024-02-08 16:46:05
1067,J1-11.コンフォリア目黒青葉台,0,5,5,35.649023,139.696086,2024-02-08 16:46:05
1068,L1-14.給田3丁目,0,12,12,35.664335,139.590114,2024-02-08 16:46:05
1069,B4-06.月島駅地下駐輪場,0,16,16,35.66291,139.782564,2024-02-08 16:46:05
1070,C5-09.グランパーク,19,0,19,35.643202,139.746244,2024-02-08 16:46:05
1071,C5-08.AQUACITY芝浦,8,0,8,35.637366,139.74844,2024-02-08 16:46:05
1072,C3-08.赤坂パークビルヂング,4,0,4,35.671792,139.733668,2024-02-08 16:46:05
1073,C3-07.新青山ビル,15,3,18,35.672659,139.725644,2024-02-08 16:46:05
1074,C3-06.ホテルアジア会館,1,7,8,35.67064,139.728166,2024-02-08 16:46:05
1075,C1-24.三田国際ビル,0,30,30,35.653159,139.744673,2024-02-08 16:46:05
1076,C5-07.港区立港南図書館,6,0,6,35.632842,139.7495,2024-02-08 16:46:05
1077,A3-04.秋葉原公園,1,17,18,35.697642,139.774867,2024-02-08 16:46:05
1078,A3-05.和泉公園（西側入口）,1,5,6,35.698817,139.778898,2024-02-08 16:46:05
1079,A3-02.絶滅メディア博物館（楓ビル）,7,1,8,35.689575,139.767848,2024-02-08 16:46:05
1080,O3-10.メゾンパークス,6,2,8,35.716265,139.618954,2024-02-08 16:46:05
1081,A2-05.神田橋公園,0,7,7,35.689665,139.764091,2024-02-08 16:46:05
1082,A3-01.神田児童公園（西側交番横）,3,3,6,35.692983,139.76773,2024-02-08 16:46:05
1083,A2-03.西神田公園（西側）,3,2,5,35.698338,139.754876,2024-02-08 16:46:05
1084,M6-03.十三号通り公園,4,2,6,35.675198,139.663587,2024-02-08 16:46:05
1085,M6-02.サイカパーク笹塚,1,6,7,35.673444,139.666553,2024-02-08 16:46:05
1086,H1-165.亀戸梅屋敷,0,8,8,35.701318,139.825916,2024-02-08 16:46:05
1087,H1-166.亀戸クロック,7,12,19,35.696574,139.82972,2024-02-08 16:46:05
1088,M5-02.あいおいニッセイ同和損保新宿ビル,1,4,5,35.684423,139.692262,2024-02-08 16:46:05
1089,M6-01.幡ヶ谷駅高架下第一,24,12,36,35.677175,139.676769,2024-02-08 16:46:05
1090,A5-02.山王パークタワー,0,10,10,35.673555,139.741293,2024-02-08 16:46:05
1091,K1-116.旧呑川緑地（大森東五丁目）,11,0,11,35.567176,139.742345,2024-02-08 16:46:05
1092,K1-115.旧呑川緑地（大森中三丁目）,3,1,4,35.565685,139.736195,2024-02-08 16:46:05
1093,K1-114.下丸子公園,8,0,8,35.568722,139.680736,2024-02-08 16:46:05
1094,T3-05.東武練馬駅南,3,7,10,35.767129,139.664365,2024-02-08 16:46:05
1095,T1-14.ファミリーマート 練馬高松五丁目北店,4,0,4,35.761038,139.623148,2024-02-08 16:46:05
1096,C3-29.高橋是清翁記念公園,5,1,6,35.674094,139.728895,2024-02-08 16:46:05
1097,K1-141.蒲田駅西口歩道,1,4,5,35.561291,139.715076,2024-02-08 16:46:05
1098,C3-35.ワールド北青山ビル,12,4,16,35.667069,139.713423,2024-02-08 16:46:05
1099,M5-03.代々木大山公園,16,0,16,35.671282,139.675307,2024-02-08 16:46:05
1100,E5-13.弥生二丁目,3,3,6,35.715592,139.76192,2024-02-08 16:46:05
1101,E5-12.NK本郷ビル,0,1,1,35.704475,139.763041,2024-02-08 16:46:05
1102,B3-18.銀座松竹スクエア,0,10,10,35.668395,139.769849,2024-02-08 16:46:05
1103,C1-44.三田Avanti,6,0,6,35.64115,139.741471,2024-02-08 16:46:05
1104,T2-31.ファミリーマート 石神井台二丁目店,0,4,4,35.739488,139.590273,2024-02-08 16:46:05
1105,H1-150.ホテルヴィラフォンテーヌ南側,9,0,9,35.636978,139.791858,2024-02-08 16:46:05
1106,H1-149.有明ガーデン 公園口,7,0,7,35.639132,139.793047,2024-02-08 16:46:05
1107,H1-148.大島七丁目団地,0,14,14,35.694104,139.840278,2024-02-08 16:46:05
1108,B4-26.東武ストア晴海三丁目店,11,1,12,35.654371,139.779545,2024-02-08 16:46:05
1109,J1-26.田向公園,5,0,5,35.623459,139.687128,2024-02-08 16:46:05
1110,J1-25.碑文谷公園,7,1,8,35.625081,139.682632,2024-02-08 16:46:05
1111,H1-195.東京アクアティクスセンター,8,11,19,35.65238,139.815613,2024-02-08 16:46:05
1112,T1-13.ファミリーマート 練馬土支田二丁目店,0,6,6,35.761613,139.61349,2024-02-08 16:46:05
1113,T2-34.ファミリーマート 練馬富士見台店,0,4,4,35.73969,139.62125,2024-02-08 16:46:05
1114,T2-35.ファミリーマート 石神井台六丁目店,0,4,4,35.738607,139.585331,2024-02-08 16:46:05
1115,C1-81.田町タワー,16,3,19,35.646534,139.748913,2024-02-08 16:46:05
1116,J1-07.目黒川船入場,12,3,15,35.641992,139.701588,2024-02-08 16:46:05
1117,J1-08.目黒区民センター公園,17,0,17,35.634533,139.708868,2024-02-08 16:46:05
1118,D4-01.市谷仲之町,6,0,6,35.695102,139.723345,2024-02-08 16:46:05
1119,M2-11.鉢山町,16,0,16,35.652151,139.698426,2024-02-08 16:46:05
1120,E4-08.ドコモ・バイクシェア向丘ポート,2,4,6,35.720546,139.756685,2024-02-08 16:46:05
1121,D4-03.市谷加賀町2丁目,2,0,2,35.695636,139.727882,2024-02-08 16:46:05
1122,N1-01.BeGood野方,0,10,10,35.719717,139.64785,2024-02-08 16:46:05
1123,C2-03.アークヒルズサウスタワー,4,7,11,35.666357,139.73923,2024-02-08 16:46:05
1124,C2-01.アークヒルズ（アーク森ビル）,0,12,12,35.667107,139.739565,2024-02-08 16:46:05
1125,C2-02.六本木ヒルズ,15,11,26,35.661158,139.728533,2024-02-08 16:46:05
1126,C5-03.港南公園C,0,27,27,35.624966,139.746657,2024-02-08 16:46:05
1127,C5-04.みなとパーク芝浦,7,1,8,35.646801,139.751208,2024-02-08 16:46:05
1128,C1-16.機械振興会館,4,2,6,35.659442,139.745549,2024-02-08 16:46:05
1129,C1-14.新橋プラザビル,4,0,4,35.664461,139.756082,2024-02-08 16:46:05
1130,H1-73.イシマビル,4,0,4,35.67386,139.79976,2024-02-08 16:46:05
1131,O7-01.西永福公園,5,0,5,35.67753,139.63667,2024-02-08 16:46:05
1132,O6-02.富士見ヶ丘南自転車駐車場,6,2,8,35.68296,139.60861,2024-02-08 16:46:05
1133,K1-50.テクノポートカマタ 第1,3,3,6,35.556199,139.721476,2024-02-08 16:46:05
1134,J1-14.二の橋自転車置場1,38,1,39,35.614856,139.678208,2024-02-08 16:46:05
1135,O3-08.NTT井草ビル第２ポート,2,1,3,35.714077,139.61694,2024-02-08 16:46:05
1136,H1-124.セブン-イレブン 江東海辺店,11,1,12,35.680636,139.817977,2024-02-08 16:46:05
1137,D1-11.三井ガーデンホテル神宮外苑の杜プレミア,1,3,4,35.679807,139.715931,2024-02-08 16:46:05
1138,O7-07.ハレ永福,2,6,8,35.678913,139.639944,2024-02-08 16:46:05
1139,C5-32.トレードピアお台場,0,10,10,35.627891,139.776896,2024-02-08 16:46:05
1140,B4-18.豊海センタービル,1,4,5,35.653531,139.769431,2024-02-08 16:46:05
1141,D5-04.西戸山公園野球場,5,2,7,35.707388,139.700204,2024-02-08 16:46:05
1142,D5-03.北新宿公園,0,6,6,35.702288,139.68862,2024-02-08 16:46:05
1143,D3-04.鶴巻南公園,0,10,10,35.706182,139.723394,2024-02-08 16:46:05
1144,D3-03.甘泉園公園,0,2,2,35.712431,139.715418,2024-02-08 16:46:05
1145,K1-03.池上会館,0,7,7,35.576593,139.706597,2024-02-08 16:46:05
1146,K1-02.平和の森公園,13,2,15,35.579049,139.739878,2024-02-08 16:46:05
1147,K1-01.大森海苔のふるさと館,0,15,15,35.57685,139.742496,2024-02-08 16:46:05
1148,D6-13.新宿中央公園（ジャブジャブ池下）,5,3,8,35.687652,139.689254,2024-02-08 16:46:05
1149,T2-28.ファミリーマート 南大泉六丁目店,4,1,5,35.752217,139.571095,2024-02-08 16:46:05
1150,K1-05.平和島公園プール,9,8,17,35.581832,139.741581,2024-02-08 16:46:05
1151,K1-04.京急蒲田駅東口,16,3,19,35.559483,139.724273,2024-02-08 16:46:05
1152,E2-10.音羽パークロード（北入口）,13,2,15,35.716586,139.727705,2024-02-08 16:46:05
1153,E2-11.音羽パークロード（キャッチボール場横）,18,2,20,35.715382,139.728533,2024-02-08 16:46:05
1154,I1-21.大井競馬場(正門前),10,0,10,35.593887,139.741204,2024-02-08 16:46:05
1155,J1-27.衾町公園,0,1,1,35.623215,139.668472,2024-02-08 16:46:05
1156,T2-44.中島橋自転車駐車場,5,2,7,35.75372,139.584332,2024-02-08 16:46:05
1157,B3-15.ACホテル・バイ・マリオット東京銀座,0,7,7,35.668845,139.765144,2024-02-08 16:46:05
1158,D5-07.百人町1丁目,5,2,7,35.699252,139.697606,2024-02-08 16:46:05
1159,C4-04.ショパン高輪,1,1,2,35.632128,139.732097,2024-02-08 16:46:05
1160,B1-18.セブン-イレブン 日本橋小網町店,0,2,2,35.681352,139.781436,2024-02-08 16:46:05
1161,T2-71.わかば児童公園,4,3,7,35.7211,139.574669,2024-02-08 16:46:05
1162,M3-15.co-ba ebisu,0,5,5,35.647076,139.703964,2024-02-08 16:46:05
1163,C2-20.三井ガーデンホテル六本木プレミア,3,1,4,35.66206,139.735501,2024-02-08 16:46:05
1164,I1-70.五反田リバーステーション,1,5,6,35.624566,139.72448,2024-02-08 16:46:05
1165,E5-25.ジェノヴィア東大前グリーンヴェール,10,0,10,35.711875,139.759306,2024-02-08 16:46:05
1166,D1-12.ジェノヴィア新宿御苑グリーンヴェール,3,3,6,35.689017,139.714755,2024-02-08 16:46:05
1167,C5-33.msb Tamachi,27,5,32,35.645682,139.748768,2024-02-08 16:46:05
1168,G4-09.SYFORME MORISHITA Ⅱ 1,1,0,1,35.690348,139.796133,2024-02-08 16:46:05
1169,G4-10.SYFORME MORISHITA Ⅱ 2,4,0,4,35.690307,139.796128,2024-02-08 16:46:05
1170,N3-19.上高田パーキング,0,14,14,35.715878,139.673669,2024-02-08 16:46:05
1171,F6-01.松坂屋上野店,5,0,5,35.707305,139.773657,2024-02-08 16:46:05
1172,F4-01.SYFORME ASAKUSA,2,2,4,35.718832,139.791133,2024-02-08 16:46:05
1173,F2-02.アップルパーク浅草6丁目第3,0,3,3,35.716062,139.799552,2024-02-08 16:46:05
1174,F2-01.松が谷2丁目2,1,19,20,35.71283,139.787754,2024-02-08 16:46:05
1175,F1-02.台東デザイナーズビレッジ,1,6,7,35.706023,139.783751,2024-02-08 16:46:05
1176,F2-03.台東区生涯学習センター,1,5,6,35.717497,139.790055,2024-02-08 16:46:05
1177,K1-146.南馬込6丁目25-11,3,0,3,35.582743,139.710561,2024-02-08 16:46:05
1178,F3-01.清川1丁目18-11,1,16,17,35.724944,139.801684,2024-02-08 16:46:05
1179,F1-03.新御徒町駅自転車駐車場,1,14,15,35.706793,139.782985,2024-02-08 16:46:05
1180,F3-02.台東区リバーサイドスポーツセンター,0,7,7,35.717571,139.804216,2024-02-08 16:46:05
1181,I1-45.セブン-イレブン品川西五反田3丁目店,0,5,5,35.62541,139.718135,2024-02-08 16:46:05
1182,H1-135.北砂5丁目団地,0,20,20,35.684218,139.832843,2024-02-08 16:46:05
1183,C3-16.赤坂ガーデンシティ,0,8,8,35.6738,139.731525,2024-02-08 16:46:05
1184,J1-34.田道広場公園,10,0,10,35.636269,139.709073,2024-02-08 16:46:05
1185,O5-08.セシオン杉並,0,3,3,35.69714,139.65432,2024-02-08 16:46:05
1186,A2-04.ちよだプラットフォームスクウェア,0,14,14,35.691456,139.762228,2024-02-08 16:46:05
1187,I1-102.J.GRAN Court 品川西大井 EAST,7,0,7,35.598244,139.722447,2024-02-08 16:46:05
1188,H1-196.フットサルクラブ東京東陽町,5,1,6,35.665288,139.824294,2024-02-08 16:46:05
1189,F2-04.コンフォラス浅草マンション,0,3,3,35.717241,139.801674,2024-02-08 16:46:05
1190,G5-03.京成リッチモンドホテル東京錦糸町,3,1,4,35.693492,139.81506,2024-02-08 16:46:05
1191,K1-27.六郷文化センター,4,0,4,35.544715,139.707623,2024-02-08 16:46:05
1192,K1-147.トヨタモビリティ東京GRGarage東京蒲田店,2,0,2,35.552741,139.718404,2024-02-08 16:46:05
1193,K1-148.トヨタモビリティ東京 蒲田仲六郷店,6,0,6,35.552068,139.71747,2024-02-08 16:46:05
1194,K1-150.トヨタモビリティ東京 池上第二京浜店,3,1,4,35.568019,139.696379,2024-02-08 16:46:05
1195,K1-149.トヨタモビリティ東京 大田店,6,0,6,35.59336,139.715879,2024-02-08 16:46:05
1196,C1-82.トヨタモビリティ東京 港三田店,5,0,5,35.647831,139.739048,2024-02-08 16:46:05
1197,D4-11.トヨタモビリティ東京 新宿明治通り南店,2,0,2,35.699835,139.70808,2024-02-08 16:46:05
1198,C3-31.赤坂一丁目,11,6,17,35.670239,139.744285,2024-02-08 16:46:05
1199,E1-04.礫川公園,24,15,39,35.707853,139.751518,2024-02-08 16:46:05
1200,M3-23.円山町7-1,2,7,9,35.658229,139.694885,2024-02-08 16:46:05
1201,M3-24.渋谷道玄坂２丁目駐輪場,3,15,18,35.66026,139.69684,2024-02-08 16:46:05
1202,T3-32.練馬北町1丁目,0,5,5,35.764452,139.666299,2024-02-08 16:46:05
1203,H1-197.セブン-イレブン江東南砂葛西橋通り店,4,0,4,35.675361,139.825034,2024-02-08 16:46:05
1204,T2-84.石神井町二丁目緑地,0,3,3,35.748395,139.605958,2024-02-08 16:46:05
1205,T2-82.梅の木児童遊園,1,4,5,35.737899,139.576584,2024-02-08 16:46:05
1206,T2-83.西大泉さくら緑地,5,3,8,35.760442,139.573145,2024-02-08 16:46:05
1207,D7-05.西落合図書館,8,0,8,35.725818,139.678976,2024-02-08 16:46:05
1208,D6-28.東急ステイ新宿,0,4,4,35.690899,139.706348,2024-02-08 16:46:05
1209,T2-85.泉新公園,3,1,4,35.7547,139.601497,2024-02-08 16:46:05
1210,T2-86.石神井町八丁目緑地,2,1,3,35.746956,139.600798,2024-02-08 16:46:05
1211,T2-87.南大泉四丁目児童遊園,1,3,4,35.745607,139.573947,2024-02-08 16:46:05
1212,T2-88.南大泉かたまち緑地,0,4,4,35.739633,139.570457,2024-02-08 16:46:05
1213,T2-89.南大泉三丁目児童遊園,0,3,3,35.742755,139.568335,2024-02-08 16:46:05
1214,E2-05.護国寺駅西自転車駐車場,22,0,22,35.719421,139.725584,2024-02-08 16:46:05
1215,J1-59.第44興和ビル,2,2,4,35.647704,139.693671,2024-02-08 16:46:05
1216,C1-15.東京タワー,11,4,15,35.65928,139.744767,2024-02-08 16:46:05
1217,C5-20.ローソン芝浦二丁目店,4,0,4,35.645254,139.754765,2024-02-08 16:46:05
1218,C2-27.有栖川宮記念公園第一,17,0,17,35.651382,139.724392,2024-02-08 16:46:05
1219,C2-28.有栖川宮記念公園第二,7,1,8,35.651129,139.726003,2024-02-08 16:46:05
1220,C2-29.狸穴公園,5,0,5,35.658204,139.738935,2024-02-08 16:46:05
1221,T2-90.南田中四丁目緑地,2,2,4,35.733195,139.612327,2024-02-08 16:46:05
1222,T2-91.石神井町四丁目緑地,5,0,5,35.745272,139.604579,2024-02-08 16:46:05
1223,A3-41.秋葉原ダイビル,2,5,7,35.698917,139.771856,2024-02-08 16:46:05
1224,J1-54.田道住区センター三田分室,3,2,5,35.638904,139.712518,2024-02-08 16:46:05
1225,H1-140.キャナルパレス住吉,9,4,13,35.689896,139.815116,2024-02-08 16:46:05
1226,C1-57.虎ノ門ツインビルディング,0,13,13,35.667259,139.745643,2024-02-08 16:46:05
1227,K1-54.ファミリーマート大田久が原五丁目店,3,2,5,35.579435,139.698552,2024-02-08 16:46:05
1228,B1-29.ASTILE日本橋浜町,8,0,8,35.685504,139.790817,2024-02-08 16:46:05
1229,N3-20.SYFORME NAKANO-SAKAUE,2,2,4,35.701157,139.679617,2024-02-08 16:46:05
1230,D6-31.東急歌舞伎町タワー駐輪場,6,2,8,35.696207,139.700521,2024-02-08 16:46:05
1231,I1-30.ローソン 大井三丁目店,5,0,5,35.603327,139.729006,2024-02-08 16:46:05
1232,K1-151.PATH仲六郷,9,1,10,35.549465,139.711157,2024-02-08 16:46:05
1233,H1-198.Br Tower 有明 MID CROSS,1,6,7,35.63464,139.783445,2024-02-08 16:46:05
1234,H1-04.石と光の広場（国際展示場駅）,45,17,62,35.63363,139.79082,2024-02-08 16:46:05
1235,B4-24.ミュプレ月島,5,1,6,35.66288,139.78329,2024-02-08 16:46:05
1236,H1-199.ラ・ヴェール東陽町,10,0,10,35.664244,139.814506,2024-02-08 16:46:05
1237,H1-200.ヴェッセル木場南,2,2,4,35.662414,139.813333,2024-02-08 16:46:05
1238,F1-04.台東2丁目21,1,3,4,35.703465,139.780325,2024-02-08 16:46:05
1239,F3-03.ヴェルステージ南千住,1,4,5,35.728704,139.801867,2024-02-08 16:46:05
1240,J1-46.五本木西みどり街かど公園,1,2,3,35.632735,139.683899,2024-02-08 16:46:05
1241,K1-131.東急武蔵新田駅駐輪場,12,3,15,35.567146,139.693344,2024-02-08 16:46:05
1242,K1-152.アットホームスクエア前,0,7,7,35.543327,139.703223,2024-02-08 16:46:05
1243,B2-04.清水建設本社（都営地下鉄宝町駅 Ａ８出口）,0,14,14,35.676119,139.772895,2024-02-08 16:46:05
1244,H1-202.辰巳の森海浜公園,8,4,12,35.648107,139.813572,2024-02-08 16:46:05
1245,H1-201.ウエリスアーバン水天宮前2,5,0,5,35.678099,139.791831,2024-02-08 16:46:05
1246,I1-103.五反田ＪＰビルディング,2,1,3,35.622389,139.721552,2024-02-08 16:46:05
1247,L1-16.上祖師谷7丁目,13,1,14,35.65838,139.59231,2024-02-08 16:46:05
1248,O5-09.AppCruise中野,1,1,2,35.700772,139.66063,2024-02-08 16:46:05
1249,H1-203.セブン-イレブン江東木場３丁目店,0,1,1,35.67517,139.804087,2024-02-08 16:46:05
1250,H1-44.テプコ豊洲ビル,22,0,22,35.648726,139.790877,2024-02-08 16:46:05
1251,L1-17.赤堤3丁目,3,4,7,35.659787,139.636696,2024-02-08 16:46:05
1252,L1-18.上北沢1丁目,20,10,30,35.662796,139.626795,2024-02-08 16:46:05
1253,B3-16.明石町区民館,0,18,18,35.666001,139.778102,2024-02-08 16:46:05
1254,I1-104.源氏前ビル,4,1,5,35.603521,139.712345,2024-02-08 16:46:05
1255,J1-28.宮前公園,1,1,2,35.617699,139.664826,2024-02-08 16:46:05
1256,M6-18.セブン-イレブン渋谷本町3丁目店,3,0,3,35.686521,139.685017,2024-02-08 16:46:05
1257,O7-08.杉並区和泉2-3-17,0,3,3,35.67187,139.65474,2024-02-08 16:46:05
1258,T1-17.セブン-イレブン練馬田柄通店,6,1,7,35.75987,139.640474,2024-02-08 16:46:05
1259,H1-18.東京ビッグサイト,6,10,16,35.631192,139.79401,2024-02-08 16:46:05
1260,M3-01.渋谷マークシティ,11,1,12,35.657726,139.697802,2024-02-08 16:46:05
1261,H1-70.有明スポーツセンター,12,5,17,35.63403,139.784319,2024-02-08 16:46:05
1262,H1-41.深川北スポーツセンター,11,1,12,35.676475,139.804741,2024-02-08 16:46:05
1263,H1-55.深川江戸資料館,1,4,5,35.681089,139.800777,2024-02-08 16:46:05
1264,I1-61.五反田文化センター,2,3,5,35.622588,139.716159,2024-02-08 16:46:05
1265,N3-13.中部すこやか福祉センター,5,0,5,35.700052,139.673715,2024-02-08 16:46:05
1266,A4-02.東京サンケイビル,0,33,33,35.686847,139.765151,2024-02-08 16:46:05
1267,M3-09.ティップ.クロス TOKYO 渋谷,11,8,19,35.661475,139.699296,2024-02-08 16:46:05
1268,B3-02.サンクンガーデン,2,3,5,35.670336,139.771911,2024-02-08 16:46:05
1269,T2-10.勤労福祉会館,4,1,5,35.748153,139.58765,2024-02-08 16:46:05
1270,K1-133.東京港野鳥公園,13,0,13,35.584217,139.759232,2024-02-08 16:46:05
1271,K1-21.六郷特別出張所,0,6,6,35.55079,139.716517,2024-02-08 16:46:05
1272,H1-54.砂町文化センター,3,17,20,35.680052,139.831874,2024-02-08 16:46:05
1273,D1-08.新宿歴史博物館,3,1,4,35.689984,139.725261,2024-02-08 16:46:05
1274,E1-05.春日地下自転車駐車場,21,5,26,35.708291,139.753335,2024-02-08 16:46:05
1275,E1-15.播磨坂事業所,4,1,5,35.71724,139.74289,2024-02-08 16:46:05
1276,E5-02.不忍通りふれあい館,5,6,11,35.719356,139.764308,2024-02-08 16:46:05
1277,E4-02.向丘地域活動センター,8,5,13,35.717357,139.757817,2024-02-08 16:46:05
1278,C3-18.明治記念館,5,0,5,35.678509,139.721207,2024-02-08 16:46:05
1279,D5-05.中央図書館,13,2,15,35.705018,139.706841,2024-02-08 16:46:05
1280,E2-07.肥後細川庭園,10,3,13,35.713223,139.721699,2024-02-08 16:46:05
1281,A1-05.富士見出張所,1,1,2,35.699187,139.746348,2024-02-08 16:46:05
1282,E5-07.湯島三丁目児童遊園,4,4,8,35.707296,139.769393,2024-02-08 16:46:05
1283,D5-10.桜美林大学 新宿キャンパス,2,5,7,35.705154,139.697562,2024-02-08 16:46:05
1284,A3-08.神田明神（神田神社）,10,3,13,35.702029,139.768245,2024-02-08 16:46:05
1285,E2-14.永青文庫 ミュージアム,5,0,5,35.713145,139.723342,2024-02-08 16:46:05
1286,M5-17.小田急サザンタワー,8,1,9,35.6866,139.70014,2024-02-08 16:46:05
1287,K1-16.ファミリーマート 矢口二丁目店,6,0,6,35.563092,139.693548,2024-02-08 16:46:05
1288,H1-206.北砂5丁目団地2,0,7,7,35.683866,139.831809,2024-02-08 16:46:05
1289,G1-02.八広駅高架下,4,10,14,35.727495,139.828499,2024-02-08 16:46:05
1290,F4-02.Risingplace浅草四番館,0,4,4,35.717963,139.791025,2024-02-08 16:46:05
1291,H1-204.大島四丁目団地2,7,1,8,35.68832,139.828829,2024-02-08 16:46:05
1292,H1-205.大島四丁目団地3,7,3,10,35.688236,139.827711,2024-02-08 16:46:05
1293,H1-106.亀戸中央公園,15,4,19,35.699874,139.834263,2024-02-08 16:46:05
1294,E5-30.湯島3丁目15,1,9,10,35.705148,139.769314,2024-02-08 16:46:05
1295,B4-38.HARUMI FLAG SUN VILLAGE,0,22,22,35.650347,139.771785,2024-02-08 16:46:05
1296,B4-32.HARUMI FLAG SEA VILLAGE,1,10,11,35.648731,139.774995,2024-02-08 16:46:05
1297,B4-31.HARUMI FLAG PORT VILLAGE,0,20,20,35.650604,139.77724,2024-02-08 16:46:05
1298,B4-33.HARUMI FLAG SEA VILLAGE,0,15,15,35.649552,139.776369,2024-02-08 16:46:05
1299,B4-36.HARUMI FLAG SEA VILLAGE,3,9,12,35.650742,139.778097,2024-02-08 16:46:05
1300,B4-35.HARUMI FLAG SEA VILLAGE,4,8,12,35.650573,139.777908,2024-02-08 16:46:05
1301,B4-37.HARUMI FLAG SUN VILLAGE,0,16,16,35.649419,139.771447,2024-02-08 16:46:05
1302,B4-34.HARUMI FLAG SEA VILLAGE,3,9,12,35.649932,139.776958,2024-02-08 16:46:05
1303,B4-39.HARUMI FLAG SUN VILLAGE,0,16,16,35.650863,139.772549,2024-02-08 16:46:05
1304,B4-40.HARUMI FLAG SUN VILLAGE,0,17,17,35.651305,139.773379,2024-02-08 16:46:05
1305,B4-41.HARUMI FLAG SUN VILLAGE,0,14,14,35.649854,139.77334,2024-02-08 16:46:05
1306,B4-42.HARUMI FLAG SUN VILLAGE,2,9,11,35.649329,139.772656,2024-02-08 16:46:05
1307,B4-28.HARUMI FLAG PORT VILLAGE,0,13,13,35.651183,139.776119,2024-02-08 16:46:05
1308,B4-50.HARUMI FLAG PARK VILLAGE,3,6,9,35.648295,139.773973,2024-02-08 16:46:05
1309,B4-49.HARUMI FLAG PARK VILLAGE,4,12,16,35.648636,139.774251,2024-02-08 16:46:05
1310,B4-48.HARUMI FLAG PARK VILLAGE,0,3,3,35.649513,139.775287,2024-02-08 16:46:05
1311,B4-47.HARUMI FLAG PARK VILLAGE,2,4,6,35.649119,139.775138,2024-02-08 16:46:05
1312,B4-46.HARUMI FLAG PARK VILLAGE,0,25,25,35.649642,139.773859,2024-02-08 16:46:05
1313,B4-45.HARUMI FLAG PARK VILLAGE,0,25,25,35.649002,139.772764,2024-02-08 16:46:05
1314,B4-44.HARUMI FLAG PARK VILLAGE,3,10,13,35.648221,139.772666,2024-02-08 16:46:05
1315,B4-30.HARUMI FLAG PORT VILLAGE,2,9,11,35.651136,139.778218,2024-02-08 16:46:05
1316,B4-29.HARUMI FLAG PORT VILLAGE,3,8,11,35.651907,139.777391,2024-02-08 16:46:05
1317,L1-19.三軒茶屋1丁目駐輪場,1,3,4,35.639302,139.674744,2024-02-08 16:46:05
1318,O7-09.方南月極パーキング,9,8,17,35.678921,139.658289,2024-02-08 16:46:05
1319,O5-10.ローソン ツルハドラッグ杉並和田店,0,4,4,35.68942,139.662118,2024-02-08 16:46:05
1320,O2-04.西荻北1丁目,2,3,5,35.708082,139.607543,2024-02-08 16:46:05
1321,K1-75.三井不動産インダストリアルパーク羽田,2,8,10,35.556231,139.751408,2024-02-08 16:46:05
1322,F1-05.ホウエイコート秋葉原,2,0,2,35.703024,139.78052,2024-02-08 16:46:05
1323,C3-36.第35興和ビル,1,2,3,35.666349,139.741781,2024-02-08 16:46:05
1324,B4-53.晴海五丁目ターミナル,28,78,106,35.651627,139.773103,2024-02-08 16:46:05
1325,C5-44.ブランズタワー芝浦,9,0,9,35.643105,139.753039,2024-02-08 16:46:05
1326,A3-47.ホテルヴィラフォンテーヌ東京大手町,13,0,13,35.690602,139.766916,2024-02-08 16:46:05
1327,A1-20.菱和パレス九段,4,1,5,35.693021,139.740317,2024-02-08 16:46:05
0,E5-26.本郷4丁目,0,5,5,35.708596,139.758269,2024-02-08 12:00:05
1,A3-42.内神田3丁目,31,4,35,35.692599,139.770109,2024-02-08 12:00:05
2,T2-76.東中前の森緑地,3,2,5,35.748736,139.574839,2024-02-08 12:00:05
3,A2-20.神田スクエア,19,0,19,35.693408,139.762809,2024-02-08 12:00:05
4,K1-79.Tマークシティホテル東京大森,3,4,7,35.586993,139.736491,2024-02-08 12:00:05
5,K1-80.大森北6丁目,1,3,4,35.579849,139.731241,2024-02-08 12:00:05
6,H1-130.トヨタモビリティ東京 深川店,2,8,10,35.676643,139.816054,2024-02-08 12:00:05
7,H1-131.セブン-イレブン 江東佐賀2丁目店,0,18,18,35.679029,139.793535,2024-02-08 12:00:05
8,H1-132.セブン-イレブン 江東三好4丁目店,0,36,36,35.681418,139.809287,2024-02-08 12:00:05
9,A6-22.半蔵門PREX South,12,3,15,35.683433,139.740756,2024-02-08 12:00:05
10,I1-74.セブン-イレブン西五反田6丁目店,2,4,6,35.622403,139.71771,2024-02-08 12:00:05
11,G2-01.東京ソラマチ,4,3,7,35.709777,139.810189,2024-02-08 12:00:05
12,T2-59.平成公園,2,1,3,35.722917,139.587864,2024-02-08 12:00:05
13,Z15.ファミリーマート藤崎一丁目店,0,6,6,35.52928,139.722762,2024-02-08 12:00:05
14,I1-26.大崎西口公園,4,4,8,35.617475,139.729221,2024-02-08 12:00:05
15,I1-96.西五反田２丁目,10,0,10,35.627599,139.720463,2024-02-08 12:00:05
16,H1-172.サンヨーパシフィックマンション,0,11,11,35.668856,139.794069,2024-02-08 12:00:05
17,J1-56.青葉台四丁目街かど公園,4,0,4,35.654009,139.692727,2024-02-08 12:00:05
18,H1-173.森下駅前,6,33,39,35.687837,139.79654,2024-02-08 12:00:05
19,E3-01.大塚地域活動センター跡地,5,5,10,35.718656,139.734556,2024-02-08 12:00:05
20,E2-03.目白台運動公園,26,15,41,35.715556,139.721988,2024-02-08 12:00:05
21,T2-77.大泉なかよし緑地,3,1,4,35.759861,139.581682,2024-02-08 12:00:05
22,E2-01.江戸川橋Ｂ自転車駐車場,42,39,81,35.710381,139.732137,2024-02-08 12:00:05
23,E2-02.江戸川公園,8,11,19,35.710958,139.731165,2024-02-08 12:00:05
24,D7-14.大栄パーク西落合１丁目,4,2,6,35.720028,139.678936,2024-02-08 12:00:05
25,E1-07.礫川地域活動センター,0,8,8,35.712015,139.750284,2024-02-08 12:00:05
26,M6-05.七号通り公園,0,15,15,35.67917,139.67493,2024-02-08 12:00:05
27,H1-138.HW.HILLS新大橋,0,9,9,35.687416,139.795588,2024-02-08 12:00:05
28,B4-21.月島駅前第一駐輪場,15,19,34,35.663681,139.785651,2024-02-08 12:00:05
29,N2-03.野方1丁目,5,2,7,35.712179,139.65603,2024-02-08 12:00:05
30,C5-52.港南四丁目第3アパート駐車場,7,4,11,35.630109,139.747094,2024-02-08 12:00:05
31,E5-27.真正館駐車場,0,4,4,35.714875,139.76394,2024-02-08 12:00:05
32,C5-35.品川駅港南口,6,0,6,35.62822,139.741135,2024-02-08 12:00:05
33,N2-01.NTT野方ビル,2,3,5,35.710285,139.66173,2024-02-08 12:00:05
34,D6-27.新宿三井ビルディング二号館,8,1,9,35.686334,139.692881,2024-02-08 12:00:05
35,D1-10.曙橋駐輪場,3,13,16,35.691888,139.724365,2024-02-08 12:00:05
36,I1-39.MID POINT 目黒不動前,3,2,5,35.628116,139.713149,2024-02-08 12:00:05
37,E3-07.小日向1丁目,0,20,20,35.713388,139.737009,2024-02-08 12:00:05
38,C1-47.パークプレイス三田,8,1,9,35.641791,139.740734,2024-02-08 12:00:05
39,I1-38.ローソン 八潮三丁目店,25,20,45,35.594544,139.760423,2024-02-08 12:00:05
40,C2-24.Dash Living HigashiAzabu,6,0,6,35.655135,139.744449,2024-02-08 12:00:05
41,J1-04.菅刈公園,7,1,8,35.650351,139.692853,2024-02-08 12:00:05
42,O4-09.ローソン杉並本天沼一丁目店,0,3,3,35.712496,139.632778,2024-02-08 12:00:05
43,T3-29.平和台もものき緑地,1,2,3,35.755773,139.661913,2024-02-08 12:00:05
44,D2-10.市谷砂土原町3丁目,4,8,12,35.696242,139.735776,2024-02-08 12:00:05
45,C1-48.竹芝客船ターミナル,10,5,15,35.655139,139.762812,2024-02-08 12:00:05
46,B1-06.伊場仙ビル,3,2,5,35.687624,139.777125,2024-02-08 12:00:05
47,B2-01.鉄砲洲児童公園（西側）,0,21,21,35.67224,139.779348,2024-02-08 12:00:05
48,B1-04.産業会館,2,3,5,35.694164,139.787057,2024-02-08 12:00:05
49,B1-05.日本橋保健センター,0,11,11,35.687419,139.779053,2024-02-08 12:00:05
50,B2-05.ＮＴＴ東日本築地ビル,0,9,9,35.670674,139.775993,2024-02-08 12:00:05
51,B2-02.柳通り（東京スクエアガーデン前）,12,0,12,35.676393,139.768319,2024-02-08 12:00:05
52,B2-03.男女平等センター（ブーケ21）,8,3,11,35.673923,139.778671,2024-02-08 12:00:05
53,C2-13.麻布運動場,8,0,8,35.651718,139.728165,2024-02-08 12:00:05
54,D2-08.旧市ヶ谷商業高校,0,18,18,35.70074,139.731363,2024-02-08 12:00:05
55,C1-35.セブン-イレブン 三田駅北店,4,1,5,35.649032,139.750147,2024-02-08 12:00:05
56,B4-12.THE TOKYO TOWERS,0,99,99,35.655497,139.774556,2024-02-08 12:00:05
57,C5-21.セブン-イレブン 芝浦3丁目店,4,2,6,35.642399,139.746992,2024-02-08 12:00:05
58,H1-67.セブン-イレブン 江東亀戸9丁目店,1,15,16,35.69766,139.843408,2024-02-08 12:00:05
59,C2-15.住友不動産六本木グランドタワー,0,14,14,35.664367,139.737185,2024-02-08 12:00:05
60,C2-14.元麻布ヒルズ,0,10,10,35.653608,139.73138,2024-02-08 12:00:05
61,M6-14.ドコモショップ笹塚店,0,5,5,35.67323,139.66393,2024-02-08 12:00:05
62,N4-07.南台2丁目,2,10,12,35.68509,139.671102,2024-02-08 12:00:05
63,K1-68.ART FACTORY 城南島,6,2,8,35.580511,139.775957,2024-02-08 12:00:05
64,H1-178.北砂7丁目団地(第二),0,4,4,35.678031,139.837193,2024-02-08 12:00:05
65,H1-179.北砂7丁目団地(第三),1,10,11,35.678246,139.8366,2024-02-08 12:00:05
66,A1-17.雉子橋集積所,6,0,6,35.692605,139.755761,2024-02-08 12:00:05
67,H1-177.北砂7丁目団地(第一),0,13,13,35.678537,139.837391,2024-02-08 12:00:05
68,K1-95.城南島海浜公園,11,5,16,35.578259,139.783505,2024-02-08 12:00:05
69,B3-17.銀座6丁目-SQUARE,7,0,7,35.66711,139.76643,2024-02-08 12:00:05
70,J1-33.芳窪街かど公園,12,1,13,35.629861,139.666293,2024-02-08 12:00:05
71,N3-07.なかのZERO,1,4,5,35.70442,139.67141,2024-02-08 12:00:05
72,N4-04.弥生町5丁目,3,9,12,35.690897,139.668345,2024-02-08 12:00:05
73,A3-44.THE WAVES AKIHABARA,0,9,9,35.694679,139.779504,2024-02-08 12:00:05
74,K1-138.羽田エアポートガーデン,6,3,9,35.544534,139.763244,2024-02-08 12:00:05
75,C3-26.ホテルリブマックス赤坂,2,3,5,35.67011,139.733375,2024-02-08 12:00:05
76,C1-52.NTT三田ビル,3,3,6,35.652549,139.747789,2024-02-08 12:00:05
77,D1-07.Dash Living Shinjuku,4,0,4,35.689757,139.710091,2024-02-08 12:00:05
78,O4-07.ローソン成田西三丁目店,0,5,5,35.690311,139.62178,2024-02-08 12:00:05
79,H1-152.コンポジット亀戸ウエスト,0,9,9,35.699187,139.82429,2024-02-08 12:00:05
80,E1-13.エルアージュ小石川,0,39,39,35.71399,139.75137,2024-02-08 12:00:05
81,B4-22.リビオレゾン勝どきNEX,0,61,61,35.65554,139.77102,2024-02-08 12:00:05
82,H1-176.JMFビル東陽町02,4,2,6,35.667677,139.823552,2024-02-08 12:00:05
83,H1-102.ファミリーマート東砂七丁目店,0,17,17,35.672714,139.837914,2024-02-08 12:00:05
84,H1-101.ファミリーマート新木場一丁目店,5,1,6,35.642571,139.836766,2024-02-08 12:00:05
85,K1-67.京浜島防災広場,0,15,15,35.570508,139.764013,2024-02-08 12:00:05
86,K1-66.昭和島二丁目公園,0,12,12,35.575097,139.751446,2024-02-08 12:00:05
87,Z11.ファミリーマートＭＧ川崎昭和店,4,0,4,35.528868,139.737762,2024-02-08 12:00:05
88,I1-80.リバーサイド品川港南ビル,5,5,10,35.622714,139.74471,2024-02-08 12:00:05
89,J1-10.NTTデータ駒場研修センター,5,6,11,35.655779,139.680948,2024-02-08 12:00:05
90,A2-17.竹橋ビル,8,0,8,35.692396,139.75639,2024-02-08 12:00:05
91,H1-91.亀戸駅北口第三自転車駐車場,13,5,18,35.696913,139.823911,2024-02-08 12:00:05
92,H1-92.亀戸駅東口第二自転車駐車場,7,8,15,35.69788,139.830559,2024-02-08 12:00:05
93,K1-59.京急梅屋敷第1駐車場,6,1,7,35.565768,139.727396,2024-02-08 12:00:05
94,K1-60.京急平和島第1駐車場,1,8,9,35.576336,139.733691,2024-02-08 12:00:05
95,I1-42.京急青横駐車場,3,0,3,35.611582,139.742528,2024-02-08 12:00:05
96,I1-43.京急南大井駐車場,0,9,9,35.594722,139.737101,2024-02-08 12:00:05
97,Z01.NTTドコモ川崎ビル,8,0,8,35.528801,139.694661,2024-02-08 12:00:05
98,O7-05.ジーベック方南町,1,1,2,35.680849,139.65626,2024-02-08 12:00:05
99,H1-100.URアーバンライフ亀戸,21,8,29,35.697935,139.821855,2024-02-08 12:00:05
100,A6-10.紀尾井町ビル（西側）,9,3,12,35.682516,139.736494,2024-02-08 12:00:05
101,C3-02.赤坂地区総合支所,0,7,7,35.674788,139.731423,2024-02-08 12:00:05
102,C2-08.ファミリーマート西麻布霞町店,0,8,8,35.661673,139.721118,2024-02-08 12:00:05
103,A6-09.紀尾井町ビル（北側）,6,0,6,35.682902,139.736494,2024-02-08 12:00:05
104,H1-28.有明客船ターミナル,10,1,11,35.630063,139.792209,2024-02-08 12:00:05
105,B1-12.ファミリーマート堀留町二丁目店,0,8,8,35.687786,139.78205,2024-02-08 12:00:05
106,H1-26.青海客船ターミナル,15,0,15,35.619234,139.774485,2024-02-08 12:00:05
107,H1-27.パレットタウン乗船場,10,0,10,35.624467,139.781305,2024-02-08 12:00:05
108,K1-121.東京広域ポート（川崎LiSE）,10,0,10,35.540579,139.754506,2024-02-08 12:00:05
109,K1-122.東急新丸子駅駐輪場,8,5,13,35.581347,139.662265,2024-02-08 12:00:05
110,K1-123.東急新丸子駅（東）駐輪場,12,0,12,35.577794,139.660751,2024-02-08 12:00:05
111,O1-04.井草1-34,8,7,15,35.72758,139.62432,2024-02-08 12:00:05
112,C1-76.浜松町駅北口交通広場(ハマサイト前),16,0,16,35.656647,139.758301,2024-02-08 12:00:05
113,J1-52.駒沢一丁目公園前,7,2,9,35.629807,139.662398,2024-02-08 12:00:05
114,C1-75.虎ノ門PFビル,6,1,7,35.665466,139.748014,2024-02-08 12:00:05
115,B2-18.旭ビルディング,11,0,11,35.678291,139.78157,2024-02-08 12:00:05
116,N2-09.松山駐車場No.1,3,3,6,35.722991,139.673048,2024-02-08 12:00:05
117,I1-82.トミンハイム西五反田四丁目,3,3,6,35.627386,139.711182,2024-02-08 12:00:05
118,O4-03.ザ・ハウス,0,12,12,35.707035,139.633066,2024-02-08 12:00:05
119,O4-04.阿佐谷南3-43,15,1,16,35.704147,139.631955,2024-02-08 12:00:05
120,K1-83.北千束北児童公園,6,0,6,35.611085,139.68599,2024-02-08 12:00:05
121,I1-95.東京レールゲート EAST,6,4,10,35.584998,139.761055,2024-02-08 12:00:05
122,M5-19.グランリヴィエール代々木,1,4,5,35.68285,139.698528,2024-02-08 12:00:05
123,Z14.ファミリーマート川崎中瀬店,3,6,9,35.537163,139.729625,2024-02-08 12:00:05
124,H1-192.ウエリスアーバン水天宮前,3,1,4,35.678296,139.791949,2024-02-08 12:00:05
125,N2-08.江古田区民活動センター,3,1,4,35.728893,139.670119,2024-02-08 12:00:05
126,D7-04.セブン-イレブン 新宿下落合3丁目店,1,2,3,35.722645,139.701982,2024-02-08 12:00:05
127,Z16.ファミリーマート川崎浜町四丁目店,4,3,7,35.515344,139.722229,2024-02-08 12:00:05
128,K1-82.西蒲田公園,7,0,7,35.561499,139.71123,2024-02-08 12:00:05
129,H1-68.芝浦工業大学附属中学高等学校,0,38,38,35.649274,139.792213,2024-02-08 12:00:05
130,K1-24.東糀谷防災公園,0,16,16,35.557074,139.74575,2024-02-08 12:00:05
131,H1-03.東雲駅,13,2,15,35.640736,139.804331,2024-02-08 12:00:05
132,K1-26.大森諏訪公園,0,15,15,35.574785,139.730762,2024-02-08 12:00:05
133,K1-25.鶴渡公園,2,1,3,35.56892,139.725082,2024-02-08 12:00:05
134,N3-10.エーエスホームズⅡ駐車場,5,1,6,35.702659,139.662563,2024-02-08 12:00:05
135,J1-37.中目黒公園,11,7,18,35.640398,139.704069,2024-02-08 12:00:05
136,A1-10.ヒューリック九段ビル,6,0,6,35.696449,139.750784,2024-02-08 12:00:05
137,K1-93.六間堀仲羽公園,2,2,4,35.548864,139.74484,2024-02-08 12:00:05
138,T2-53.上練馬公園,2,2,4,35.772863,139.626969,2024-02-08 12:00:05
139,M5-01.初台駅南口,0,12,12,35.680154,139.685937,2024-02-08 12:00:05
140,C1-60.専売ビル,10,3,13,35.647659,139.745055,2024-02-08 12:00:05
141,K1-85.大田区青少年交流センター ゆいっつ,3,1,4,35.583555,139.743381,2024-02-08 12:00:05
142,I1-64.株式会社ユアス ゆうパック取扱所：ポストのうしろ,8,2,10,35.622965,139.731014,2024-02-08 12:00:05
143,C4-09.ケーヨーデイツー三田店,0,6,6,35.646375,139.740061,2024-02-08 12:00:05
144,C1-61.環三浜松町駅南,23,15,38,35.653096,139.75739,2024-02-08 12:00:05
145,K1-84.佐伯山緑地,0,13,13,35.581698,139.71491,2024-02-08 12:00:05
146,C1-59.セレスティン芝三井ビルディング,5,8,13,35.650845,139.748346,2024-02-08 12:00:05
147,G2-07.レオーネ押上cube,2,2,4,35.706167,139.815955,2024-02-08 12:00:05
148,E1-06.文京シビックセンター,10,10,20,35.708265,139.751983,2024-02-08 12:00:05
149,D2-13.THE CENTER TOKYO,0,23,23,35.695646,139.725722,2024-02-08 12:00:05
150,E5-22.千駄木2丁目,2,4,6,35.724828,139.762583,2024-02-08 12:00:05
151,C4-07.品川プリンスホテル,9,1,10,35.628266,139.734171,2024-02-08 12:00:05
152,A3-43.unito CHIYODA,3,0,3,35.69474,139.77929,2024-02-08 12:00:05
153,C4-06.白金プラチナレジデンス,0,22,22,35.644134,139.723432,2024-02-08 12:00:05
154,I1-63.セブン-イレブン西五反田店,3,0,3,35.62765,139.719212,2024-02-08 12:00:05
155,H1-53.豊洲シビックセンター,18,0,18,35.653991,139.795513,2024-02-08 12:00:05
156,T3-16.練馬区役所東庁舎(第一),10,0,10,35.735428,139.652379,2024-02-08 12:00:05
157,T2-68.さくら原っぱ緑地,2,3,5,35.731372,139.619164,2024-02-08 12:00:05
158,T2-69.久保新田さくら公園,0,4,4,35.76525,139.575978,2024-02-08 12:00:05
159,H1-187.森下文化センター,0,5,5,35.685344,139.80234,2024-02-08 12:00:05
160,E4-04.セブン-イレブン 文京本駒込１丁目店,0,5,5,35.724707,139.750469,2024-02-08 12:00:05
161,M2-13.恵比寿プライムスクエアタワー南,8,0,8,35.649257,139.713272,2024-02-08 12:00:05
162,H1-48.セブン-イレブン 江東潮見２丁目店,0,8,8,35.658249,139.815775,2024-02-08 12:00:05
163,H1-51.豊洲交通広場　東,26,0,26,35.654958,139.795718,2024-02-08 12:00:05
164,H1-52.辰巳駅,14,1,15,35.646756,139.809295,2024-02-08 12:00:05
165,D7-01.下落合図書館,5,11,16,35.715894,139.698578,2024-02-08 12:00:05
166,H1-50.豊洲交通広場　北,11,0,11,35.655457,139.795161,2024-02-08 12:00:05
167,A6-14.MG市ヶ谷ビルディング,1,1,2,35.690861,139.736393,2024-02-08 12:00:05
168,T2-21.ファミリーマート 練馬大泉町一丁目店,1,3,4,35.768448,139.601679,2024-02-08 12:00:05
169,A6-15.東急番町ビル,4,1,5,35.688929,139.7358,2024-02-08 12:00:05
170,A1-18.東京区政会館別館(特別区研修所),3,0,3,35.696202,139.752351,2024-02-08 12:00:05
171,T3-18.練馬駅北,10,9,19,35.738585,139.653396,2024-02-08 12:00:05
172,C1-43.KDX浜松町プレイス,3,3,6,35.658169,139.752509,2024-02-08 12:00:05
173,C5-27.プレミア海岸ビル,9,12,21,35.648948,139.757895,2024-02-08 12:00:05
174,I1-29.ローソン 勝島一丁目店,0,20,20,35.599987,139.745195,2024-02-08 12:00:05
175,H1-72.ネクストサイト深川ビル,20,1,21,35.674578,139.797396,2024-02-08 12:00:05
176,T1-11.むつみ台,0,3,3,35.768528,139.639807,2024-02-08 12:00:05
177,T1-10.月見大橋下,5,0,5,35.758366,139.628982,2024-02-08 12:00:05
178,H1-167.大島八丁目公園,1,9,10,35.688074,139.838932,2024-02-08 12:00:05
179,K1-36.セブン-イレブン 大田区南雪谷5丁目店,0,12,12,35.587815,139.691748,2024-02-08 12:00:05
180,L1-01.羽根木公園,5,8,13,35.66088,139.654546,2024-02-08 12:00:05
181,P1-02.雑司ヶ谷一丁目,8,0,8,35.721738,139.723103,2024-02-08 12:00:05
182,I1-66.南大井文化センター駐車場,2,4,6,35.596733,139.73804,2024-02-08 12:00:05
183,L1-05.NTT烏山ビル,1,2,3,35.669285,139.597931,2024-02-08 12:00:05
184,L1-04.下馬中央公園,0,5,5,35.63367,139.678139,2024-02-08 12:00:05
185,L1-03.世田谷城阯公園,0,6,6,35.645838,139.647799,2024-02-08 12:00:05
186,L1-02.若林公園,5,2,7,35.647075,139.654472,2024-02-08 12:00:05
187,T2-30.ファミリーマート 練馬東大泉四丁目店,4,0,4,35.750804,139.58243,2024-02-08 12:00:05
188,L1-07.NTT成城ビル,2,1,3,35.648021,139.606529,2024-02-08 12:00:05
189,L1-06.NTT瀬田ビル,0,11,11,35.618357,139.626191,2024-02-08 12:00:05
190,T3-12.春日町西公園,3,1,4,35.748092,139.636587,2024-02-08 12:00:05
191,T3-13.平和台児童公園,2,2,4,35.757298,139.664139,2024-02-08 12:00:05
192,T2-38.ファミリーマート 練馬上石神井四丁目店,7,2,9,35.727195,139.590179,2024-02-08 12:00:05
193,B1-28.アイルイムーブル日本橋,8,1,9,35.684502,139.77906,2024-02-08 12:00:05
194,A2-28.NTTコミュニケーションズ一ツ橋ビル駐車場,8,0,8,35.6915,139.75685,2024-02-08 12:00:05
195,C3-32.乃木公園,3,2,5,35.667936,139.72745,2024-02-08 12:00:05
196,T3-14.わらべ児童遊園,3,1,4,35.759774,139.654529,2024-02-08 12:00:05
197,T2-52.田柄中央児童公園,2,3,5,35.762395,139.641522,2024-02-08 12:00:05
198,M4-06.THE SHARE 原宿,9,0,9,35.671823,139.708158,2024-02-08 12:00:05
199,K1-10.セブン‐イレブン 大田区西糀谷１丁目店,1,3,4,35.559647,139.730098,2024-02-08 12:00:05
200,K1-09.セブン‐イレブン 大田区西蒲田２丁目店,0,22,22,35.570763,139.705895,2024-02-08 12:00:05
201,H1-63.東京スイソミル,0,14,14,35.65637,139.811765,2024-02-08 12:00:05
202,B1-16.小網町児童遊園,6,0,6,35.683695,139.780043,2024-02-08 12:00:05
203,H1-61.Brilliaランニングスタジアムマギーズ東京前,7,2,9,35.648281,139.786112,2024-02-08 12:00:05
204,K1-08.セブン‐イレブン 大田区東蒲田キネマ通り店,0,6,6,35.562368,139.730143,2024-02-08 12:00:05
205,C1-34.城山ガーデン,8,0,8,35.664479,139.743731,2024-02-08 12:00:05
206,H1-62.扇橋一丁目公園南,0,42,42,35.683343,139.812161,2024-02-08 12:00:05
207,J1-23.清水池公園,9,14,23,35.623756,139.692517,2024-02-08 12:00:05
208,C5-18.パークタワー品川ベイワード,8,11,19,35.634529,139.748378,2024-02-08 12:00:05
209,E4-07.ファミリーマート 本駒込二丁目店,3,1,4,35.727279,139.74627,2024-02-08 12:00:05
210,C5-45.パークアクシス芝浦キャナル,2,7,9,35.644794,139.755688,2024-02-08 12:00:05
211,A2-02.西神田公園（北側）,6,3,9,35.698591,139.755113,2024-02-08 12:00:05
212,T2-49.善福寺公園テニスクラブ,5,4,9,35.719674,139.593696,2024-02-08 12:00:05
213,H1-193.ライフ豊洲店,27,1,28,35.651833,139.79962,2024-02-08 12:00:05
214,A2-01.神田駿河台下,52,1,53,35.695762,139.761585,2024-02-08 12:00:05
215,I1-51.京急鈴ヶ森駐車場,0,14,14,35.589573,139.735585,2024-02-08 12:00:05
216,T2-36.サントピア テニスパーク,4,6,10,35.75195,139.616028,2024-02-08 12:00:05
217,G4-13. Parking in 両国駅前第2,0,3,3,35.696492,139.791591,2024-02-08 12:00:05
218,K1-120.蒲田駅消費者生活センター横自転車駐車場 屋上部,6,0,6,35.560125,139.71569,2024-02-08 12:00:05
219,N3-18.藤和シティコープ新中野3,5,1,6,35.69942,139.673964,2024-02-08 12:00:05
220,K1-145.トヨタモビリティ東京馬込テクニカル研修センター,6,7,13,35.58209,139.701362,2024-02-08 12:00:05
221,K1-100.多摩川台公園,5,0,5,35.589794,139.666955,2024-02-08 12:00:05
222,C1-54.ニッセイ虎ノ門ビル,11,1,12,35.664344,139.746662,2024-02-08 12:00:05
223,I1-52.カスタリアタワー品川シーサイド,7,3,10,35.607557,139.746866,2024-02-08 12:00:05
224,I1-53.天王洲公園,3,1,4,35.620355,139.749339,2024-02-08 12:00:05
225,C2-18.ブランシェ東麻布,0,3,3,35.656769,139.743224,2024-02-08 12:00:05
226,A3-45.鍛冶町2丁目,12,6,18,35.691578,139.77138,2024-02-08 12:00:05
227,H1-87.パークアクシス木場キャナルウエスト,0,27,27,35.662514,139.803694,2024-02-08 12:00:05
228,D6-20.淀橋けやき橋公園,5,10,15,35.693544,139.685806,2024-02-08 12:00:05
229,A3-46.神田須田町2丁目,0,1,1,35.695457,139.772972,2024-02-08 12:00:05
230,B3-13.国立がん研究センター,11,0,11,35.664871,139.767188,2024-02-08 12:00:05
231,I1-35.シーフォートスクエア,18,0,18,35.622954,139.750593,2024-02-08 12:00:05
232,K1-55.カバヤビル,5,13,18,35.576275,139.713704,2024-02-08 12:00:05
233,C3-24.SHARE GREEN 南青山 西エントランス,0,7,7,35.668419,139.724676,2024-02-08 12:00:05
234,A5-06.APA HOTEL PRIDE〈国会議事堂前〉,10,0,10,35.674468,139.741328,2024-02-08 12:00:05
235,A6-17.東京ガーデンテラス紀尾井町（プリンス通り側）,12,0,12,35.680431,139.738203,2024-02-08 12:00:05
236,B4-07.勝どき駅地下駐輪場,58,3,61,35.658135,139.776131,2024-02-08 12:00:05
237,B4-08.東京ミッドベイ勝どき（西仲通り）,1,17,18,35.656449,139.771302,2024-02-08 12:00:05
238,B3-04.築地市場駅地下駐輪場,17,0,17,35.664265,139.767426,2024-02-08 12:00:05
239,C5-10.シーバンス,11,3,14,35.649959,139.756068,2024-02-08 12:00:05
240,H1-34.門前仲町駅,47,5,52,35.67391,139.796165,2024-02-08 12:00:05
241,C3-10.ファミリーマート特許庁前店,1,5,6,35.670364,139.744684,2024-02-08 12:00:05
242,A1-01.千代田区役所,6,0,6,35.693799,139.753281,2024-02-08 12:00:05
243,A1-03.東京区政会館（メトロA5出口）,7,0,7,35.701073,139.747525,2024-02-08 12:00:05
244,B3-06.朝日新聞東京本社,4,0,4,35.664457,139.767214,2024-02-08 12:00:05
245,A1-04.東京区政会館（西側駐輪場）,7,0,7,35.701347,139.746951,2024-02-08 12:00:05
246,T1-03.四季の香公園,5,0,5,35.760585,139.626284,2024-02-08 12:00:05
247,T1-04.春の風公園,3,0,3,35.75731,139.624922,2024-02-08 12:00:05
248,T1-05.夏の雲公園,5,0,5,35.753964,139.629116,2024-02-08 12:00:05
249,H1-194.セブン-イレブン江東北砂5丁目店,0,5,5,35.68268,139.8353,2024-02-08 12:00:05
250,O5-03.新高円寺地下自転車駐輪場,5,7,12,35.697265,139.649397,2024-02-08 12:00:05
251,O3-06.アミーズ荻窪,3,1,4,35.714616,139.625116,2024-02-08 12:00:05
252,T2-03.リヴィンオズ大泉店,7,1,8,35.752383,139.594855,2024-02-08 12:00:05
253,O6-06.上高井戸1丁目,0,7,7,35.673055,139.611293,2024-02-08 12:00:05
254,T2-05.石神井図書館,3,1,4,35.736076,139.599676,2024-02-08 12:00:05
255,T2-06.総合体育館,2,1,3,35.748957,139.621385,2024-02-08 12:00:05
256,O5-02.馬橋ハイツ,4,2,6,35.705686,139.642587,2024-02-08 12:00:05
257,N1-07.プランドール上鷺宮,1,6,7,35.733292,139.630369,2024-02-08 12:00:05
258,E1-18.アーバネックス小石川春日,0,8,8,35.709261,139.746374,2024-02-08 12:00:05
259,T3-03.新桜台駅自転車駐車場,4,3,7,35.740378,139.667502,2024-02-08 12:00:05
260,O3-05.Nちゃりパーク,18,4,22,35.70389,139.6185,2024-02-08 12:00:05
261,O5-01.朝霞ハイツ,7,4,11,35.71038,139.64519,2024-02-08 12:00:05
262,L1-11.アイムタウン上祖師谷,2,1,3,35.656849,139.594422,2024-02-08 12:00:05
263,L1-12.鈴木リースホーム駐車場,12,2,14,35.646648,139.633038,2024-02-08 12:00:05
264,L1-13.わびさびホステル,1,3,4,35.647393,139.667085,2024-02-08 12:00:05
265,G2-05.リアナスカイパーク押上,5,1,6,35.715733,139.815451,2024-02-08 12:00:05
266,T3-02.早宮第二自転車駐車場,8,3,11,35.756846,139.652154,2024-02-08 12:00:05
267,I1-37.ガーデンシティ品川御殿山,6,3,9,35.623466,139.734359,2024-02-08 12:00:05
268,T2-47.上石神井駅北第二自転車駐車場,7,3,10,35.726523,139.5905,2024-02-08 12:00:05
269,C1-51.環二新橋四丁目,9,3,12,35.663843,139.757697,2024-02-08 12:00:05
270,M6-07.笹塚東,12,9,21,35.675436,139.670594,2024-02-08 12:00:05
271,M3-10.ウノサワ東急ビル,8,0,8,35.647757,139.712981,2024-02-08 12:00:05
272,C2-26.一の橋公園,6,1,7,35.655367,139.738075,2024-02-08 12:00:05
273,H1-14.ホテルリブマックス東京潮見駅前,5,1,6,35.658351,139.818229,2024-02-08 12:00:05
274,D2-12.ヴィアイン飯田橋後楽園,0,12,12,35.705774,139.743366,2024-02-08 12:00:05
275,D3-08.ホテルリブマックス高田馬場駅前,8,0,8,35.712952,139.701356,2024-02-08 12:00:05
276,H1-103.清澄庭園,4,6,10,35.680948,139.796917,2024-02-08 12:00:05
277,H1-104.木場公園,0,19,19,35.676488,139.809616,2024-02-08 12:00:05
278,H1-105.猿江恩賜公園,7,1,8,35.692277,139.817491,2024-02-08 12:00:05
279,G4-07.ディアレイシャス両国,0,4,4,35.69955,139.803204,2024-02-08 12:00:05
280,T2-46.大泉郵便局バス停自転車駐車場,0,9,9,35.766491,139.587232,2024-02-08 12:00:05
281,I1-18.東品川公園,4,3,7,35.61379,139.746617,2024-02-08 12:00:05
282,J1-03.西郷山公園,5,1,6,35.650688,139.696696,2024-02-08 12:00:05
283,J1-02.駒場野公園,10,4,14,35.657718,139.681043,2024-02-08 12:00:05
284,D2-14.ローソン 神楽坂駅北店,0,16,16,35.704201,139.735815,2024-02-08 12:00:05
285,K1-65.下丸子3丁目,7,5,12,35.571711,139.685337,2024-02-08 12:00:05
286,T2-43.学園通り自転車駐車場,8,0,8,35.7547,139.5871,2024-02-08 12:00:05
287,I1-46.セブン-イレブン 品川東中延2丁目店,0,5,5,35.608721,139.714158,2024-02-08 12:00:05
288,T2-04.石神井公園駅南口,12,1,13,35.743354,139.606592,2024-02-08 12:00:05
289,J1-06.観音橋自転車置場,34,11,45,35.642251,139.69692,2024-02-08 12:00:05
290,J1-05.東山公園　北,0,13,13,35.64853,139.686309,2024-02-08 12:00:05
291,J1-45.プラウド中目黒,0,3,3,35.63767,139.7045,2024-02-08 12:00:05
292,H1-168.大島五丁目公園,11,2,13,35.68642,139.836151,2024-02-08 12:00:05
293,J1-47.本町みなみ街かど公園,4,13,17,35.61847,139.70019,2024-02-08 12:00:05
294,J1-48.グランドエクセル祐天寺,0,19,19,35.64372,139.68777,2024-02-08 12:00:05
295,K1-101.小池公園,0,5,5,35.599541,139.697962,2024-02-08 12:00:05
296,H1-171.LOGI’Q南砂町,6,3,9,35.672877,139.842339,2024-02-08 12:00:05
297,H1-153.三井リンクラボ新木場1,9,1,10,35.63851,139.823534,2024-02-08 12:00:05
298,H1-154.やぐら橋下,20,0,20,35.631132,139.792726,2024-02-08 12:00:05
299,Z21.コーナン川崎小田栄店,0,9,9,35.514643,139.706285,2024-02-08 12:00:05
300,D5-11.NTTコミュニケーションズ新宿ビル,4,5,9,35.699312,139.696468,2024-02-08 12:00:05
301,C5-31.ヒルトン東京お台場,3,7,10,35.626267,139.771438,2024-02-08 12:00:05
302,K1-78.城南鋳物団地協同組合,0,10,10,35.567562,139.766854,2024-02-08 12:00:05
303,Z05.ローソン川崎小田二丁目店,0,8,8,35.513548,139.697176,2024-02-08 12:00:05
304,I1-68.八潮公園第二,0,9,9,35.600003,139.754288,2024-02-08 12:00:05
305,I1-67.八潮公園第一,0,11,11,35.601149,139.754284,2024-02-08 12:00:05
306,H1-123.ダイワロイネットホテル東京有明,19,2,21,35.634316,139.793199,2024-02-08 12:00:05
307,J1-24.ボヌールREIWA,4,1,5,35.612389,139.676238,2024-02-08 12:00:05
308,B2-12.東京ダイヤビルディング（東側）,16,2,18,35.674835,139.785656,2024-02-08 12:00:05
309,J1-15.二の橋自転車置場2,14,2,16,35.614391,139.678396,2024-02-08 12:00:05
310,H1-77.ライフ東砂店,0,9,9,35.684641,139.844243,2024-02-08 12:00:05
311,D1-09.NTT四谷ビル,0,3,3,35.691188,139.712079,2024-02-08 12:00:05
312,E4-11.プライマル千石,0,14,14,35.727519,139.742815,2024-02-08 12:00:05
313,I1-23.東海橋防災船着場,0,15,15,35.616114,139.74033,2024-02-08 12:00:05
314,A4-12.東京ミッドタウン日比谷,4,0,4,35.674274,139.759111,2024-02-08 12:00:05
315,K1-46.池上駅前自転車駐車場,5,7,12,35.571478,139.702779,2024-02-08 12:00:05
316,I1-24.しながわ区民公園(中央口),2,12,14,35.593611,139.738056,2024-02-08 12:00:05
317,T2-13.セブン-イレブン 練馬石神井町8丁目店,0,5,5,35.750414,139.600011,2024-02-08 12:00:05
318,O3-04.アヴァンセ阿佐ヶ谷,2,0,2,35.712,139.62816,2024-02-08 12:00:05
319,B4-01.黎明橋公園（駐輪場）,3,9,12,35.656071,139.780068,2024-02-08 12:00:05
320,T2-32.セブン-イレブン 練馬東大泉NTTビル店,3,5,8,35.750761,139.594457,2024-02-08 12:00:05
321,K1-142.コーラル洗足池,9,1,10,35.604567,139.689096,2024-02-08 12:00:05
322,K1-28.鵜の木特別出張所,4,0,4,35.574886,139.685122,2024-02-08 12:00:05
323,T1-02.ホテルカデンツァ東京,12,0,12,35.755106,139.621675,2024-02-08 12:00:05
324,C2-16.ザ・ベルグレイヴィア麻布,0,9,9,35.657264,139.743821,2024-02-08 12:00:05
325,N3-11.上高田区民活動センター,3,2,5,35.711501,139.672761,2024-02-08 12:00:05
326,T3-30.北西大松公園,2,2,4,35.765979,139.64931,2024-02-08 12:00:05
327,D6-05.新宿中央公園（水の広場）,5,1,6,35.690474,139.690219,2024-02-08 12:00:05
328,D6-07.新宿フロントタワー,3,6,9,35.696387,139.689924,2024-02-08 12:00:05
329,T2-73.早実グラウンド記念公園,2,2,4,35.734615,139.576214,2024-02-08 12:00:05
330,O7-03.永福町西幸モータープール東,2,9,11,35.67156,139.64609,2024-02-08 12:00:05
331,D1-03.新左門児童遊園,0,5,5,35.684523,139.720519,2024-02-08 12:00:05
332,D1-04.四谷見附公園,0,30,30,35.683448,139.728425,2024-02-08 12:00:05
333,I1-54.天王洲オーシャンスクエア,12,3,15,35.622356,139.749468,2024-02-08 12:00:05
334,D6-01.新宿区役所本庁舎,44,2,46,35.693602,139.703229,2024-02-08 12:00:05
335,D6-02.新宿区役所第二分庁舎,34,1,35,35.693976,139.706134,2024-02-08 12:00:05
336,D6-03.新宿中央公園（ポケットパーク）,9,0,9,35.691559,139.690029,2024-02-08 12:00:05
337,D6-04.新宿中央公園（ちびっこ広場）,8,2,10,35.686649,139.689821,2024-02-08 12:00:05
338,A6-21.日本工営ビル,2,2,4,35.684584,139.734442,2024-02-08 12:00:05
339,I1-77.セブン-イレブン品川西中延1丁目店,0,19,19,35.612217,139.708164,2024-02-08 12:00:05
340,T1-01.光が丘駅前広場,11,2,13,35.759164,139.629466,2024-02-08 12:00:05
341,T2-37.上石神井2丁目,2,6,8,35.729615,139.59532,2024-02-08 12:00:05
342,I1-75.セブン-イレブン品川二葉4丁目店,0,6,6,35.603275,139.713428,2024-02-08 12:00:05
343,M5-13.セブン-イレブン初台店,0,15,15,35.675049,139.68444,2024-02-08 12:00:05
344,D6-24.ＮＴＴ東日本 本社ビル,9,3,12,35.683102,139.688852,2024-02-08 12:00:05
345,H1-134.豊洲ぐるり公園,10,12,22,35.643141,139.777821,2024-02-08 12:00:05
346,H1-133.北砂2丁目公園,0,27,27,35.679001,139.825809,2024-02-08 12:00:05
347,E3-08.サガラマンション,0,4,4,35.722833,139.734662,2024-02-08 12:00:05
348,O4-05.阿佐ヶ谷南1-30,1,2,3,35.700703,139.639985,2024-02-08 12:00:05
349,O5-06.EXAM高円寺南,5,0,5,35.70273,139.65864,2024-02-08 12:00:05
350,G2-03.押上１丁目２６-４,5,0,5,35.710323,139.815215,2024-02-08 12:00:05
351,K1-132.多摩川駅前自転車等駐車場,15,0,15,35.587232,139.669519,2024-02-08 12:00:05
352,C5-47.oak港南品川,23,2,25,35.62413,139.744831,2024-02-08 12:00:05
353,D3-15.カースルいずみ,6,8,14,35.711324,139.711976,2024-02-08 12:00:05
354,C5-15.セブン-イレブン 港区芝浦ふ頭店,0,8,8,35.640215,139.755971,2024-02-08 12:00:05
355,C5-14.セブン-イレブン 港区汐彩橋店,0,12,12,35.640481,139.753659,2024-02-08 12:00:05
356,D5-01.新宿コズミックセンター,0,8,8,35.705244,139.70841,2024-02-08 12:00:05
357,H1-45.夢の島競技場,18,2,20,35.648596,139.824936,2024-02-08 12:00:05
358,E1-01.後楽橋横,25,0,25,35.702746,139.752009,2024-02-08 12:00:05
359,B1-15.ロイヤルパークホテル,0,11,11,35.682332,139.78722,2024-02-08 12:00:05
360,C4-05.白金台駅自転車駐車場,5,10,15,35.638927,139.727083,2024-02-08 12:00:05
361,E1-02.東京ドーム（ミーツポート）,7,2,9,35.70311,139.754951,2024-02-08 12:00:05
362,M2-06.あいおいニッセイ同和損保恵比寿ビル,6,1,7,35.647237,139.71512,2024-02-08 12:00:05
363,J1-12.工大橋下流自転車置場,3,1,4,35.605828,139.680265,2024-02-08 12:00:05
364,C5-25.NEX-TEC芝浦,37,0,37,35.639571,139.755551,2024-02-08 12:00:05
365,H1-175.ダイアパレス大島駅前,0,2,2,35.689543,139.836394,2024-02-08 12:00:05
366,C1-65.東京ポートシティ竹芝,10,3,13,35.654757,139.761516,2024-02-08 12:00:05
367,O2-03.西荻北5-8-17,4,1,5,35.709712,139.601846,2024-02-08 12:00:05
368,B2-21.八重洲二丁目北地区広場,4,0,4,35.67942,139.77004,2024-02-08 12:00:05
369,I1-101.下神明駅前,25,0,25,35.60838,139.726587,2024-02-08 12:00:05
370,N2-04.野方2丁目,6,0,6,35.713018,139.656768,2024-02-08 12:00:05
371,N2-05.野方3丁目,0,12,12,35.717877,139.654732,2024-02-08 12:00:05
372,K1-88.大田久が原西郵便局,0,6,6,35.582756,139.6925,2024-02-08 12:00:05
373,C5-51.トミンタワー台場一番街,0,12,12,35.634627,139.77663,2024-02-08 12:00:05
374,C4-10.亀塚公園,10,0,10,35.642764,139.741174,2024-02-08 12:00:05
375,H1-190.福山通運 東京支店,0,28,28,35.664845,139.796643,2024-02-08 12:00:05
376,C1-80.浜松町262ビル,11,1,12,35.654289,139.75557,2024-02-08 12:00:05
377,B2-19.リエトコートアルクスタワー,0,10,10,35.670506,139.77854,2024-02-08 12:00:05
378,C1-79.髙松コンストラクショングループ 東京本社ビル,0,6,6,35.648765,139.753363,2024-02-08 12:00:05
379,C5-43.オアーゼ芝浦MJビル,7,2,9,35.644798,139.752697,2024-02-08 12:00:05
380,J1-44.五本木2丁目,1,7,8,35.634441,139.687186,2024-02-08 12:00:05
381,B2-17.アーバネックス八丁堀,3,0,3,35.67518,139.77364,2024-02-08 12:00:05
382,M6-16.パールマンション,2,0,2,35.67464,139.67876,2024-02-08 12:00:05
383,G4-06.ドムス・スタイル両国,0,7,7,35.700453,139.798978,2024-02-08 12:00:05
384,G2-04.ラ　ステュディオ押上,3,2,5,35.712157,139.815298,2024-02-08 12:00:05
385,T3-15.セブン-イレブン練馬北町8丁目店,6,0,6,35.768105,139.646049,2024-02-08 12:00:05
386,C1-77.芝公園,13,5,18,35.65513,139.749645,2024-02-08 12:00:05
387,I1-27.小関橋公園,3,1,4,35.620699,139.730904,2024-02-08 12:00:05
388,B3-01.中央区役所,5,0,5,35.670855,139.772052,2024-02-08 12:00:05
389,A6-08.二番町ガーデン,5,0,5,35.685489,139.734562,2024-02-08 12:00:05
390,B1-01.十思公園,0,10,10,35.691058,139.777915,2024-02-08 12:00:05
391,B4-02.月島特別出張所,0,42,42,35.662197,139.782719,2024-02-08 12:00:05
392,A4-05.大手町タワー,18,0,18,35.685938,139.764886,2024-02-08 12:00:05
393,H1-22.豊洲市場（7街区）,29,41,70,35.6447,139.784512,2024-02-08 12:00:05
394,A6-07.二番町センタービル,0,2,2,35.685966,139.736328,2024-02-08 12:00:05
395,A2-12.神保町三井ビルディング,10,0,10,35.694532,139.760695,2024-02-08 12:00:05
396,E2-06.oto no ha Cafe,0,4,4,35.713991,139.725665,2024-02-08 12:00:05
397,B4-10.リバーシティ,0,14,14,35.668795,139.784784,2024-02-08 12:00:05
398,B1-03.常盤公園（北側）,7,3,10,35.688405,139.770068,2024-02-08 12:00:05
399,C5-19.グランドメゾン田町,6,1,7,35.645537,139.754899,2024-02-08 12:00:05
400,K1-11.ファミリーマート かわだ多摩川２丁目店,0,3,3,35.558289,139.697403,2024-02-08 12:00:05
401,J1-43.アルコタワー・ホテル雅叙園東京,12,0,12,35.63237,139.712681,2024-02-08 12:00:05
402,N1-03.鷺宮南駐輪場,7,2,9,35.721827,139.635949,2024-02-08 12:00:05
403,N2-06.江古田1丁目B,1,5,6,35.72515,139.672614,2024-02-08 12:00:05
404,D7-12.プラウド高田馬場,4,1,5,35.715538,139.701683,2024-02-08 12:00:05
405,K1-118.久が原3丁目,0,9,9,35.580741,139.687152,2024-02-08 12:00:05
406,K1-125.池上駅南口第1,1,1,2,35.571866,139.703214,2024-02-08 12:00:05
407,K1-117.安詳寺,5,15,20,35.581798,139.695222,2024-02-08 12:00:05
408,I1-91.アクロス目黒タワー,8,2,10,35.634019,139.719749,2024-02-08 12:00:05
409,K1-126.池上駅南口第2,2,1,3,35.571815,139.702387,2024-02-08 12:00:05
410,C5-50.お台場レインボー公園,12,0,12,35.633133,139.777315,2024-02-08 12:00:05
411,T3-26.富士見ランド公園,0,8,8,35.73701,139.627244,2024-02-08 12:00:05
412,T1-15.つのの山緑地,4,0,4,35.765144,139.636606,2024-02-08 12:00:05
413,T1-16.ゆりの木通り南公園,3,1,4,35.767582,139.636304,2024-02-08 12:00:05
414,H1-185.UR大島六丁目団地(第二),0,3,3,35.690038,139.833252,2024-02-08 12:00:05
415,H1-186.セブン-イレブン亀戸昭和橋通り店,0,9,9,35.694804,139.831357,2024-02-08 12:00:05
416,K1-96.西馬込駅前自転車駐車場,9,5,14,35.586408,139.705425,2024-02-08 12:00:05
417,H1-184.UR大島六丁目団地(第一),3,3,6,35.689913,139.833279,2024-02-08 12:00:05
418,A6-25.麹町仮住宅,4,0,4,35.679192,139.74019,2024-02-08 12:00:05
419,C1-69.塩釜公園,0,11,11,35.662908,139.755014,2024-02-08 12:00:05
420,C1-68.桜田公園,29,0,29,35.665214,139.757008,2024-02-08 12:00:05
421,A2-14.興和一橋ビル,15,0,15,35.6927,139.759311,2024-02-08 12:00:05
422,C5-41.トヨタモビリティ東京 芝浦店,4,2,6,35.639644,139.745532,2024-02-08 12:00:05
423,T2-22.ファミリーマート 石神井台7丁目店,4,1,5,35.731909,139.579685,2024-02-08 12:00:05
424,A6-20.紀尾井町PREX,6,0,6,35.68369,139.736936,2024-02-08 12:00:05
425,C5-24.GLOBAL FRONT TOWER,1,13,14,35.647713,139.755534,2024-02-08 12:00:05
426,E5-09.文京区 男女平等センター,4,11,15,35.70861,139.75768,2024-02-08 12:00:05
427,K1-37.東京サーハウス前,17,4,21,35.563874,139.685011,2024-02-08 12:00:05
428,B4-15.リバーシティ　イーストタワーズ,0,18,18,35.669188,139.785301,2024-02-08 12:00:05
429,M6-08.Be Good 幡ヶ谷,0,13,13,35.682453,139.677687,2024-02-08 12:00:05
430,D5-09.ハウジングステージ新宿,6,7,13,35.702277,139.701214,2024-02-08 12:00:05
431,D6-21.新宿5丁目,2,5,7,35.691613,139.711233,2024-02-08 12:00:05
432,K1-39.東京モノレール 流通センター駅前,28,0,28,35.581752,139.748705,2024-02-08 12:00:05
433,K1-38.ネクストサイト蒲田ビル,8,0,8,35.558916,139.717253,2024-02-08 12:00:05
434,T3-17.練馬区役所東庁舎(第二),5,0,5,35.735585,139.652544,2024-02-08 12:00:05
435,H1-107.大島小松川公園,0,27,27,35.692641,139.846346,2024-02-08 12:00:05
436,B1-11.浜町川緑道,18,29,47,35.684158,139.787649,2024-02-08 12:00:05
437,A6-19.番町麹町ビルディング,12,0,12,35.685578,139.732078,2024-02-08 12:00:05
438,B3-12.築地場外市場,18,0,18,35.665254,139.769301,2024-02-08 12:00:05
439,I1-40.御殿山トラストタワー,26,0,26,35.622371,139.737457,2024-02-08 12:00:05
440,M5-08.古賀政男音楽博物館,2,0,2,35.668091,139.680243,2024-02-08 12:00:05
441,H1-90.富士倉庫運輸(株) FACE-1前,0,11,11,35.655102,139.805205,2024-02-08 12:00:05
442,A3-38.パークホームズ千代田淡路町,4,0,4,35.695163,139.769566,2024-02-08 12:00:05
443,D2-11.神楽坂アインスタワー,2,4,6,35.702833,139.739,2024-02-08 12:00:05
444,C2-04.飯倉いきいきプラザ,0,5,5,35.656991,139.740739,2024-02-08 12:00:05
445,B1-09.スマイルホテル日本橋三越前,18,0,18,35.686101,139.776089,2024-02-08 12:00:05
446,E5-15.文京千駄木の郷,7,4,11,35.726499,139.759884,2024-02-08 12:00:05
447,C2-05.ありすいきいきプラザ,9,4,13,35.651046,139.727745,2024-02-08 12:00:05
448,C5-06.品川シーズンテラス,19,0,19,35.632303,139.742393,2024-02-08 12:00:05
449,B1-10.箱崎川第二公園,6,3,9,35.680833,139.784267,2024-02-08 12:00:05
450,L1-15.ソフィア,0,3,3,35.663222,139.587803,2024-02-08 12:00:05
451,A3-12.秋葉原UDX北側駐輪場前,15,0,15,35.70111,139.772855,2024-02-08 12:00:05
452,A2-08.KDX御茶ノ水ビル,6,3,9,35.700568,139.76013,2024-02-08 12:00:05
453,A3-07.淡路公園,5,1,6,35.696942,139.767302,2024-02-08 12:00:05
454,A1-08.飯田橋サクラテラス（早稲田通り）,11,0,11,35.699132,139.74462,2024-02-08 12:00:05
455,A3-13.富士ソフトビル（駐車場入口横）,4,14,18,35.700486,139.774254,2024-02-08 12:00:05
456,A2-09.テラススクエア,8,0,8,35.6931,139.7599,2024-02-08 12:00:05
457,A6-11.東京ガーデンテラス紀尾井町,17,5,22,35.67962,139.7364,2024-02-08 12:00:05
458,K1-124.矢口2丁目,1,5,6,35.564161,139.695187,2024-02-08 12:00:05
459,N3-15.ライオンズマンション中野東,1,2,3,35.71046,139.6855,2024-02-08 12:00:05
460,M3-11.渋谷道玄坂東急ビル,8,2,10,35.65718,139.698687,2024-02-08 12:00:05
461,H1-180.シティコート大島,7,1,8,35.691954,139.836462,2024-02-08 12:00:05
462,B1-27.日本橋本町4丁目,24,4,28,35.68973,139.77598,2024-02-08 12:00:05
463,M3-22.森谷ビル,15,0,15,35.64514,139.71686,2024-02-08 12:00:05
464,N3-17.東中野3丁目,10,0,10,35.70862,139.680679,2024-02-08 12:00:05
465,N2-10.関根ビル,2,3,5,35.733432,139.671241,2024-02-08 12:00:05
466,T1-06.秋の陽公園,5,0,5,35.762326,139.635226,2024-02-08 12:00:05
467,N1-02.鷺宮東駐輪場,0,14,14,35.721556,139.640397,2024-02-08 12:00:05
468,K1-140.西馬込駅前自転車駐車場(奥),14,0,14,35.586382,139.705116,2024-02-08 12:00:05
469,H1-182.錦糸町プライムタワー,13,1,14,35.695695,139.820507,2024-02-08 12:00:05
470,E5-05.駒込地域活動センター,0,9,9,35.728644,139.752183,2024-02-08 12:00:05
471,M3-06.渋谷第一生命ビル,6,0,6,35.657556,139.704129,2024-02-08 12:00:05
472,T2-42.石神井公園駅北第二自転車駐車場,2,3,5,35.74553,139.608939,2024-02-08 12:00:05
473,K1-144.蒲田五丁目44番自転車駐車場,10,0,10,35.559809,139.716993,2024-02-08 12:00:05
474,M3-07.渋谷ファーストプレイス,10,0,10,35.65506,139.69384,2024-02-08 12:00:05
475,H1-74.タダノ教習センター,10,0,10,35.63848,139.832305,2024-02-08 12:00:05
476,Z22.みんちゅう京急川崎駅前駐輪場内ラックスペース,3,0,3,35.532615,139.700332,2024-02-08 12:00:05
477,H1-151.コスモリード錦糸町,0,9,9,35.701347,139.819973,2024-02-08 12:00:05
478,T2-23.セブン-イレブン 練馬南大泉5丁目店,6,0,6,35.750185,139.579216,2024-02-08 12:00:05
479,M4-13.J-cube,3,0,3,35.66616,139.70458,2024-02-08 12:00:05
480,T2-65.さくらの辻公園,0,5,5,35.734805,139.599906,2024-02-08 12:00:05
481,T2-24.セブン-イレブン 練馬インター店,0,27,27,35.754586,139.606409,2024-02-08 12:00:05
482,O5-05.モンテ・ベルテ,0,2,2,35.701454,139.650518,2024-02-08 12:00:05
483,J1-42.都立大学駅北口バス停前,5,4,9,35.618622,139.67596,2024-02-08 12:00:05
484,K1-97.トミンタワー多摩川二丁目,0,14,14,35.555561,139.704345,2024-02-08 12:00:05
485,D1-14.コモレ四谷,0,7,7,35.68752,139.72818,2024-02-08 12:00:05
486,K1-106.ファミリーマート上池台夫婦坂店,0,9,9,35.599329,139.703343,2024-02-08 12:00:05
487,J1-39.松見坂公園,0,11,11,35.655483,139.687325,2024-02-08 12:00:05
488,J1-40.西小山公園,5,3,8,35.616541,139.697369,2024-02-08 12:00:05
489,J1-38.林試の森公園 北,6,6,12,35.626355,139.700153,2024-02-08 12:00:05
490,I1-84.セブン-イレブン西品川2丁目店,0,3,3,35.613819,139.728418,2024-02-08 12:00:05
491,D6-26.セブン-イレブン新宿６丁目文化センター通り店,8,1,9,35.694951,139.708219,2024-02-08 12:00:05
492,T2-25.ファミリーマート 高野台二丁目店,0,5,5,35.746045,139.620087,2024-02-08 12:00:05
493,I1-85.GOODOFFICE品川,0,5,5,35.621081,139.741178,2024-02-08 12:00:05
494,K1-74.大田スタジアム,3,4,7,35.587423,139.753871,2024-02-08 12:00:05
495,C1-64.東京虎ノ門グローバルスクエア,3,2,5,35.669941,139.749261,2024-02-08 12:00:05
496,K1-72.ファミリーマート大森西四丁目店,0,7,7,35.573358,139.723105,2024-02-08 12:00:05
497,H1-118.ファミリーマート亀戸駅前店,6,5,11,35.69839,139.825484,2024-02-08 12:00:05
498,I1-62.天王洲Rim,0,6,6,35.622277,139.745638,2024-02-08 12:00:05
499,H1-40.深川東京モダン館,3,1,4,35.674076,139.795008,2024-02-08 12:00:05
500,H1-117.東京パークサイドビル,8,3,11,35.671225,139.808561,2024-02-08 12:00:05
501,J1-01.目黒区総合庁舎,8,1,9,35.640675,139.698088,2024-02-08 12:00:05
502,C5-16.品川インターシティ,23,0,23,35.626704,139.742174,2024-02-08 12:00:05
503,A1-12.北の丸スクエア,7,0,7,35.695515,139.750213,2024-02-08 12:00:05
504,H1-46.セブン-イレブン 江東枝川2丁目店,0,27,27,35.659287,139.807358,2024-02-08 12:00:05
505,A2-25.プラウド神田駿河台,11,2,13,35.698991,139.76091,2024-02-08 12:00:05
506,C5-49.プラウドタワー芝浦,0,15,15,35.638912,139.747422,2024-02-08 12:00:05
507,T3-25.北町みのり公園,0,4,4,35.767627,139.65243,2024-02-08 12:00:05
508,H1-75.ジオ深川住吉,0,10,10,35.684247,139.815638,2024-02-08 12:00:05
509,T1-09.ローソン練馬旭町一丁目店,3,2,5,35.765704,139.625178,2024-02-08 12:00:05
510,T2-26.ファミリーマート 大泉学園町四丁目店,0,8,8,35.767388,139.587625,2024-02-08 12:00:05
511,T2-27.ファミリーマート 大泉長久保通り店,2,3,5,35.773841,139.591456,2024-02-08 12:00:05
512,C3-19.明治記念館西,3,1,4,35.678179,139.720809,2024-02-08 12:00:05
513,I1-11.鮫洲入江広場,11,3,14,35.603984,139.744504,2024-02-08 12:00:05
514,I1-10.品川シーサイド公園第1,15,3,18,35.607717,139.749478,2024-02-08 12:00:05
515,I1-09.東品川海上公園第1,0,15,15,35.616633,139.748945,2024-02-08 12:00:05
516,D3-06.セブン-イレブン高田馬場3丁目中央店,0,7,7,35.713872,139.698301,2024-02-08 12:00:05
517,K1-40.大田文化の森,0,16,16,35.579649,139.720263,2024-02-08 12:00:05
518,C1-41.港区立エコプラザ,6,3,9,35.658709,139.757036,2024-02-08 12:00:05
519,I1-13.八潮北公園,0,12,12,35.613421,139.75375,2024-02-08 12:00:05
520,I1-12.しながわ区民公園（北側）,2,2,4,35.596091,139.740884,2024-02-08 12:00:05
521,T2-09.こぐれの森緑地,3,7,10,35.763741,139.588847,2024-02-08 12:00:05
522,T3-31.パークサイド関口,4,4,8,35.74097,139.63836,2024-02-08 12:00:05
523,H1-183.MFLP新木場1,4,0,4,35.643958,139.838358,2024-02-08 12:00:05
524,T2-33.ウインドヒルズ189,2,4,6,35.74642,139.581204,2024-02-08 12:00:05
525,T2-67.陽和病院,0,7,7,35.761211,139.603316,2024-02-08 12:00:05
526,H1-82.セブンｰイレブン 北砂3丁目明治通り店,0,21,21,35.683514,139.827081,2024-02-08 12:00:05
527,T2-60.武蔵関公園（第一）,9,0,9,35.724747,139.565817,2024-02-08 12:00:05
528,I1-48.NTT 東日本 関東病院(北側),5,4,9,35.632191,139.725002,2024-02-08 12:00:05
529,T2-58.立野公園,3,2,5,35.716776,139.577975,2024-02-08 12:00:05
530,I1-100.東急荏原中延駅駐輪場,3,4,7,35.610444,139.712333,2024-02-08 12:00:05
531,T2-56.大泉公園（第一）,2,2,4,35.77228,139.58325,2024-02-08 12:00:05
532,T2-55.大泉町もみじやま公園,0,3,3,35.767296,139.602321,2024-02-08 12:00:05
533,T2-54.土支田農業公園,0,9,9,35.760939,139.609264,2024-02-08 12:00:05
534,I1-44.大井三ツ又商店街入口,6,0,6,35.604606,139.734483,2024-02-08 12:00:05
535,T2-62.大泉井頭公園,6,4,10,35.746681,139.57754,2024-02-08 12:00:05
536,T2-61.武蔵関公園（第二）,4,0,4,35.727826,139.570056,2024-02-08 12:00:05
537,T3-09.学田公園,4,1,5,35.730428,139.648704,2024-02-08 12:00:05
538,K1-105.東糀谷二丁目児童公園,0,8,8,35.555702,139.740802,2024-02-08 12:00:05
539,Z02.NTT渡田ビル,2,4,6,35.513644,139.712594,2024-02-08 12:00:05
540,T3-04.サンパレス平和台,8,4,12,35.759827,139.659121,2024-02-08 12:00:05
541,K1-104.六郷BASE,1,5,6,35.543573,139.714393,2024-02-08 12:00:05
542,M4-16.神宮前6丁目,2,1,3,35.668673,139.702816,2024-02-08 12:00:05
543,K1-69.京急平和島第2Bバイク駐輪場,0,7,7,35.585747,139.735242,2024-02-08 12:00:05
544,H1-155.メブクス豊洲,13,7,20,35.645726,139.784496,2024-02-08 12:00:05
545,C2-11.一の橋,7,46,53,35.654726,139.737491,2024-02-08 12:00:05
546,C4-11.ザ・パークハウス 三田ガーデン,0,14,14,35.64816,139.737991,2024-02-08 12:00:05
547,H1-161.昭文社制作本部ビル,4,2,6,35.684003,139.794983,2024-02-08 12:00:05
548,N2-07.新井区民活動センター,2,3,5,35.714292,139.663327,2024-02-08 12:00:05
549,K1-87.羽田イノベーションシティ,2,8,10,35.547061,139.756277,2024-02-08 12:00:05
550,N3-16.COURT 5,5,0,5,35.699743,139.664608,2024-02-08 12:00:05
551,C4-01.高輪地区総合支所(5F),1,10,11,35.641833,139.734519,2024-02-08 12:00:05
552,C5-48.セブンイレブン港区海岸三丁目店,0,8,8,35.636808,139.752517,2024-02-08 12:00:05
553,H1-42.江東区スポーツ会館,0,29,29,35.683961,139.821559,2024-02-08 12:00:05
554,B2-10.東京ダイヤビルディング（北側）,0,12,12,35.675702,139.785229,2024-02-08 12:00:05
555,H1-43.東京イースト21,0,18,18,35.675639,139.815255,2024-02-08 12:00:05
556,B3-20.歌舞伎座タワー駐輪場2F,6,0,6,35.670106,139.768041,2024-02-08 12:00:05
557,B3-21.歌舞伎座タワー駐輪場3F,11,0,11,35.6701,139.76801,2024-02-08 12:00:05
558,Z06.ローソン川崎殿町店,5,8,13,35.537434,139.744509,2024-02-08 12:00:05
559,K1-139.プラットホステル京急 羽田ホーム,8,2,10,35.548104,139.748889,2024-02-08 12:00:05
560,J1-58.目黒女子会館前,3,2,5,35.629011,139.69716,2024-02-08 12:00:05
561,T2-18.ファミリーマート練馬西税務署前店,2,2,4,35.745505,139.580878,2024-02-08 12:00:05
562,C3-23.LIFORK 南青山 北エントランス,14,15,29,35.669916,139.725701,2024-02-08 12:00:05
563,C1-46.新虎通りCORE,14,2,16,35.665124,139.754054,2024-02-08 12:00:05
564,C1-45.浜松町クレアタワー,17,2,19,35.656324,139.755927,2024-02-08 12:00:05
565,K1-53.セブン-イレブン 田園調布郵便局前店,15,5,20,35.589309,139.678587,2024-02-08 12:00:05
566,K1-52.大田区総合体育館,7,0,7,35.564152,139.727422,2024-02-08 12:00:05
567,T1-12.ファミリーマート 高松六丁目店,3,1,4,35.756873,139.616612,2024-02-08 12:00:05
568,D7-07.ローソン 新宿西落合三丁目店,0,5,5,35.725171,139.675897,2024-02-08 12:00:05
569,A6-16.一番町第二TGビル,3,2,5,35.688351,139.744321,2024-02-08 12:00:05
570,C3-33.PASONA SQUARE,12,0,12,35.667462,139.716058,2024-02-08 12:00:05
571,A3-24.岩本町ほほえみプラザ,0,10,10,35.69441,139.777715,2024-02-08 12:00:05
572,H1-35.ヒューリック豊洲プライムスクエア,7,0,7,35.652376,139.797724,2024-02-08 12:00:05
573,C5-11.フェイバリッチタワー品川,0,57,57,35.631729,139.749767,2024-02-08 12:00:05
574,E2-13.デルックス文京神楽坂,0,4,4,35.70781,139.732227,2024-02-08 12:00:05
575,C5-01.こうなん星の公園,47,0,47,35.629697,139.742167,2024-02-08 12:00:05
576,C5-02.港南緑水公園,0,79,79,35.628955,139.750731,2024-02-08 12:00:05
577,A3-22.龍閑児童公園,1,7,8,35.693234,139.779702,2024-02-08 12:00:05
578,A3-21.神田ふれあい通り第３,7,5,12,35.695176,139.772832,2024-02-08 12:00:05
579,H1-30.江東区役所（北側）,9,3,12,35.67338,139.8164,2024-02-08 12:00:05
580,C1-17.港区役所,4,0,4,35.657866,139.751068,2024-02-08 12:00:05
581,H1-31.江東区役所（南側）,17,0,17,35.67214,139.8166,2024-02-08 12:00:05
582,C1-09.愛宕グリーンヒルズ,9,0,9,35.662051,139.748132,2024-02-08 12:00:05
583,D1-02.四谷特別出張所（新宿御苑大木戸門前）,16,1,17,35.687435,139.714169,2024-02-08 12:00:05
584,D1-01.花園西公園,5,0,5,35.690612,139.711631,2024-02-08 12:00:05
585,C1-04.虎ノ門ヒルズ,12,2,14,35.666527,139.748804,2024-02-08 12:00:05
586,C1-05.西新橋2丁目（新虎通り）,14,0,14,35.665593,139.752617,2024-02-08 12:00:05
587,C1-73.日比谷フォートタワー,14,0,14,35.669871,139.753147,2024-02-08 12:00:05
588,K1-102.上池台四丁目公園,0,7,7,35.595119,139.6996,2024-02-08 12:00:05
589,M2-01.恵比寿保健相談所（恵比寿社会教育館）,0,15,15,35.64524,139.71946,2024-02-08 12:00:05
590,I1-98.コーポ荏原,0,6,6,35.60411,139.709784,2024-02-08 12:00:05
591,C3-17.セブン-イレブン 港区溜池山王店,0,18,18,35.670308,139.743242,2024-02-08 12:00:05
592,T2-11.石神井松の風文化公園,2,1,3,35.739471,139.595578,2024-02-08 12:00:05
593,M2-03.サイカパーク恵比寿,15,0,15,35.646581,139.710613,2024-02-08 12:00:05
594,M2-02.アメリカ橋公園,8,0,8,35.643606,139.713099,2024-02-08 12:00:05
595,T2-50.North Ridge 吉祥寺,8,1,9,35.72305,139.579555,2024-02-08 12:00:05
596,J1-35.目黒川田道街かど公園,5,1,6,35.634574,139.710332,2024-02-08 12:00:05
597,H1-174.ジュネス(エントランス側),0,2,2,35.682712,139.823961,2024-02-08 12:00:05
598,M6-17.笹塚一丁目駐輪場,1,6,7,35.672922,139.668729,2024-02-08 12:00:05
599,C4-14.神応ほっとプラザ,3,7,10,35.643711,139.724753,2024-02-08 12:00:05
600,K1-107.馬込駅A2出口,5,5,10,35.596854,139.712139,2024-02-08 12:00:05
601,T3-11.ガラクタ公園,1,2,3,35.740321,139.631256,2024-02-08 12:00:05
602,T2-80.みその緑地,2,3,5,35.756825,139.590528,2024-02-08 12:00:05
603,T3-24.AZEST新桜台,5,2,7,35.743962,139.670315,2024-02-08 12:00:05
604,D4-07.新宿余丁町ビル,0,9,9,35.698512,139.716482,2024-02-08 12:00:05
605,Z23.NA川崎南町,4,0,4,35.524976,139.697495,2024-02-08 12:00:05
606,T3-01.練馬春日町駅自転車駐車場,7,0,7,35.751438,139.641265,2024-02-08 12:00:05
607,H1-89.BUDDY スポーツアリーナ,7,7,14,35.637041,139.781088,2024-02-08 12:00:05
608,E5-14.上野広小路駅（湯島側）,5,8,13,35.707313,139.771857,2024-02-08 12:00:05
609,H1-109.Brillia ist 東雲キャナルコート東側,0,46,46,35.648008,139.803487,2024-02-08 12:00:05
610,H1-108.Brillia ist 東雲キャナルコート北側,0,21,21,35.648431,139.803125,2024-02-08 12:00:05
611,C1-53.ホテルリブマックス新橋,4,0,4,35.661149,139.754612,2024-02-08 12:00:05
612,D7-10.染の里 おちあい,1,5,6,35.715211,139.689788,2024-02-08 12:00:05
613,A1-15.富士見みらい館,0,6,6,35.697167,139.745629,2024-02-08 12:00:05
614,E4-15.千石4丁目,2,3,5,35.729153,139.741368,2024-02-08 12:00:05
615,H1-111.ファミリーマート木場六丁目店,0,9,9,35.66688,139.80779,2024-02-08 12:00:05
616,C5-36.お台場海浜公園駅,3,0,3,35.62974,139.778178,2024-02-08 12:00:05
617,H1-10.出会い橋,15,0,15,35.625029,139.777344,2024-02-08 12:00:05
618,H1-11.テレコムセンター駅,6,15,21,35.61813,139.778698,2024-02-08 12:00:05
619,H1-47.トピレックプラザ,0,37,37,35.672481,139.835877,2024-02-08 12:00:05
620,H1-13.アーバンドック ららぽーと豊洲,19,0,19,35.654067,139.792376,2024-02-08 12:00:05
621,T2-66.大泉学園町希望ヶ丘公園,0,4,4,35.778605,139.588883,2024-02-08 12:00:05
622,C5-37.台場駅,0,24,24,35.626388,139.772453,2024-02-08 12:00:05
623,H1-16.豊洲三丁目公園,19,0,19,35.657477,139.796629,2024-02-08 12:00:05
624,H1-17.東雲水辺公園,0,69,69,35.64704,139.80469,2024-02-08 12:00:05
625,C1-72.新田町ビル,10,1,11,35.646307,139.746428,2024-02-08 12:00:05
626,K1-98.鵜の木松山公園,2,5,7,35.577433,139.680752,2024-02-08 12:00:05
627,C1-71.芝商業高校前交差点,0,7,7,35.65583,139.759896,2024-02-08 12:00:05
628,H1-122.東砂スポーツセンター,0,11,11,35.679167,139.839746,2024-02-08 12:00:05
629,O6-05.コージーコート久我山,0,5,5,35.687531,139.60439,2024-02-08 12:00:05
630,T2-39.ローソン 練馬大泉町五丁目店,7,1,8,35.758929,139.597548,2024-02-08 12:00:05
631,J1-50.大岡山公園,2,2,4,35.609958,139.684087,2024-02-08 12:00:05
632,J1-51.池尻大橋駅東口駐輪場,0,5,5,35.650627,139.687228,2024-02-08 12:00:05
633,K1-99.東原くすのき公園,7,1,8,35.584086,139.67898,2024-02-08 12:00:05
634,N3-12.桃園区民活動センター,3,0,3,35.702414,139.667327,2024-02-08 12:00:05
635,H1-191.三井リンクラボ新木場2,14,0,14,35.644863,139.831107,2024-02-08 12:00:05
636,M5-09.代々木上原駅前,5,0,5,35.66865,139.679251,2024-02-08 12:00:05
637,O3-09.NTT井草ビル第3ポート,4,3,7,35.714151,139.61693,2024-02-08 12:00:05
638,T1-07.土支田一丁目（笹目通り）,2,8,10,35.765913,139.619285,2024-02-08 12:00:05
639,K1-22.矢口特別出張所,2,3,5,35.562324,139.690486,2024-02-08 12:00:05
640,T3-08.中新井川児童遊園,2,5,7,35.728268,139.649188,2024-02-08 12:00:05
641,H1-78.ローソン新木場一丁目店,14,0,14,35.645604,139.834941,2024-02-08 12:00:05
642,A6-13.番町会館,5,1,6,35.689131,139.733071,2024-02-08 12:00:05
643,H1-71.セブン-イレブン 江東東陽4丁目,0,4,4,35.670906,139.819386,2024-02-08 12:00:05
644,D2-09.セブン-イレブン 新宿岩戸町店,3,0,3,35.700993,139.736355,2024-02-08 12:00:05
645,I1-08.天王洲アイル第一水辺広場,27,4,31,35.622294,139.751644,2024-02-08 12:00:05
646,I1-07.しながわ水族館,0,16,16,35.590641,139.736354,2024-02-08 12:00:05
647,D3-09.西早稲田3丁目,2,2,4,35.712545,139.713319,2024-02-08 12:00:05
648,E1-16.小石川3丁目緑地,0,21,21,35.714338,139.746346,2024-02-08 12:00:05
649,C5-28.芝浦ルネサイトタワー,6,1,7,35.643683,139.7506,2024-02-08 12:00:05
650,I1-59.文庫の森第一,14,7,21,35.612357,139.721484,2024-02-08 12:00:05
651,I1-60.文庫の森第二,0,5,5,35.611368,139.720424,2024-02-08 12:00:05
652,C1-38.KDX西新橋ビル（西側）,2,3,5,35.66495,139.750459,2024-02-08 12:00:05
653,C1-37.KDX西新橋ビル（北側）,3,2,5,35.665218,139.750827,2024-02-08 12:00:05
654,T2-14.NPC24H東大泉第6パーキング,0,6,6,35.747807,139.593599,2024-02-08 12:00:05
655,C3-12.赤坂センタービルディング前（青山通り）,1,7,8,35.676732,139.733905,2024-02-08 12:00:05
656,H1-36.フジゴルフセンター,0,23,23,35.66605,139.806699,2024-02-08 12:00:05
657,C1-27.虎ノ門2丁目タワー,14,0,14,35.668547,139.747175,2024-02-08 12:00:05
658,C5-12.第2東運ビル,5,3,8,35.633742,139.748281,2024-02-08 12:00:05
659,D6-08.新宿イーストサイドスクエア,6,1,7,35.697158,139.707887,2024-02-08 12:00:05
660,A4-08.永代通り（大手町駅B2c出口前）,24,0,24,35.684349,139.766958,2024-02-08 12:00:05
661,H1-37.東雲駅（東京湾岸道路）,32,3,35,35.640618,139.802455,2024-02-08 12:00:05
662,C3-11.赤坂見附南,1,0,1,35.676566,139.737083,2024-02-08 12:00:05
663,M6-04.本町東べんてん橋公園,0,20,20,35.687126,139.680702,2024-02-08 12:00:05
664,I1-79.品川浦第二,11,4,15,35.621904,139.741429,2024-02-08 12:00:05
665,K1-81.コーナン本羽田萩中店,10,3,13,35.549568,139.731093,2024-02-08 12:00:05
666,D6-25.新宿駅東南口自転車駐輪場,29,4,33,35.689755,139.701323,2024-02-08 12:00:05
667,I1-78.セブン-イレブン西大井店,2,8,10,35.601431,139.718659,2024-02-08 12:00:05
668,H1-136.東砂一丁目公園,0,17,17,35.683542,139.839763,2024-02-08 12:00:05
669,A6-23.セブン-イレブン 千代田三番町店,0,14,14,35.689466,139.745316,2024-02-08 12:00:05
670,C5-34.五色橋ビル,0,13,13,35.636644,139.751798,2024-02-08 12:00:05
671,K1-41.郷土博物館,0,11,11,35.588644,139.710413,2024-02-08 12:00:05
672,G2-06.ディアレイシャス押上スカイヴィレッジ,0,5,5,35.71408,139.810588,2024-02-08 12:00:05
673,O3-11.ハイリビング関根,7,1,8,35.707877,139.618926,2024-02-08 12:00:05
674,O7-02.永福中央公園,6,0,6,35.67121,139.64145,2024-02-08 12:00:05
675,K1-29.萩中文化センター,3,6,9,35.55017,139.728146,2024-02-08 12:00:05
676,K1-30.テクノFRONT森ケ崎,2,2,4,35.567922,139.746181,2024-02-08 12:00:05
677,K1-130.COCOONひろば平和島,15,3,18,35.578728,139.735238,2024-02-08 12:00:05
678,H1-81.豊洲IHIビル（北側）,21,0,21,35.659829,139.793243,2024-02-08 12:00:05
679,E4-03.昭和小学校北側（不忍通り）,25,8,33,35.73166,139.748625,2024-02-08 12:00:05
680,C2-12.六本木ファーストビル,15,0,15,35.66249,139.741397,2024-02-08 12:00:05
681,D3-16.セジョリ江戸川橋,4,11,15,35.708734,139.730509,2024-02-08 12:00:05
682,A5-04.日比谷パークフロント前　日比谷公園南面向い歩道上,6,2,8,35.671514,139.753952,2024-02-08 12:00:05
683,C3-22.OMO3東京赤坂 by 星野リゾート,8,0,8,35.674929,139.736053,2024-02-08 12:00:05
684,B1-20.竜閑さくら橋際街角広場,0,19,19,35.688301,139.768958,2024-02-08 12:00:05
685,H1-83.ローソン江東東雲店,0,15,15,35.642165,139.800439,2024-02-08 12:00:05
686,H1-84.NTT東日本辰巳ビル,0,20,20,35.647091,139.817333,2024-02-08 12:00:05
687,C5-26.ピアシティ芝浦ビル,10,4,14,35.644155,139.756216,2024-02-08 12:00:05
688,T3-28.ほしぞら緑地,0,3,3,35.755137,139.661208,2024-02-08 12:00:05
689,I1-88.セブン-イレブン品川南大井3丁目店,1,1,2,35.58768,139.734515,2024-02-08 12:00:05
690,I1-87.セブン-イレブン西大井滝王子通り店,0,8,8,35.599774,139.723467,2024-02-08 12:00:05
691,Z20.川崎キングスカイフロント 東急 REI ホテル,0,10,10,35.540589,139.752918,2024-02-08 12:00:05
692,G4-11.ホテルマイステイズ浅草,19,2,21,35.703972,139.797327,2024-02-08 12:00:05
693,C5-30.フェイム芝浦インターウェーブ,0,11,11,35.647872,139.75391,2024-02-08 12:00:05
694,M6-13.JICA東京,9,3,12,35.673409,139.675203,2024-02-08 12:00:05
695,A4-13.アーバンネット大手町ビル,5,0,5,35.68557,139.766929,2024-02-08 12:00:05
696,B4-27.リバーシティ西ブロック,11,7,18,35.670491,139.784447,2024-02-08 12:00:05
697,K1-143.大森北1丁目,59,1,60,35.584914,139.730504,2024-02-08 12:00:05
698,E5-24.本郷6丁目,3,2,5,35.712445,139.758157,2024-02-08 12:00:05
699,D2-17.genten市ヶ谷店,10,0,10,35.690657,139.73255,2024-02-08 12:00:05
700,A4-14.東京国際フォーラム（有楽町駅ガード側）,8,0,8,35.675739,139.763712,2024-02-08 12:00:05
701,A2-27.丸紅ビル,6,0,6,35.690958,139.759876,2024-02-08 12:00:05
702,K1-135.北千束2丁目,4,2,6,35.608633,139.693653,2024-02-08 12:00:05
703,A1-19.九段会館テラス,4,0,4,35.694065,139.751801,2024-02-08 12:00:05
704,K1-136.BIG FUN 平和島,0,9,9,35.585489,139.740194,2024-02-08 12:00:05
705,K1-137.京浜島つばさ公園,0,14,14,35.571578,139.770532,2024-02-08 12:00:05
706,D1-16.ルネ新宿御苑タワー,6,3,9,35.690155,139.713377,2024-02-08 12:00:05
707,G6-01.オーキッドレジデンス森下,1,6,7,35.692547,139.799231,2024-02-08 12:00:05
708,T2-63.三原台公園,1,6,7,35.751471,139.599835,2024-02-08 12:00:05
709,O4-01.阿佐ヶ谷南公園,1,1,2,35.70328,139.62981,2024-02-08 12:00:05
710,B4-11.ダンスキューブ勝どき,0,17,17,35.656565,139.775073,2024-02-08 12:00:05
711,D1-06.四谷第六小学校北,10,0,10,35.681754,139.715256,2024-02-08 12:00:05
712,T2-64.高野台中央公園,1,2,3,35.746768,139.613885,2024-02-08 12:00:05
713,H1-169.セブンイレブン江東亀戸7丁目東店,0,10,10,35.697157,139.839835,2024-02-08 12:00:05
714,H1-170.セブンイレブン江東亀戸7丁目南店,0,31,31,35.695937,139.838017,2024-02-08 12:00:05
715,B2-16.ホテルサードニクス東京,5,0,5,35.67684,139.77876,2024-02-08 12:00:05
716,I1-93.中央海浜公園前交差点（南側）,4,1,5,35.595498,139.750654,2024-02-08 12:00:05
717,I1-92.中央海浜公園前交差点（北側）,10,0,10,35.595873,139.75134,2024-02-08 12:00:05
718,B1-26.Dash Living Nihonbashi,3,3,6,35.68802,139.78112,2024-02-08 12:00:05
719,H1-158.東京国際交流館,11,1,12,35.621845,139.776833,2024-02-08 12:00:05
720,J1-32.緑が丘駅前高架下,7,0,7,35.606793,139.678372,2024-02-08 12:00:05
721,K1-90.ファミリーマート大田仲池上一丁目店,1,5,6,35.5873,139.701644,2024-02-08 12:00:05
722,K1-91.穴守稲荷神社,4,6,10,35.550027,139.74973,2024-02-08 12:00:05
723,C1-67.京阪神 虎ノ門ビル,16,5,21,35.669228,139.751668,2024-02-08 12:00:05
724,K1-89.ファミリーマート大田千鳥三丁目店,3,2,5,35.572086,139.68708,2024-02-08 12:00:05
725,I1-97.トミンハイム東品川三丁目第二,14,5,19,35.613387,139.749307,2024-02-08 12:00:05
726,T2-51.練馬区役所石神井庁舎,10,0,10,35.743772,139.603317,2024-02-08 12:00:05
727,T2-75.石神井台二丁目緑地,3,0,3,35.734684,139.593628,2024-02-08 12:00:05
728,E5-19.千駄木公園,1,6,7,35.728333,139.757629,2024-02-08 12:00:05
729,E5-18.団子坂上広場,1,10,11,35.724921,139.75903,2024-02-08 12:00:05
730,A5-07.富国生命ビル,3,3,6,35.670452,139.75557,2024-02-08 12:00:05
731,H1-156.つどい橋下,0,9,9,35.630791,139.787396,2024-02-08 12:00:05
732,H1-159.夢の大橋西,16,0,16,35.627599,139.782953,2024-02-08 12:00:05
733,H1-143.ダイバーシティ東京 プラザ,8,2,10,35.624619,139.776006,2024-02-08 12:00:05
734,I1-57.大井水神公園,74,0,74,35.589972,139.729368,2024-02-08 12:00:05
735,B2-15.KABUTO ONE,6,0,6,35.68168,139.77825,2024-02-08 12:00:05
736,K1-64.多摩川グリーンスクエア,0,17,17,35.545459,139.719489,2024-02-08 12:00:05
737,Z07.ローソン川崎渡田三丁目店,0,4,4,35.519137,139.705791,2024-02-08 12:00:05
738,T2-57.大泉公園（第二）,5,1,6,35.771708,139.583551,2024-02-08 12:00:05
739,A4-06.大手町ファーストスクエア,10,0,10,35.686037,139.764472,2024-02-08 12:00:05
740,C1-50.NTT虎ノ門ビル,11,3,14,35.666075,139.748008,2024-02-08 12:00:05
741,C1-23.三田いきいきプラザ,8,1,9,35.648637,139.749834,2024-02-08 12:00:05
742,H1-29.スカイズタワー＆ガーデン,0,74,74,35.647618,139.792152,2024-02-08 12:00:05
743,C1-21.汐留ビルディング,5,5,10,35.657363,139.75918,2024-02-08 12:00:05
744,A3-16.地蔵橋東児童遊園,2,4,6,35.691069,139.775376,2024-02-08 12:00:05
745,Z08.ファミリーマート観音二丁目店,0,10,10,35.526238,139.72907,2024-02-08 12:00:05
746,A3-18.美倉橋北児童遊園,0,11,11,35.69703,139.779928,2024-02-08 12:00:05
747,A4-01.丸ビル（南側駐輪場）,12,0,12,35.680514,139.764002,2024-02-08 12:00:05
748,A3-11.練成公園,0,8,8,35.703735,139.770629,2024-02-08 12:00:05
749,A3-10.芳林公園（北側）,0,9,9,35.701978,139.7698,2024-02-08 12:00:05
750,A6-02.いきいきプラザ一番町（西側駐輪場）,4,4,8,35.687031,139.739327,2024-02-08 12:00:05
751,A6-01.東郷元帥記念公園（南側）,3,2,5,35.689879,139.740178,2024-02-08 12:00:05
752,A5-03.参議院第二別館（永田町駅2番出口）,10,6,16,35.677763,139.74271,2024-02-08 12:00:05
753,A4-03.東京国際フォーラム（メトロD5出口）,8,0,8,35.675843,139.763329,2024-02-08 12:00:05
754,K1-15.セブン‐イレブン 大田区西蒲田店,3,0,3,35.56694,139.716331,2024-02-08 12:00:05
755,K1-49.ローソン仲池上一丁目店,0,10,10,35.586585,139.698552,2024-02-08 12:00:05
756,A2-06.東光電気工事 別館（屋内駐輪場）,7,0,7,35.69919,139.75701,2024-02-08 12:00:05
757,M4-01.新宿タカシマヤ,5,1,6,35.68714,139.702775,2024-02-08 12:00:05
758,M4-03.NTTドコモ代々木ビル,8,2,10,35.684451,139.702884,2024-02-08 12:00:05
759,M3-03.代官山 T-SITE,6,2,8,35.649823,139.700139,2024-02-08 12:00:05
760,K1-14.大森地域庁舎,5,3,8,35.578239,139.723262,2024-02-08 12:00:05
761,C5-46.ウエリスアーバン品川タワー,0,21,21,35.630961,139.746875,2024-02-08 12:00:05
762,C4-13.コシダコネクトビル,0,16,16,35.637765,139.739128,2024-02-08 12:00:05
763,K1-127.第二石井ビル,5,0,5,35.559286,139.722611,2024-02-08 12:00:05
764,C1-74.札の辻スクエア,6,2,8,35.645155,139.744543,2024-02-08 12:00:05
765,H1-164.森下三丁目第三児童遊園,0,19,19,35.68546,139.80244,2024-02-08 12:00:05
766,C1-78.CIRCLES新橋,7,2,9,35.66646,139.752138,2024-02-08 12:00:05
767,C3-34.3rd MINAMI AOYAMA,5,1,6,35.668622,139.715957,2024-02-08 12:00:05
768,O4-06.杉並区役所本庁舎,3,2,5,35.699328,139.636343,2024-02-08 12:00:05
769,D3-14.コーシャハイム高田馬場,5,1,6,35.712413,139.70168,2024-02-08 12:00:05
770,D7-11.新宿清掃事務所,2,4,6,35.716359,139.704377,2024-02-08 12:00:05
771,D5-08.ウエリス新宿早稲田の森,0,9,9,35.704597,139.708397,2024-02-08 12:00:05
772,E2-12.水道2丁目,0,29,29,35.709147,139.739183,2024-02-08 12:00:05
773,M6-10.京王コインパーク幡ヶ谷,0,11,11,35.6772,139.678117,2024-02-08 12:00:05
774,E3-05.文京スポーツセンター,49,11,60,35.721045,139.735687,2024-02-08 12:00:05
775,J1-36.WJ Haus,0,7,7,35.629067,139.711779,2024-02-08 12:00:05
776,K1-51.テクノポートカマタ 第2,11,0,11,35.555808,139.722791,2024-02-08 12:00:05
777,D1-13.新宿御苑新宿門【西側】,0,23,23,35.688945,139.706536,2024-02-08 12:00:05
778,I1-31.セブン-イレブン 品川戸越5丁目店,3,3,6,35.608193,139.719139,2024-02-08 12:00:05
779,T3-27.貫井川緑地,1,3,4,35.738427,139.632251,2024-02-08 12:00:05
780,H1-147.大島四丁目団地,8,9,17,35.68744,139.827075,2024-02-08 12:00:05
781,O4-02.成宗さくら公園,2,0,2,35.69638,139.63482,2024-02-08 12:00:05
782,O1-01.上瀬戸公園,3,1,4,35.72077,139.6045,2024-02-08 12:00:05
783,T2-15.NPC24H大泉学園南口パーキング,10,0,10,35.748611,139.584251,2024-02-08 12:00:05
784,O3-03.桃井1丁目5番地,6,1,7,35.71013,139.61194,2024-02-08 12:00:05
785,H1-08.東京テレポート駅,17,28,45,35.627087,139.779779,2024-02-08 12:00:05
786,H1-05.相鉄グランドフレッサ 東京ベイ有明,13,1,14,35.632148,139.79017,2024-02-08 12:00:05
787,H1-06.武蔵野大学,2,13,15,35.630185,139.786618,2024-02-08 12:00:05
788,A4-15.TOKIWAブリッジ,9,0,9,35.686389,139.769237,2024-02-08 12:00:05
789,H1-160.花の広場,8,9,17,35.633908,139.793322,2024-02-08 12:00:05
790,H1-01.豊洲ＩＨＩビル前（晴海通り）,9,1,10,35.658911,139.792531,2024-02-08 12:00:05
791,H1-02.豊洲駅,16,0,16,35.654196,139.79626,2024-02-08 12:00:05
792,J1-19.NTT東日本自由が丘ビル,3,1,4,35.615098,139.675954,2024-02-08 12:00:05
793,C2-19.広尾駅,4,0,4,35.650732,139.72256,2024-02-08 12:00:05
794,H1-114.東京夢の島マリーナ,5,10,15,35.651987,139.830691,2024-02-08 12:00:05
795,K1-71.ファミリーマート大田大森南店,0,19,19,35.562769,139.74327,2024-02-08 12:00:05
796,J1-20.すずめのお宿緑地公園,2,7,9,35.617773,139.685351,2024-02-08 12:00:05
797,H1-115.東京夢の島マリーナ 第4駐車場,2,12,14,35.650235,139.835993,2024-02-08 12:00:05
798,M5-10.富ヶ谷2丁目,14,3,17,35.665961,139.686491,2024-02-08 12:00:05
799,J1-21.中央緑地公園,0,9,9,35.630694,139.690482,2024-02-08 12:00:05
800,H1-116.出会い橋高架下,27,22,49,35.625037,139.777646,2024-02-08 12:00:05
801,M3-12.渋谷南東急ビル,6,0,6,35.656228,139.706284,2024-02-08 12:00:05
802,T2-01.大泉学園駅北口,3,2,5,35.749918,139.58618,2024-02-08 12:00:05
803,K1-06.大森駅入新井自転車駐車場,5,0,5,35.585269,139.726279,2024-02-08 12:00:05
804,D6-06.新宿中央公園（エコギャラリー下）,0,15,15,35.691199,139.687966,2024-02-08 12:00:05
805,D6-14.新宿ファーストウエスト,13,1,14,35.689529,139.695995,2024-02-08 12:00:05
806,D6-15.住友不動産西新宿ビル,10,1,11,35.69465,139.695911,2024-02-08 12:00:05
807,H1-56.南砂三丁目緑地公園西,0,30,30,35.672361,139.829825,2024-02-08 12:00:05
808,T2-74.扇橋公園,2,3,5,35.731791,139.588844,2024-02-08 12:00:05
809,B2-20.SHビル,3,1,4,35.675398,139.779962,2024-02-08 12:00:05
810,I1-17.東品川海上公園第2,0,18,18,35.616364,139.749171,2024-02-08 12:00:05
811,I1-16.品川浦,13,1,14,35.6214,139.741958,2024-02-08 12:00:05
812,A4-11.二重橋前駅(メトロ4番出口),5,0,5,35.680753,139.762069,2024-02-08 12:00:05
813,H1-76.有明物流センター,0,19,19,35.638571,139.78829,2024-02-08 12:00:05
814,K1-43.北馬込わくわく公園,0,14,14,35.600707,139.703216,2024-02-08 12:00:05
815,K1-42.馬込西公園,11,3,14,35.58849,139.70376,2024-02-08 12:00:05
816,T1-08.セブン-イレブン 練馬高松6丁目店,4,0,4,35.756506,139.620347,2024-02-08 12:00:05
817,T2-17.ファミリーマート 練馬石神井町八丁目店,0,6,6,35.74755,139.597968,2024-02-08 12:00:05
818,K1-31.テクノWING,0,12,12,35.546252,139.731708,2024-02-08 12:00:05
819,K1-32.石川町文化センター,5,0,5,35.601958,139.682876,2024-02-08 12:00:05
820,I1-20.しおじ公園,9,11,20,35.59632,139.751279,2024-02-08 12:00:05
821,I1-19.品川シーサイド公園第2,7,0,7,35.607571,139.749108,2024-02-08 12:00:05
822,J1-29.カスタリア目黒鷹番,2,3,5,35.626121,139.688576,2024-02-08 12:00:05
823,H1-127.古石場川親水公園,0,38,38,35.669291,139.795364,2024-02-08 12:00:05
824,D4-05.カスタリア新宿7丁目,0,14,14,35.700732,139.711472,2024-02-08 12:00:05
825,I1-71.セブン-イレブン南大井浜川店,0,4,4,35.596483,139.7355,2024-02-08 12:00:05
826,I1-72.セブン-イレブン大井店,0,22,22,35.600081,139.728193,2024-02-08 12:00:05
827,T3-21.くまのやま緑地,4,1,5,35.747038,139.667965,2024-02-08 12:00:05
828,K1-110.萩中集会所裏,9,5,14,35.550479,139.739538,2024-02-08 12:00:05
829,O2-02.シエール荻窪,30,0,30,35.708265,139.612703,2024-02-08 12:00:05
830,H1-128.豊洲市場（5街区）,30,4,34,35.645162,139.785386,2024-02-08 12:00:05
831,N1-09.若宮レジデンス,1,4,5,35.716184,139.643905,2024-02-08 12:00:05
832,M6-12.LIVART SEASON 幡ヶ谷,0,15,15,35.683156,139.67338,2024-02-08 12:00:05
833,H1-142.東京ベイ潮見プリンスホテル,0,18,18,35.660632,139.817294,2024-02-08 12:00:05
834,G1-01.鐘ヶ淵駅南自転車駐車場,1,8,9,35.732291,139.82012,2024-02-08 12:00:05
835,M1-01.渋谷区役所,8,0,8,35.66362,139.69801,2024-02-08 12:00:05
836,I1-83.かもめ歩道橋,0,25,25,35.600161,139.749902,2024-02-08 12:00:05
837,N4-05.セブン-イレブン中野鍋横店,3,2,5,35.693815,139.668571,2024-02-08 12:00:05
838,D4-02.JICA市ヶ谷ビル（地球ひろば／研究所）,7,0,7,35.694927,139.731328,2024-02-08 12:00:05
839,T3-19.なかみや児童遊園,1,4,5,35.749388,139.651824,2024-02-08 12:00:05
840,N1-08.上鷺自転車保管場所,2,5,7,35.729056,139.627864,2024-02-08 12:00:05
841,O7-06.松木1丁目,2,11,13,35.686015,139.642784,2024-02-08 12:00:05
842,E4-16.ビレッジワン,1,6,7,35.723723,139.740143,2024-02-08 12:00:05
843,D1-15.フロンティア四谷,3,6,9,35.68768,139.71937,2024-02-08 12:00:05
844,K1-128.大森西3丁目,1,14,15,35.571975,139.732137,2024-02-08 12:00:05
845,N1-06.大和区民活動センター,0,5,5,35.713562,139.649075,2024-02-08 12:00:05
846,G4-01.両国ビューホテル1,1,6,7,35.69566,139.79214,2024-02-08 12:00:05
847,G4-02.両国ビューホテル2,0,8,8,35.69562,139.79206,2024-02-08 12:00:05
848,G4-05.両国駅西口臨時自転車駐車場,18,2,20,35.698588,139.792946,2024-02-08 12:00:05
849,G4-03.本所1-6-5,11,3,14,35.702525,139.796632,2024-02-08 12:00:05
850,G5-01.牡丹橋自転車駐車場,15,2,17,35.693059,139.813417,2024-02-08 12:00:05
851,G5-02.横川3-7-10,17,20,37,35.70378,139.814298,2024-02-08 12:00:05
852,G4-04.NTTドコモ墨田ビル,14,7,21,35.697898,139.795345,2024-02-08 12:00:05
853,G2-02.押上1-23-8,1,6,7,35.710111,139.81488,2024-02-08 12:00:05
854,C5-13.区立芝浦西運河沿緑地,9,30,39,35.638245,139.749754,2024-02-08 12:00:05
855,D6-12.東京ビジネスホテル,0,3,3,35.69342,139.710568,2024-02-08 12:00:05
856,D6-11.ホテルリステル新宿,0,6,6,35.693029,139.711327,2024-02-08 12:00:05
857,D6-10.ホテルサンライト新宿,3,0,3,35.694201,139.707047,2024-02-08 12:00:05
858,H1-39.辰巳駅東口自転車駐車場,22,3,25,35.645823,139.812178,2024-02-08 12:00:05
859,H1-38.辰巳駅西口自転車駐車場,89,0,89,35.646857,139.808912,2024-02-08 12:00:05
860,C2-10.元麻布三丁目,0,7,7,35.655865,139.730566,2024-02-08 12:00:05
861,C2-09.麻布地区総合支所,2,0,2,35.660614,139.734771,2024-02-08 12:00:05
862,M3-20.東急ステイ渋谷新南口,8,0,8,35.65494,139.70534,2024-02-08 12:00:05
863,I1-86.ファミリーマート二葉三丁目店,3,0,3,35.601694,139.719778,2024-02-08 12:00:05
864,A2-23.axle御茶ノ水,7,0,7,35.696126,139.763297,2024-02-08 12:00:05
865,C4-02.白金台いきいきプラザ,5,0,5,35.63756,139.724981,2024-02-08 12:00:05
866,N3-04.東中野駅地下駐輪場,0,13,13,35.707883,139.683284,2024-02-08 12:00:05
867,N3-05.中野坂上駅地下駐輪場,0,6,6,35.698068,139.682781,2024-02-08 12:00:05
868,N3-03.青桐公園,0,15,15,35.697024,139.677846,2024-02-08 12:00:05
869,N3-01.中野四季の森公園,6,4,10,35.708487,139.662135,2024-02-08 12:00:05
870,N4-01.本四公園,1,9,10,35.69693,139.672721,2024-02-08 12:00:05
871,N4-02.栄町公園,0,11,11,35.686474,139.671383,2024-02-08 12:00:05
872,K1-57.池上本門寺,5,1,6,35.579585,139.705377,2024-02-08 12:00:05
873,C1-49.汐留シティセンター,15,0,15,35.666213,139.760907,2024-02-08 12:00:05
874,C4-15.クロスレジデンス白金高輪,0,13,13,35.642771,139.733046,2024-02-08 12:00:05
875,K1-56.NTT馬込ビル,0,9,9,35.588106,139.718852,2024-02-08 12:00:05
876,J1-41.CASSIA目黒,0,9,9,35.631319,139.70237,2024-02-08 12:00:05
877,A2-22.専修大学,6,0,6,35.696147,139.753709,2024-02-08 12:00:05
878,T3-20.はやいち公園,2,2,4,35.75312,139.65661,2024-02-08 12:00:05
879,B3-19.本の森ちゅうおう,9,0,9,35.67363,139.77623,2024-02-08 12:00:05
880,K1-86.IMPREST STAY TOKYO 蒲田,22,0,22,35.556267,139.727246,2024-02-08 12:00:05
881,T3-23.氷川台二丁目緑地,3,1,4,35.756575,139.669689,2024-02-08 12:00:05
882,T3-22.氷川台三丁目ちびっこ公園,1,2,3,35.750547,139.66707,2024-02-08 12:00:05
883,B1-23.NANAEI日本橋,3,4,7,35.679616,139.784341,2024-02-08 12:00:05
884,B2-11.京橋エドグラン,12,0,12,35.677576,139.769822,2024-02-08 12:00:05
885,N1-05.大野ハイツ,2,3,5,35.7266,139.62948,2024-02-08 12:00:05
886,B2-09.茅場町一丁目平和ビル,10,0,10,35.680203,139.778679,2024-02-08 12:00:05
887,B2-08.共同ビル（茅場町交差点前）,9,0,9,35.681012,139.778569,2024-02-08 12:00:05
888,B2-07.東京証券会館（北側）,1,0,1,35.680864,139.779331,2024-02-08 12:00:05
889,O3-12.大宮前体育館,0,3,3,35.696567,139.610517,2024-02-08 12:00:05
890,B1-08.明治座,0,19,19,35.688038,139.786561,2024-02-08 12:00:05
891,B4-05.ドコモ・バイクシェア晴海ポート,0,28,28,35.654165,139.781568,2024-02-08 12:00:05
892,B4-04.ＫＤＸ晴海ビル,0,0,0,35.65443,139.77843,2024-02-08 12:00:05
893,B4-03.桜の散歩道（晴海トリトンスクエア前）,3,13,16,35.658665,139.782553,2024-02-08 12:00:05
894,E5-08.セブン-イレブン 文京動坂上店,2,3,5,35.727778,139.756296,2024-02-08 12:00:05
895,H1-65.ローソン南砂日曹橋店,6,9,15,35.669507,139.825553,2024-02-08 12:00:05
896,H1-66.中川船番所資料館,0,8,8,35.687732,139.846383,2024-02-08 12:00:05
897,K1-113.ファミリーマート大田上池台四丁目店,1,6,7,35.594658,139.700133,2024-02-08 12:00:05
898,H1-64.ローソン東雲駅前店,9,1,10,35.640228,139.804267,2024-02-08 12:00:05
899,E1-11.小石川運動場前,12,3,15,35.703914,139.747061,2024-02-08 12:00:05
900,T2-70.三ツ塚けやき緑地,2,2,4,35.720318,139.570762,2024-02-08 12:00:05
901,H1-137.住友不動産ショッピングシティ有明ガーデン,21,0,21,35.638985,139.793653,2024-02-08 12:00:05
902,C5-40.芝浦ふ頭駅前暫定自転車駐車場,3,1,4,35.64096,139.75754,2024-02-08 12:00:05
903,M3-21.渋谷ソラスタ,12,0,12,35.65618,139.69612,2024-02-08 12:00:05
904,D7-03.中井駅北,20,11,31,35.715645,139.687486,2024-02-08 12:00:05
905,K1-119.シーンズ大森パークサイド,3,1,4,35.58223,139.72763,2024-02-08 12:00:05
906,M6-15.cova Hatagaya,0,2,2,35.67741,139.67383,2024-02-08 12:00:05
907,C2-25.アパホテル＆リゾート＜六本木駅東＞,32,10,42,35.661783,139.737242,2024-02-08 12:00:05
908,D4-10.東新宿ポート(余丁町6番),1,5,6,35.696585,139.713081,2024-02-08 12:00:05
909,O1-02.井荻南地下自転車駐車場,7,7,14,35.72424,139.61431,2024-02-08 12:00:05
910,O1-03.LUCKY HOUSE,0,4,4,35.72489,139.62383,2024-02-08 12:00:05
911,D6-30.京王プラザホテル,6,1,7,35.6897,139.694823,2024-02-08 12:00:05
912,D6-29.都庁第二本庁舎前,13,0,13,35.688735,139.692249,2024-02-08 12:00:05
913,O3-02.アートメゾン荻窪,6,2,8,35.71355,139.6199,2024-02-08 12:00:05
914,J1-57.トレインチ自由が丘,5,0,5,35.606667,139.667324,2024-02-08 12:00:05
915,O2-01.サカエフラット荻窪,10,1,11,35.70535,139.61497,2024-02-08 12:00:05
916,O3-01.西田公園,1,6,7,35.69575,139.62065,2024-02-08 12:00:05
917,K1-47.NTT雪ヶ谷ビル,7,4,11,35.598601,139.684747,2024-02-08 12:00:05
918,Z17.NTT川崎ビル,9,0,9,35.529519,139.704845,2024-02-08 12:00:05
919,O7-04.永福町西幸モータープール西,7,1,8,35.67161,139.64527,2024-02-08 12:00:05
920,K1-48.ファミリーマート大田上池台三丁目店,0,25,25,35.590934,139.696915,2024-02-08 12:00:05
921,K1-111.本羽田公園,4,3,7,35.546499,139.736761,2024-02-08 12:00:05
922,C1-58.ウォーターズ竹芝,3,7,10,35.655937,139.763251,2024-02-08 12:00:05
923,K1-109.萩中公園プール駐輪場,8,0,8,35.549323,139.737091,2024-02-08 12:00:05
924,K1-108.仲江名公園,2,2,4,35.557999,139.732564,2024-02-08 12:00:05
925,E1-17.小石川パークスクエア,1,9,10,35.713913,139.745416,2024-02-08 12:00:05
926,D6-23.アパホテル 東新宿 歌舞伎町西,0,0,0,35.697535,139.703633,2024-02-08 12:00:05
927,H1-98.洲崎川緑道公園,0,35,35,35.668705,139.810549,2024-02-08 12:00:05
928,H1-99.南砂三丁目公園,18,6,24,35.669695,139.831874,2024-02-08 12:00:05
929,H1-96.越中島公園,0,19,19,35.668757,139.790156,2024-02-08 12:00:05
930,H1-97.浜園公園,0,17,17,35.661852,139.802224,2024-02-08 12:00:05
931,H1-94.新木場一丁目緑地公園,8,1,9,35.64423,139.835823,2024-02-08 12:00:05
932,H1-95.若洲公園,7,17,24,35.619451,139.834429,2024-02-08 12:00:05
933,J1-09.ファミリーマート佐野久下目黒店,2,3,5,35.629252,139.712716,2024-02-08 12:00:05
934,H1-93.新木場一丁目公園,7,0,7,35.64143,139.835455,2024-02-08 12:00:05
935,I1-55.鈴ヶ森公園,0,21,21,35.593559,139.734704,2024-02-08 12:00:05
936,O6-04.柏の宮公園,0,5,5,35.67834,139.62711,2024-02-08 12:00:05
937,B4-14.Brillia ist Tower 勝どき,0,21,21,35.660526,139.776816,2024-02-08 12:00:05
938,D7-08.上落合3丁目,3,10,13,35.71115,139.68232,2024-02-08 12:00:05
939,H1-21.UR東雲キャナルコート,0,91,91,35.646041,139.804495,2024-02-08 12:00:05
940,H1-20.日本科学未来館,23,7,30,35.619377,139.777582,2024-02-08 12:00:05
941,H1-19.UR豊洲四丁目団地,12,9,21,35.653603,139.80144,2024-02-08 12:00:05
942,T2-45.風致地区バス停第三自転車駐車場,0,7,7,35.771068,139.586798,2024-02-08 12:00:05
943,H1-33.深川ギャザリア（ウエストスクエア）,0,27,27,35.66789,139.803,2024-02-08 12:00:05
944,H1-32.区営塩浜住宅前,0,24,24,35.664591,139.813954,2024-02-08 12:00:05
945,H1-23.KDX豊洲グランスクエア,10,4,14,35.648085,139.798986,2024-02-08 12:00:05
946,C2-22.飯倉公園,9,1,10,35.655649,139.74427,2024-02-08 12:00:05
947,I1-89.下神明駅自転車駐車場,5,0,5,35.608402,139.726118,2024-02-08 12:00:05
948,C5-39.お台場海浜公園東,11,2,13,35.631021,139.778109,2024-02-08 12:00:05
949,C5-38.お台場海浜公園乗船場,0,15,15,35.628743,139.773915,2024-02-08 12:00:05
950,O4-08.ローソン阿佐ヶ谷青梅街道店,0,5,5,35.703203,139.62804,2024-02-08 12:00:05
951,T2-72.高塚南緑地,5,1,6,35.733132,139.570311,2024-02-08 12:00:05
952,O6-03.みなみ荘,6,4,10,35.68073,139.62803,2024-02-08 12:00:05
953,K1-129.ローソン東糀谷一丁目店,0,8,8,35.557427,139.739126,2024-02-08 12:00:05
954,E1-03.東京ドーム（黄色いビル横）,8,0,8,35.70319,139.751888,2024-02-08 12:00:05
955,K1-23.大田区役所本庁舎前,7,0,7,35.561183,139.716339,2024-02-08 12:00:05
956,T2-78.北大泉くれはし公園,1,2,3,35.761474,139.592735,2024-02-08 12:00:05
957,J1-53.ボヌールAllamanda,3,2,5,35.612833,139.675047,2024-02-08 12:00:05
958,A3-39.トーシン東神田ビル,0,4,4,35.694834,139.780333,2024-02-08 12:00:05
959,O6-01.高井戸みどり公園,4,5,9,35.67912,139.61074,2024-02-08 12:00:05
960,T2-79.大泉学園町八丁目緑地,4,2,6,35.774457,139.596182,2024-02-08 12:00:05
961,O5-04.リヴィエール,17,3,20,35.70104,139.65839,2024-02-08 12:00:05
962,N3-08.中野区役所(西側),6,0,6,35.707968,139.663519,2024-02-08 12:00:05
963,I1-99.北品川２丁目,3,3,6,35.61663,139.74192,2024-02-08 12:00:05
964,P1-01.サンシャインシティ,7,0,7,35.728846,139.718577,2024-02-08 12:00:05
965,N3-14.ヴィラソンサ落合,0,6,6,35.713227,139.680966,2024-02-08 12:00:05
966,H1-49.セブン-イレブン 江東新砂３丁目店,0,20,20,35.667892,139.8311,2024-02-08 12:00:05
967,I1-06.大森貝塚遺跡庭園,9,0,9,35.593489,139.72967,2024-02-08 12:00:05
968,M2-12.恵比寿プライムスクエアタワー北,8,1,9,35.650541,139.713361,2024-02-08 12:00:05
969,H1-69.ファミリーマート 江東石島店,0,32,32,35.680474,139.812316,2024-02-08 12:00:05
970,B3-09.築地永谷コーポラス,0,15,15,35.66523,139.776313,2024-02-08 12:00:05
971,E4-10.白山四丁目第二児童遊園横,2,9,11,35.720349,139.746924,2024-02-08 12:00:05
972,I1-03.大井町駅中央口（西側）,7,0,7,35.605617,139.73472,2024-02-08 12:00:05
973,I1-04.大井町歩道橋,5,0,5,35.605146,139.734694,2024-02-08 12:00:05
974,I1-01.品川区役所 本庁舎前,10,0,10,35.609052,139.729825,2024-02-08 12:00:05
975,I1-02.品川区役所 第三庁舎前,9,0,9,35.608161,139.730048,2024-02-08 12:00:05
976,G4-08.ブオンサンヴァレンティーノ,0,6,6,35.691677,139.793857,2024-02-08 12:00:05
977,J1-13.洗足二丁目駐輪場,13,4,17,35.61061,139.693443,2024-02-08 12:00:05
978,J1-16.八雲橋自転車置場,2,4,6,35.617353,139.672256,2024-02-08 12:00:05
979,H1-189.MFLP新木場2,0,35,35,35.634453,139.824,2024-02-08 12:00:05
980,M6-09.ファミリーマート渋谷本町店,0,9,9,35.683756,139.684965,2024-02-08 12:00:05
981,H1-113.123+N東雲店,0,36,36,35.646366,139.801492,2024-02-08 12:00:05
982,J1-17.ファミリーマート原町二丁目店,0,6,6,35.613902,139.691476,2024-02-08 12:00:05
983,E5-21.動坂公園,1,10,11,35.73176,139.756669,2024-02-08 12:00:05
984,E5-20.本郷2丁目,0,8,8,35.704391,139.758575,2024-02-08 12:00:05
985,T2-48.武蔵関駅南第二自転車駐車場,1,3,4,35.726064,139.578015,2024-02-08 12:00:05
986,A6-26.相互半蔵門ビル,6,3,9,35.683378,139.743189,2024-02-08 12:00:05
987,J1-31.守屋図書館,13,7,20,35.634194,139.688833,2024-02-08 12:00:05
988,M3-19.渋谷キャスト,20,1,21,35.662146,139.702793,2024-02-08 12:00:05
989,N1-04.都立家政南駐輪場,0,10,10,35.721679,139.645265,2024-02-08 12:00:05
990,Z09.ファミリーマート川崎川中島二丁目店,0,11,11,35.529781,139.727511,2024-02-08 12:00:05
991,N2-02.江古田1丁目A,0,3,3,35.724988,139.672511,2024-02-08 12:00:05
992,C1-56.鈴与竹芝ビル,3,2,5,35.654873,139.762103,2024-02-08 12:00:05
993,D3-07.戸塚特別出張所,6,1,7,35.71429,139.70507,2024-02-08 12:00:05
994,G4-12.プレミアムキューブ両国,0,7,7,35.70103,139.803341,2024-02-08 12:00:05
995,A2-21.神田神保町3丁目,7,0,7,35.694578,139.754434,2024-02-08 12:00:05
996,B4-19.コーシャタワー佃,0,26,26,35.668044,139.785801,2024-02-08 12:00:05
997,I1-81.戸越6丁目,16,4,20,35.608127,139.717865,2024-02-08 12:00:05
998,A6-24.国立劇場,0,15,15,35.682218,139.743292,2024-02-08 12:00:05
999,E5-23.ビレッジ千駄木,0,6,6,35.722353,139.760966,2024-02-08 12:00:05
1000,H1-119.榎戸材木店,0,6,6,35.638319,139.834741,2024-02-08 12:00:05
1001,C5-29.Hi-NODE(ハイノード),7,1,8,35.651672,139.760549,2024-02-08 12:00:05
1002,J1-22.NTTコミュニケーションズ唐ヶ崎ビル,0,4,4,35.627373,139.692044,2024-02-08 12:00:05
1003,A2-18.猿楽町SSビル東,5,1,6,35.698654,139.759762,2024-02-08 12:00:05
1004,A2-19.猿楽町SSビル西,2,0,2,35.698641,139.759306,2024-02-08 12:00:05
1005,C1-55.アーバンネット内幸町ビル,19,1,20,35.669267,139.756018,2024-02-08 12:00:05
1006,D4-06.グリーンフォート河田,0,12,12,35.697143,139.718739,2024-02-08 12:00:05
1007,K1-134.東調布公園,3,7,10,35.588363,139.69042,2024-02-08 12:00:05
1008,Z12.京急川崎西口駐輪場B,21,0,21,35.533627,139.700527,2024-02-08 12:00:05
1009,M5-18.Luxe初台,0,5,5,35.679182,139.68596,2024-02-08 12:00:05
1010,D7-06.エムアイセミナーハウス,3,2,5,35.721064,139.677128,2024-02-08 12:00:05
1011,A3-37.ポータル秋葉原,0,24,24,35.695737,139.78162,2024-02-08 12:00:05
1012,M5-11.あおい通り,9,0,9,35.688154,139.698975,2024-02-08 12:00:05
1013,E5-04.保健サービスセンター本郷支所,0,5,5,35.727046,139.760439,2024-02-08 12:00:05
1014,E5-03.汐見地域活動センター（本郷図書館）,0,5,5,35.725538,139.76116,2024-02-08 12:00:05
1015,E5-01.文京総合体育館,31,0,31,35.708121,139.763583,2024-02-08 12:00:05
1016,E4-01.千石南自転車駐車場,5,20,25,35.72707,139.746112,2024-02-08 12:00:05
1017,E3-03.大塚公園,5,16,21,35.724286,139.730954,2024-02-08 12:00:05
1018,E3-02.教育の森公園,5,12,17,35.719345,139.736198,2024-02-08 12:00:05
1019,I1-25.セブン-イレブン 品川旗の台2丁目店,0,3,3,35.607084,139.705007,2024-02-08 12:00:05
1020,B1-21.日本橋二丁目街角広場,9,1,10,35.680861,139.774493,2024-02-08 12:00:05
1021,C3-30.東京赤坂NKビル (ヴィアインプライム赤坂),9,0,9,35.672652,139.738908,2024-02-08 12:00:05
1022,A3-36.クロックカフェ東神田,0,5,5,35.694943,139.782718,2024-02-08 12:00:05
1023,E1-14.いきいき礫川,0,9,9,35.711147,139.747386,2024-02-08 12:00:05
1024,D4-09.トミンハイム仲之町,0,15,15,35.69617,139.722021,2024-02-08 12:00:05
1025,L1-08.NTT砧ビル,0,6,6,35.63534,139.601602,2024-02-08 12:00:05
1026,L1-09.コージーK・駒沢,1,3,4,35.632689,139.654804,2024-02-08 12:00:05
1027,L1-10.宮坂2-4-10,0,6,6,35.652913,139.644825,2024-02-08 12:00:05
1028,I1-22.ウィラ大井 (ショッピングモール),2,3,5,35.596579,139.745009,2024-02-08 12:00:05
1029,K1-76.グリーンベルト,9,0,9,35.585178,139.726339,2024-02-08 12:00:05
1030,H1-121.南砂5丁目,0,42,42,35.676603,139.829736,2024-02-08 12:00:05
1031,M3-02.文化総合センター大和田,5,0,5,35.65558,139.69966,2024-02-08 12:00:05
1032,D4-04.ジェノヴィア新宿早稲田グリーンヴェール,0,6,6,35.700033,139.71983,2024-02-08 12:00:05
1033,A3-20.神田ふれあい通り第２,1,1,2,35.695005,139.772747,2024-02-08 12:00:05
1034,H1-120.豊洲5丁目,17,1,18,35.650948,139.799711,2024-02-08 12:00:05
1035,C5-42.DHC芝浦2丁目ビル,1,7,8,35.644241,139.753834,2024-02-08 12:00:05
1036,I1-65.セブン-イレブン品川東大井1丁目店,7,0,7,35.605996,139.743037,2024-02-08 12:00:05
1037,M2-04.広尾東公園,5,1,6,35.653382,139.721059,2024-02-08 12:00:05
1038,M3-13.渋谷駅東口地下駐輪場,18,1,19,35.657682,139.703307,2024-02-08 12:00:05
1039,A3-19.神田ふれあい通り第１,0,6,6,35.694904,139.772712,2024-02-08 12:00:05
1040,O6-07.ローソン杉並宮前一丁目店,1,4,5,35.689639,139.613516,2024-02-08 12:00:05
1041,T3-10.貫井一丁目緑地,0,3,3,35.736378,139.632485,2024-02-08 12:00:05
1042,M2-05.日本赤十字医療センター,1,9,10,35.65519,139.718559,2024-02-08 12:00:05
1043,T2-20.パークサイド石神井,0,13,13,35.741769,139.591103,2024-02-08 12:00:05
1044,N4-06.ローソン中野本町新橋通り店,0,7,7,35.695819,139.674326,2024-02-08 12:00:05
1045,T3-07.徳殿公園,3,1,4,35.726728,139.65874,2024-02-08 12:00:05
1046,K1-35.セブン-イレブン 大田区西六郷2丁目店,0,13,13,35.549778,139.707362,2024-02-08 12:00:05
1047,A3-27.秋葉原駅中央口（ヨドバシカメラ前）,7,3,10,35.698986,139.774099,2024-02-08 12:00:05
1048,A3-28.秋葉原駅電気街口(西側交通広場),5,0,5,35.699173,139.772629,2024-02-08 12:00:05
1049,H1-57.新木場駅,10,55,65,35.64508,139.826456,2024-02-08 12:00:05
1050,H1-58.潮見駅,0,26,26,35.658703,139.817251,2024-02-08 12:00:05
1051,D7-02.セブン-イレブン 新宿中落合3丁目店,0,15,15,35.722202,139.691712,2024-02-08 12:00:05
1052,D2-06.飯田濠,13,1,14,35.70057,139.74301,2024-02-08 12:00:05
1053,C5-17.鈴与浜松町ビル,5,4,9,35.651103,139.759092,2024-02-08 12:00:05
1054,H1-59.LYURO 東京清澄,0,24,24,35.681316,139.792176,2024-02-08 12:00:05
1055,H1-60.荒川・砂町庭球場西,0,30,30,35.679678,139.844892,2024-02-08 12:00:05
1056,K1-44.中馬込貝塚公園,0,7,7,35.594795,139.704951,2024-02-08 12:00:05
1057,M6-11.京王サイクルパーク笹塚,0,5,5,35.674337,139.668801,2024-02-08 12:00:05
1058,J1-49.伊勢脇公園,1,3,4,35.638864,139.696568,2024-02-08 12:00:05
1059,K1-45.たぬき山公園,1,7,8,35.592801,139.715472,2024-02-08 12:00:05
1060,D2-01.あずさセンタービル,12,6,18,35.702286,139.741093,2024-02-08 12:00:05
1061,C1-02.西新橋1丁目（外堀通り）,4,1,5,35.668791,139.753582,2024-02-08 12:00:05
1062,O3-07.NTT井草ビル第1ポート,2,1,3,35.714044,139.61688,2024-02-08 12:00:05
1063,T2-41.ローソン 練馬東大泉五丁目店,0,4,4,35.74248,139.58715,2024-02-08 12:00:05
1064,H1-144.南砂住宅,0,17,17,35.674199,139.822018,2024-02-08 12:00:05
1065,C3-28.ヒューリックＪＰ赤坂ビル,11,0,11,35.672477,139.739743,2024-02-08 12:00:05
1066,H1-145.東雲都橋住宅,0,16,16,35.643131,139.797784,2024-02-08 12:00:05
1067,I1-58.品川区役所　第二庁舎前,18,0,18,35.609664,139.730006,2024-02-08 12:00:05
1068,K1-92.蒲田駅西口自転車駐車場,25,0,25,35.561101,139.715173,2024-02-08 12:00:05
1069,A2-24.水道橋駅西口前,6,0,6,35.702271,139.752619,2024-02-08 12:00:05
1070,K1-94.昭和島駅前,0,25,25,35.572188,139.749613,2024-02-08 12:00:05
1071,M5-15.新宿マインズタワー,18,2,20,35.686567,139.699355,2024-02-08 12:00:05
1072,D7-13.日本光電本社南側,11,4,15,35.71936,139.679083,2024-02-08 12:00:05
1073,N3-09.中野区役所(北側),5,0,5,35.708259,139.663829,2024-02-08 12:00:05
1074,H1-163.森下公園,2,3,5,35.68663,139.799529,2024-02-08 12:00:05
1075,B4-23.交通広場（豊海町）,0,15,15,35.653771,139.769295,2024-02-08 12:00:05
1076,D6-18.ヨドバシカメラ 新宿西口本店前,5,1,6,35.689689,139.698231,2024-02-08 12:00:05
1077,I1-47.NTT 東日本 関東病院(南側),7,0,7,35.630151,139.725215,2024-02-08 12:00:05
1078,H1-112.ファミリーマート江東塩浜二丁目店,0,21,21,35.66305,139.8087,2024-02-08 12:00:05
1079,K1-103.雪谷特別出張所,0,7,7,35.594515,139.691219,2024-02-08 12:00:05
1080,E5-17.Village藍染,0,5,5,35.720896,139.76422,2024-02-08 12:00:05
1081,Z04.ローソン川崎四谷上町店,7,1,8,35.527562,139.737102,2024-02-08 12:00:05
1082,Z03.ローソン川崎塩浜三丁目店,0,3,3,35.523754,139.746356,2024-02-08 12:00:05
1083,I1-49.京急鮫洲バイク駐輪場,6,0,6,35.603815,139.741362,2024-02-08 12:00:05
1084,I1-50.京急立会川第2バイク駐輪場,0,12,12,35.599196,139.739158,2024-02-08 12:00:05
1085,E4-14.NTT東日本大塚ビル,0,17,17,35.726188,139.741375,2024-02-08 12:00:05
1086,M2-07.ファミリーマート恵比寿駅東店,7,0,7,35.6471,139.712818,2024-02-08 12:00:05
1087,M4-07.千駄ヶ谷駅前,1,3,4,35.68082,139.71188,2024-02-08 12:00:05
1088,O5-07.バーンホーフ キクチ,12,8,20,35.698169,139.655665,2024-02-08 12:00:05
1089,J1-11.コンフォリア目黒青葉台,0,6,6,35.649023,139.696086,2024-02-08 12:00:05
1090,L1-14.給田3丁目,1,12,13,35.664335,139.590114,2024-02-08 12:00:05
1091,B4-06.月島駅地下駐輪場,1,17,18,35.66291,139.782564,2024-02-08 12:00:05
1092,C5-09.グランパーク,20,1,21,35.643202,139.746244,2024-02-08 12:00:05
1093,C5-08.AQUACITY芝浦,5,6,11,35.637366,139.74844,2024-02-08 12:00:05
1094,C3-08.赤坂パークビルヂング,5,0,5,35.671792,139.733668,2024-02-08 12:00:05
1095,C3-07.新青山ビル,17,1,18,35.672659,139.725644,2024-02-08 12:00:05
1096,C3-06.ホテルアジア会館,0,12,12,35.67064,139.728166,2024-02-08 12:00:05
1097,C1-24.三田国際ビル,3,7,10,35.653159,139.744673,2024-02-08 12:00:05
1098,C5-07.港区立港南図書館,0,36,36,35.632842,139.7495,2024-02-08 12:00:05
1099,A3-04.秋葉原公園,3,14,17,35.697642,139.774867,2024-02-08 12:00:05
1100,A3-05.和泉公園（西側入口）,4,2,6,35.698817,139.778898,2024-02-08 12:00:05
1101,A3-02.絶滅メディア博物館（楓ビル）,8,0,8,35.689575,139.767848,2024-02-08 12:00:05
1102,O3-10.メゾンパークス,3,5,8,35.716265,139.618954,2024-02-08 12:00:05
1103,A2-05.神田橋公園,1,0,1,35.689665,139.764091,2024-02-08 12:00:05
1104,A3-01.神田児童公園（西側交番横）,4,2,6,35.692983,139.76773,2024-02-08 12:00:05
1105,A2-03.西神田公園（西側）,5,0,5,35.698338,139.754876,2024-02-08 12:00:05
1106,M6-03.十三号通り公園,0,8,8,35.675198,139.663587,2024-02-08 12:00:05
1107,M6-02.サイカパーク笹塚,0,11,11,35.673444,139.666553,2024-02-08 12:00:05
1108,H1-165.亀戸梅屋敷,0,10,10,35.701318,139.825916,2024-02-08 12:00:05
1109,H1-166.亀戸クロック,18,1,19,35.696574,139.82972,2024-02-08 12:00:05
1110,M5-02.あいおいニッセイ同和損保新宿ビル,1,3,4,35.684423,139.692262,2024-02-08 12:00:05
1111,M6-01.幡ヶ谷駅高架下第一,23,12,35,35.677175,139.676769,2024-02-08 12:00:05
1112,A5-02.山王パークタワー,4,1,5,35.673555,139.741293,2024-02-08 12:00:05
1113,K1-116.旧呑川緑地（大森東五丁目）,5,7,12,35.567176,139.742345,2024-02-08 12:00:05
1114,K1-115.旧呑川緑地（大森中三丁目）,0,7,7,35.565685,139.736195,2024-02-08 12:00:05
1115,K1-114.下丸子公園,6,2,8,35.568722,139.680736,2024-02-08 12:00:05
1116,T3-05.東武練馬駅南,0,10,10,35.767129,139.664365,2024-02-08 12:00:05
1117,T1-14.ファミリーマート 練馬高松五丁目北店,4,0,4,35.761038,139.623148,2024-02-08 12:00:05
1118,C3-29.高橋是清翁記念公園,5,2,7,35.674094,139.728895,2024-02-08 12:00:05
1119,K1-141.蒲田駅西口歩道,5,0,5,35.561291,139.715076,2024-02-08 12:00:05
1120,C3-35.ワールド北青山ビル,17,0,17,35.667069,139.713423,2024-02-08 12:00:05
1121,M5-03.代々木大山公園,9,7,16,35.671282,139.675307,2024-02-08 12:00:05
1122,E5-13.弥生二丁目,4,2,6,35.715592,139.76192,2024-02-08 12:00:05
1123,E5-12.NK本郷ビル,0,6,6,35.704475,139.763041,2024-02-08 12:00:05
1124,B3-18.銀座松竹スクエア,10,0,10,35.668395,139.769849,2024-02-08 12:00:05
1125,C1-44.三田Avanti,5,1,6,35.64115,139.741471,2024-02-08 12:00:05
1126,T2-31.ファミリーマート 石神井台二丁目店,0,9,9,35.739488,139.590273,2024-02-08 12:00:05
1127,H1-150.ホテルヴィラフォンテーヌ南側,8,1,9,35.636978,139.791858,2024-02-08 12:00:05
1128,H1-149.有明ガーデン 公園口,7,1,8,35.639132,139.793047,2024-02-08 12:00:05
1129,H1-148.大島七丁目団地,0,17,17,35.694104,139.840278,2024-02-08 12:00:05
1130,B4-26.東武ストア晴海三丁目店,0,14,14,35.654371,139.779545,2024-02-08 12:00:05
1131,J1-26.田向公園,3,4,7,35.623459,139.687128,2024-02-08 12:00:05
1132,J1-25.碑文谷公園,3,5,8,35.625081,139.682632,2024-02-08 12:00:05
1133,H1-195.東京アクアティクスセンター,6,13,19,35.65238,139.815613,2024-02-08 12:00:05
1134,T1-13.ファミリーマート 練馬土支田二丁目店,0,14,14,35.761613,139.61349,2024-02-08 12:00:05
1135,T2-34.ファミリーマート 練馬富士見台店,0,5,5,35.73969,139.62125,2024-02-08 12:00:05
1136,T2-35.ファミリーマート 石神井台六丁目店,0,6,6,35.738607,139.585331,2024-02-08 12:00:05
1137,C1-81.田町タワー,20,0,20,35.646534,139.748913,2024-02-08 12:00:05
1138,J1-07.目黒川船入場,14,1,15,35.641992,139.701588,2024-02-08 12:00:05
1139,J1-08.目黒区民センター公園,15,3,18,35.634533,139.708868,2024-02-08 12:00:05
1140,D4-01.市谷仲之町,2,4,6,35.695102,139.723345,2024-02-08 12:00:05
1141,M2-11.鉢山町,14,2,16,35.652151,139.698426,2024-02-08 12:00:05
1142,E4-08.ドコモ・バイクシェア向丘ポート,1,8,9,35.720546,139.756685,2024-02-08 12:00:05
1143,D4-03.市谷加賀町2丁目,0,10,10,35.695636,139.727882,2024-02-08 12:00:05
1144,Z10.ローソン川崎浅田三丁目店,4,6,10,35.506142,139.701005,2024-02-08 12:00:05
1145,N1-01.BeGood野方,0,10,10,35.719717,139.64785,2024-02-08 12:00:05
1146,C2-03.アークヒルズサウスタワー,10,1,11,35.666357,139.73923,2024-02-08 12:00:05
1147,C2-01.アークヒルズ（アーク森ビル）,7,4,11,35.667107,139.739565,2024-02-08 12:00:05
1148,C2-02.六本木ヒルズ,26,0,26,35.661158,139.728533,2024-02-08 12:00:05
1149,C5-03.港南公園C,7,19,26,35.624966,139.746657,2024-02-08 12:00:05
1150,C5-04.みなとパーク芝浦,10,1,11,35.646801,139.751208,2024-02-08 12:00:05
1151,C1-16.機械振興会館,6,0,6,35.659442,139.745549,2024-02-08 12:00:05
1152,C1-14.新橋プラザビル,0,7,7,35.664461,139.756082,2024-02-08 12:00:05
1153,H1-73.イシマビル,0,9,9,35.67386,139.79976,2024-02-08 12:00:05
1154,O7-01.西永福公園,4,1,5,35.67753,139.63667,2024-02-08 12:00:05
1155,O6-02.富士見ヶ丘南自転車駐車場,6,2,8,35.68296,139.60861,2024-02-08 12:00:05
1156,K1-50.テクノポートカマタ 第1,6,0,6,35.556199,139.721476,2024-02-08 12:00:05
1157,J1-14.二の橋自転車置場1,39,0,39,35.614856,139.678208,2024-02-08 12:00:05
1158,O3-08.NTT井草ビル第２ポート,0,3,3,35.714077,139.61694,2024-02-08 12:00:05
1159,H1-124.セブン-イレブン 江東海辺店,1,12,13,35.680636,139.817977,2024-02-08 12:00:05
1160,D1-11.三井ガーデンホテル神宮外苑の杜プレミア,5,0,5,35.679807,139.715931,2024-02-08 12:00:05
1161,O7-07.ハレ永福,1,7,8,35.678913,139.639944,2024-02-08 12:00:05
1162,C5-32.トレードピアお台場,4,1,5,35.627891,139.776896,2024-02-08 12:00:05
1163,B4-18.豊海センタービル,0,5,5,35.653531,139.769431,2024-02-08 12:00:05
1164,D5-04.西戸山公園野球場,2,5,7,35.707388,139.700204,2024-02-08 12:00:05
1165,D5-03.北新宿公園,0,14,14,35.702288,139.68862,2024-02-08 12:00:05
1166,D3-04.鶴巻南公園,0,23,23,35.706182,139.723394,2024-02-08 12:00:05
1167,D3-03.甘泉園公園,0,15,15,35.712431,139.715418,2024-02-08 12:00:05
1168,K1-03.池上会館,0,7,7,35.576593,139.706597,2024-02-08 12:00:05
1169,K1-02.平和の森公園,11,4,15,35.579049,139.739878,2024-02-08 12:00:05
1170,K1-01.大森海苔のふるさと館,0,12,12,35.57685,139.742496,2024-02-08 12:00:05
1171,D6-13.新宿中央公園（ジャブジャブ池下）,7,2,9,35.687652,139.689254,2024-02-08 12:00:05
1172,T2-28.ファミリーマート 南大泉六丁目店,3,2,5,35.752217,139.571095,2024-02-08 12:00:05
1173,K1-05.平和島公園プール,13,4,17,35.581832,139.741581,2024-02-08 12:00:05
1174,K1-04.京急蒲田駅東口,21,0,21,35.559483,139.724273,2024-02-08 12:00:05
1175,E2-10.音羽パークロード（北入口）,13,2,15,35.716586,139.727705,2024-02-08 12:00:05
1176,E2-11.音羽パークロード（キャッチボール場横）,13,7,20,35.715382,139.728533,2024-02-08 12:00:05
1177,I1-21.大井競馬場(正門前),10,0,10,35.593887,139.741204,2024-02-08 12:00:05
1178,J1-27.衾町公園,1,0,1,35.623215,139.668472,2024-02-08 12:00:05
1179,T2-44.中島橋自転車駐車場,5,2,7,35.75372,139.584332,2024-02-08 12:00:05
1180,B3-15.ACホテル・バイ・マリオット東京銀座,8,0,8,35.668845,139.765144,2024-02-08 12:00:05
1181,D5-07.百人町1丁目,2,4,6,35.699252,139.697606,2024-02-08 12:00:05
1182,C4-04.ショパン高輪,0,10,10,35.632128,139.732097,2024-02-08 12:00:05
1183,B1-18.セブン-イレブン 日本橋小網町店,2,1,3,35.681352,139.781436,2024-02-08 12:00:05
1184,T2-71.わかば児童公園,4,3,7,35.7211,139.574669,2024-02-08 12:00:05
1185,M3-15.co-ba ebisu,6,0,6,35.647076,139.703964,2024-02-08 12:00:05
1186,C2-20.三井ガーデンホテル六本木プレミア,4,0,4,35.66206,139.735501,2024-02-08 12:00:05
1187,I1-70.五反田リバーステーション,4,4,8,35.624566,139.72448,2024-02-08 12:00:05
1188,E5-25.ジェノヴィア東大前グリーンヴェール,7,4,11,35.711875,139.759306,2024-02-08 12:00:05
1189,D1-12.ジェノヴィア新宿御苑グリーンヴェール,1,6,7,35.689017,139.714755,2024-02-08 12:00:05
1190,C5-33.msb Tamachi,37,1,38,35.645682,139.748768,2024-02-08 12:00:05
1191,G4-09.SYFORME MORISHITA Ⅱ 1,1,0,1,35.690348,139.796133,2024-02-08 12:00:05
1192,G4-10.SYFORME MORISHITA Ⅱ 2,0,5,5,35.690307,139.796128,2024-02-08 12:00:05
1193,N3-19.上高田パーキング,0,16,16,35.715878,139.673669,2024-02-08 12:00:05
1194,Z13.京急川崎日進町駐輪場,10,0,10,35.528361,139.696499,2024-02-08 12:00:05
1195,F6-01.松坂屋上野店,1,3,4,35.707305,139.773657,2024-02-08 12:00:05
1196,F4-01.SYFORME ASAKUSA,0,4,4,35.718832,139.791133,2024-02-08 12:00:05
1197,F2-02.アップルパーク浅草6丁目第3,0,3,3,35.716062,139.799552,2024-02-08 12:00:05
1198,F2-01.松が谷2丁目2,0,20,20,35.71283,139.787754,2024-02-08 12:00:05
1199,F1-02.台東デザイナーズビレッジ,2,5,7,35.706023,139.783751,2024-02-08 12:00:05
1200,F2-03.台東区生涯学習センター,0,6,6,35.717497,139.790055,2024-02-08 12:00:05
1201,K1-146.南馬込6丁目25-11,0,3,3,35.582743,139.710561,2024-02-08 12:00:05
1202,F3-01.清川1丁目18-11,0,17,17,35.724944,139.801684,2024-02-08 12:00:05
1203,F1-03.新御徒町駅自転車駐車場,4,12,16,35.706793,139.782985,2024-02-08 12:00:05
1204,F3-02.台東区リバーサイドスポーツセンター,0,7,7,35.717571,139.804216,2024-02-08 12:00:05
1205,I1-45.セブン-イレブン品川西五反田3丁目店,4,1,5,35.62541,139.718135,2024-02-08 12:00:05
1206,H1-135.北砂5丁目団地,0,35,35,35.684218,139.832843,2024-02-08 12:00:05
1207,C3-16.赤坂ガーデンシティ,0,11,11,35.6738,139.731525,2024-02-08 12:00:05
1208,J1-34.田道広場公園,7,3,10,35.636269,139.709073,2024-02-08 12:00:05
1209,O5-08.セシオン杉並,1,2,3,35.69714,139.65432,2024-02-08 12:00:05
1210,A2-04.ちよだプラットフォームスクウェア,10,0,10,35.691456,139.762228,2024-02-08 12:00:05
1211,I1-102.J.GRAN Court 品川西大井 EAST,2,5,7,35.598244,139.722447,2024-02-08 12:00:05
1212,H1-196.フットサルクラブ東京東陽町,6,0,6,35.665288,139.824294,2024-02-08 12:00:05
1213,F2-04.コンフォラス浅草マンション,0,3,3,35.717241,139.801674,2024-02-08 12:00:05
1214,G5-03.京成リッチモンドホテル東京錦糸町,3,2,5,35.693492,139.81506,2024-02-08 12:00:05
1215,K1-27.六郷文化センター,1,3,4,35.544715,139.707623,2024-02-08 12:00:05
1216,K1-147.トヨタモビリティ東京GRGarage東京蒲田店,2,0,2,35.552741,139.718404,2024-02-08 12:00:05
1217,K1-148.トヨタモビリティ東京 蒲田仲六郷店,6,0,6,35.552068,139.71747,2024-02-08 12:00:05
1218,K1-150.トヨタモビリティ東京 池上第二京浜店,1,4,5,35.568019,139.696379,2024-02-08 12:00:05
1219,K1-149.トヨタモビリティ東京 大田店,1,5,6,35.59336,139.715879,2024-02-08 12:00:05
1220,C1-82.トヨタモビリティ東京 港三田店,0,5,5,35.647831,139.739048,2024-02-08 12:00:05
1221,D4-11.トヨタモビリティ東京 新宿明治通り南店,2,0,2,35.699835,139.70808,2024-02-08 12:00:05
1222,C3-31.赤坂一丁目,12,5,17,35.670239,139.744285,2024-02-08 12:00:05
1223,E1-04.礫川公園,34,7,41,35.707853,139.751518,2024-02-08 12:00:05
1224,M3-23.円山町7-1,2,7,9,35.658229,139.694885,2024-02-08 12:00:05
1225,M3-24.渋谷道玄坂２丁目駐輪場,3,16,19,35.66026,139.69684,2024-02-08 12:00:05
1226,T3-32.練馬北町1丁目,1,4,5,35.764452,139.666299,2024-02-08 12:00:05
1227,H1-197.セブン-イレブン江東南砂葛西橋通り店,0,4,4,35.675361,139.825034,2024-02-08 12:00:05
1228,T2-84.石神井町二丁目緑地,0,3,3,35.748395,139.605958,2024-02-08 12:00:05
1229,T2-82.梅の木児童遊園,0,5,5,35.737899,139.576584,2024-02-08 12:00:05
1230,T2-83.西大泉さくら緑地,4,4,8,35.760442,139.573145,2024-02-08 12:00:05
1231,D7-05.西落合図書館,7,1,8,35.725818,139.678976,2024-02-08 12:00:05
1232,D6-28.東急ステイ新宿,3,0,3,35.690899,139.706348,2024-02-08 12:00:05
1233,T2-85.泉新公園,3,1,4,35.7547,139.601497,2024-02-08 12:00:05
1234,T2-86.石神井町八丁目緑地,2,1,3,35.746956,139.600798,2024-02-08 12:00:05
1235,T2-87.南大泉四丁目児童遊園,0,4,4,35.745607,139.573947,2024-02-08 12:00:05
1236,T2-88.南大泉かたまち緑地,0,4,4,35.739633,139.570457,2024-02-08 12:00:05
1237,T2-89.南大泉三丁目児童遊園,0,3,3,35.742755,139.568335,2024-02-08 12:00:05
1238,E2-05.護国寺駅西自転車駐車場,21,1,22,35.719421,139.725584,2024-02-08 12:00:05
1239,J1-59.第44興和ビル,4,0,4,35.647704,139.693671,2024-02-08 12:00:05
1240,C1-15.東京タワー,11,5,16,35.65928,139.744767,2024-02-08 12:00:05
1241,C5-20.ローソン芝浦二丁目店,3,1,4,35.645254,139.754765,2024-02-08 12:00:05
1242,C2-27.有栖川宮記念公園第一,17,0,17,35.651382,139.724392,2024-02-08 12:00:05
1243,C2-28.有栖川宮記念公園第二,4,4,8,35.651129,139.726003,2024-02-08 12:00:05
1244,C2-29.狸穴公園,4,1,5,35.658204,139.738935,2024-02-08 12:00:05
1245,T2-90.南田中四丁目緑地,2,2,4,35.733195,139.612327,2024-02-08 12:00:05
1246,T2-91.石神井町四丁目緑地,5,0,5,35.745272,139.604579,2024-02-08 12:00:05
1247,A3-41.秋葉原ダイビル,4,1,5,35.698917,139.771856,2024-02-08 12:00:05
1248,J1-54.田道住区センター三田分室,5,0,5,35.638904,139.712518,2024-02-08 12:00:05
1249,H1-140.キャナルパレス住吉,12,4,16,35.689896,139.815116,2024-02-08 12:00:05
1250,C1-57.虎ノ門ツインビルディング,7,0,7,35.667259,139.745643,2024-02-08 12:00:05
1251,K1-54.ファミリーマート大田久が原五丁目店,0,16,16,35.579435,139.698552,2024-02-08 12:00:05
1252,B1-29.ASTILE日本橋浜町,1,7,8,35.685504,139.790817,2024-02-08 12:00:05
1253,N3-20.SYFORME NAKANO-SAKAUE,2,3,5,35.701157,139.679617,2024-02-08 12:00:05
1254,D6-31.東急歌舞伎町タワー駐輪場,3,7,10,35.696207,139.700521,2024-02-08 12:00:05
1255,I1-30.ローソン 大井三丁目店,6,1,7,35.603327,139.729006,2024-02-08 12:00:05
1256,K1-151.PATH仲六郷,10,0,10,35.549465,139.711157,2024-02-08 12:00:05
1257,H1-198.Br Tower 有明 MID CROSS,2,5,7,35.63464,139.783445,2024-02-08 12:00:05
1258,H1-04.石と光の広場（国際展示場駅）,41,20,61,35.63363,139.79082,2024-02-08 12:00:05
1259,B4-24.ミュプレ月島,4,3,7,35.66288,139.78329,2024-02-08 12:00:05
1260,H1-199.ラ・ヴェール東陽町,1,9,10,35.664244,139.814506,2024-02-08 12:00:05
1261,H1-200.ヴェッセル木場南,0,12,12,35.662414,139.813333,2024-02-08 12:00:05
1262,F1-04.台東2丁目21,0,5,5,35.703465,139.780325,2024-02-08 12:00:05
1263,F3-03.ヴェルステージ南千住,0,5,5,35.728704,139.801867,2024-02-08 12:00:05
1264,J1-46.五本木西みどり街かど公園,0,6,6,35.632735,139.683899,2024-02-08 12:00:05
1265,Z24.総合川崎臨港病院,0,10,10,35.525854,139.717848,2024-02-08 12:00:05
1266,K1-131.東急武蔵新田駅駐輪場,11,4,15,35.567146,139.693344,2024-02-08 12:00:05
1267,K1-152.アットホームスクエア前,0,8,8,35.543327,139.703223,2024-02-08 12:00:05
1268,B2-04.清水建設本社（都営地下鉄宝町駅 Ａ８出口）,12,3,15,35.676119,139.772895,2024-02-08 12:00:05
1269,H1-202.辰巳の森海浜公園,7,5,12,35.648107,139.813572,2024-02-08 12:00:05
1270,H1-201.ウエリスアーバン水天宮前2,1,5,6,35.678099,139.791831,2024-02-08 12:00:05
1271,I1-103.五反田ＪＰビルディング,3,0,3,35.622389,139.721552,2024-02-08 12:00:05
1272,L1-16.上祖師谷7丁目,13,1,14,35.65838,139.59231,2024-02-08 12:00:05
1273,O5-09.AppCruise中野,1,1,2,35.700772,139.66063,2024-02-08 12:00:05
1274,H1-203.セブン-イレブン江東木場３丁目店,0,11,11,35.67517,139.804087,2024-02-08 12:00:05
1275,H1-44.テプコ豊洲ビル,25,0,25,35.648726,139.790877,2024-02-08 12:00:05
1276,L1-17.赤堤3丁目,3,4,7,35.659787,139.636696,2024-02-08 12:00:05
1277,L1-18.上北沢1丁目,20,10,30,35.662796,139.626795,2024-02-08 12:00:05
1278,B3-16.明石町区民館,0,8,8,35.666001,139.778102,2024-02-08 12:00:05
1279,I1-104.源氏前ビル,4,1,5,35.603521,139.712345,2024-02-08 12:00:05
1280,J1-28.宮前公園,0,8,8,35.617699,139.664826,2024-02-08 12:00:05
1281,M6-18.セブン-イレブン渋谷本町3丁目店,0,3,3,35.686521,139.685017,2024-02-08 12:00:05
1282,O7-08.杉並区和泉2-3-17,0,4,4,35.67187,139.65474,2024-02-08 12:00:05
1283,T1-17.セブン-イレブン練馬田柄通店,6,1,7,35.75987,139.640474,2024-02-08 12:00:05
1284,H1-18.東京ビッグサイト,7,9,16,35.631192,139.79401,2024-02-08 12:00:05
1285,M3-01.渋谷マークシティ,11,2,13,35.657726,139.697802,2024-02-08 12:00:05
1286,H1-70.有明スポーツセンター,13,4,17,35.63403,139.784319,2024-02-08 12:00:05
1287,H1-41.深川北スポーツセンター,2,11,13,35.676475,139.804741,2024-02-08 12:00:05
1288,H1-55.深川江戸資料館,3,5,8,35.681089,139.800777,2024-02-08 12:00:05
1289,I1-61.五反田文化センター,3,4,7,35.622588,139.716159,2024-02-08 12:00:05
1290,N3-13.中部すこやか福祉センター,3,2,5,35.700052,139.673715,2024-02-08 12:00:05
1291,A4-02.東京サンケイビル,10,0,10,35.686847,139.765151,2024-02-08 12:00:05
1292,M3-09.ティップ.クロス TOKYO 渋谷,10,9,19,35.661475,139.699296,2024-02-08 12:00:05
1293,B3-02.サンクンガーデン,2,4,6,35.670336,139.771911,2024-02-08 12:00:05
1294,T2-10.勤労福祉会館,5,0,5,35.748153,139.58765,2024-02-08 12:00:05
1295,K1-133.東京港野鳥公園,13,0,13,35.584217,139.759232,2024-02-08 12:00:05
1296,K1-21.六郷特別出張所,0,8,8,35.55079,139.716517,2024-02-08 12:00:05
1297,H1-54.砂町文化センター,3,17,20,35.680052,139.831874,2024-02-08 12:00:05
1298,D1-08.新宿歴史博物館,3,1,4,35.689984,139.725261,2024-02-08 12:00:05
1299,E1-05.春日地下自転車駐車場,23,3,26,35.708291,139.753335,2024-02-08 12:00:05
1300,E1-15.播磨坂事業所,0,6,6,35.71724,139.74289,2024-02-08 12:00:05
1301,E5-02.不忍通りふれあい館,0,12,12,35.719356,139.764308,2024-02-08 12:00:05
1302,E4-02.向丘地域活動センター,8,5,13,35.717357,139.757817,2024-02-08 12:00:05
1303,C3-18.明治記念館,4,1,5,35.678509,139.721207,2024-02-08 12:00:05
1304,D5-05.中央図書館,13,2,15,35.705018,139.706841,2024-02-08 12:00:05
1305,E2-07.肥後細川庭園,10,3,13,35.713223,139.721699,2024-02-08 12:00:05
1306,A1-05.富士見出張所,0,4,4,35.699187,139.746348,2024-02-08 12:00:05
1307,E5-07.湯島三丁目児童遊園,4,4,8,35.707296,139.769393,2024-02-08 12:00:05
1308,D5-10.桜美林大学 新宿キャンパス,1,6,7,35.705154,139.697562,2024-02-08 12:00:05
1309,A3-08.神田明神（神田神社）,11,2,13,35.702029,139.768245,2024-02-08 12:00:05
1310,E2-14.永青文庫 ミュージアム,5,0,5,35.713145,139.723342,2024-02-08 12:00:05
1311,M5-17.小田急サザンタワー,8,1,9,35.6866,139.70014,2024-02-08 12:00:05
1312,K1-16.ファミリーマート 矢口二丁目店,3,3,6,35.563092,139.693548,2024-02-08 12:00:05
1313,H1-206.北砂5丁目団地2,0,9,9,35.683866,139.831809,2024-02-08 12:00:05
1314,G1-02.八広駅高架下,4,10,14,35.727495,139.828499,2024-02-08 12:00:05
1315,F4-02.Risingplace浅草四番館,0,4,4,35.717963,139.791025,2024-02-08 12:00:05
1316,H1-204.大島四丁目団地2,3,5,8,35.68832,139.828829,2024-02-08 12:00:05
1317,H1-205.大島四丁目団地3,5,5,10,35.688236,139.827711,2024-02-08 12:00:05
1318,H1-106.亀戸中央公園,12,7,19,35.699874,139.834263,2024-02-08 12:00:05
1319,E5-30.湯島3丁目15,0,12,12,35.705148,139.769314,2024-02-08 12:00:05
1320,B4-38.HARUMI FLAG SUN VILLAGE,0,24,24,35.650347,139.771785,2024-02-08 12:00:05
1321,B4-32.HARUMI FLAG SEA VILLAGE,0,10,10,35.648731,139.774995,2024-02-08 12:00:05
1322,B4-31.HARUMI FLAG PORT VILLAGE,0,19,19,35.650604,139.77724,2024-02-08 12:00:05
1323,B4-33.HARUMI FLAG SEA VILLAGE,0,15,15,35.649552,139.776369,2024-02-08 12:00:05
1324,B4-36.HARUMI FLAG SEA VILLAGE,2,10,12,35.650742,139.778097,2024-02-08 12:00:05
1325,B4-35.HARUMI FLAG SEA VILLAGE,1,11,12,35.650573,139.777908,2024-02-08 12:00:05
1326,B4-37.HARUMI FLAG SUN VILLAGE,0,17,17,35.649419,139.771447,2024-02-08 12:00:05
1327,B4-34.HARUMI FLAG SEA VILLAGE,2,10,12,35.649932,139.776958,2024-02-08 12:00:05
1328,B4-39.HARUMI FLAG SUN VILLAGE,0,18,18,35.650863,139.772549,2024-02-08 12:00:05
1329,B4-40.HARUMI FLAG SUN VILLAGE,0,15,15,35.651305,139.773379,2024-02-08 12:00:05
1330,B4-41.HARUMI FLAG SUN VILLAGE,0,17,17,35.649854,139.77334,2024-02-08 12:00:05
1331,B4-42.HARUMI FLAG SUN VILLAGE,0,13,13,35.649329,139.772656,2024-02-08 12:00:05
1332,B4-28.HARUMI FLAG PORT VILLAGE,4,7,11,35.651183,139.776119,2024-02-08 12:00:05
1333,B4-50.HARUMI FLAG PARK VILLAGE,2,7,9,35.648295,139.773973,2024-02-08 12:00:05
1334,B4-49.HARUMI FLAG PARK VILLAGE,4,12,16,35.648636,139.774251,2024-02-08 12:00:05
1335,B4-48.HARUMI FLAG PARK VILLAGE,0,5,5,35.649513,139.775287,2024-02-08 12:00:05
1336,B4-47.HARUMI FLAG PARK VILLAGE,2,4,6,35.649119,139.775138,2024-02-08 12:00:05
1337,B4-46.HARUMI FLAG PARK VILLAGE,0,26,26,35.649642,139.773859,2024-02-08 12:00:05
1338,B4-45.HARUMI FLAG PARK VILLAGE,0,25,25,35.649002,139.772764,2024-02-08 12:00:05
1339,B4-44.HARUMI FLAG PARK VILLAGE,3,10,13,35.648221,139.772666,2024-02-08 12:00:05
1340,B4-30.HARUMI FLAG PORT VILLAGE,1,10,11,35.651136,139.778218,2024-02-08 12:00:05
1341,B4-29.HARUMI FLAG PORT VILLAGE,0,17,17,35.651907,139.777391,2024-02-08 12:00:05
1342,L1-19.三軒茶屋1丁目駐輪場,1,3,4,35.639302,139.674744,2024-02-08 12:00:05
1343,O7-09.方南月極パーキング,8,9,17,35.678921,139.658289,2024-02-08 12:00:05
1344,O5-10.ローソン ツルハドラッグ杉並和田店,0,4,4,35.68942,139.662118,2024-02-08 12:00:05
1345,O2-04.西荻北1丁目,2,3,5,35.708082,139.607543,2024-02-08 12:00:05
1346,K1-75.三井不動産インダストリアルパーク羽田,6,4,10,35.556231,139.751408,2024-02-08 12:00:05
1347,F1-05.ホウエイコート秋葉原,0,2,2,35.703024,139.78052,2024-02-08 12:00:05
1348,C3-36.第35興和ビル,2,2,4,35.666349,139.741781,2024-02-08 12:00:05
1349,B4-53.晴海五丁目ターミナル,24,82,106,35.651627,139.773103,2024-02-08 12:00:05
1350,C5-44.ブランズタワー芝浦,9,0,9,35.643105,139.753039,2024-02-08 12:00:05
1351,A3-47.ホテルヴィラフォンテーヌ東京大手町,13,0,13,35.690602,139.766916,2024-02-08 12:00:05
1352,A1-20.菱和パレス九段,4,1,5,35.693021,139.740317,2024-02-08 12:00:05
0,E5-26.本郷4丁目,0,5,5,35.708596,139.758269,2024-02-08 14:51:04
1,A3-42.内神田3丁目,34,1,35,35.692599,139.770109,2024-02-08 14:51:04
2,T2-76.東中前の森緑地,3,2,5,35.748736,139.574839,2024-02-08 14:51:04
3,A2-20.神田スクエア,18,0,18,35.693408,139.762809,2024-02-08 14:51:04
4,K1-79.Tマークシティホテル東京大森,3,2,5,35.586993,139.736491,2024-02-08 14:51:04
5,K1-80.大森北6丁目,3,0,3,35.579849,139.731241,2024-02-08 14:51:04
6,H1-130.トヨタモビリティ東京 深川店,5,4,9,35.676643,139.816054,2024-02-08 14:51:04
7,H1-131.セブン-イレブン 江東佐賀2丁目店,0,15,15,35.679029,139.793535,2024-02-08 14:51:04
8,H1-132.セブン-イレブン 江東三好4丁目店,0,31,31,35.681418,139.809287,2024-02-08 14:51:04
9,A6-22.半蔵門PREX South,12,2,14,35.683433,139.740756,2024-02-08 14:51:04
10,I1-74.セブン-イレブン西五反田6丁目店,5,0,5,35.622403,139.71771,2024-02-08 14:51:04
11,G2-01.東京ソラマチ,6,1,7,35.709777,139.810189,2024-02-08 14:51:04
12,T2-59.平成公園,2,1,3,35.722917,139.587864,2024-02-08 14:51:04
13,I1-26.大崎西口公園,0,5,5,35.617475,139.729221,2024-02-08 14:51:04
14,I1-96.西五反田２丁目,10,0,10,35.627599,139.720463,2024-02-08 14:51:04
15,H1-172.サンヨーパシフィックマンション,0,9,9,35.668856,139.794069,2024-02-08 14:51:04
16,J1-56.青葉台四丁目街かど公園,3,1,4,35.654009,139.692727,2024-02-08 14:51:04
17,H1-173.森下駅前,7,31,38,35.687837,139.79654,2024-02-08 14:51:04
18,E3-01.大塚地域活動センター跡地,5,4,9,35.718656,139.734556,2024-02-08 14:51:04
19,E2-03.目白台運動公園,28,13,41,35.715556,139.721988,2024-02-08 14:51:04
20,T2-77.大泉なかよし緑地,3,1,4,35.759861,139.581682,2024-02-08 14:51:04
21,E2-01.江戸川橋Ｂ自転車駐車場,43,38,81,35.710381,139.732137,2024-02-08 14:51:04
22,E2-02.江戸川公園,9,10,19,35.710958,139.731165,2024-02-08 14:51:04
23,D7-14.大栄パーク西落合１丁目,3,3,6,35.720028,139.678936,2024-02-08 14:51:04
24,E1-07.礫川地域活動センター,0,7,7,35.712015,139.750284,2024-02-08 14:51:04
25,M6-05.七号通り公園,0,14,14,35.67917,139.67493,2024-02-08 14:51:04
26,H1-138.HW.HILLS新大橋,1,10,11,35.687416,139.795588,2024-02-08 14:51:04
27,B4-21.月島駅前第一駐輪場,16,17,33,35.663681,139.785651,2024-02-08 14:51:04
28,N2-03.野方1丁目,6,1,7,35.712179,139.65603,2024-02-08 14:51:04
29,C5-52.港南四丁目第3アパート駐車場,9,2,11,35.630109,139.747094,2024-02-08 14:51:04
30,E5-27.真正館駐車場,0,4,4,35.714875,139.76394,2024-02-08 14:51:04
31,C5-35.品川駅港南口,4,1,5,35.62822,139.741135,2024-02-08 14:51:04
32,N2-01.NTT野方ビル,3,2,5,35.710285,139.66173,2024-02-08 14:51:04
33,D6-27.新宿三井ビルディング二号館,7,2,9,35.686334,139.692881,2024-02-08 14:51:04
34,D1-10.曙橋駐輪場,2,14,16,35.691888,139.724365,2024-02-08 14:51:04
35,I1-39.MID POINT 目黒不動前,3,1,4,35.628116,139.713149,2024-02-08 14:51:04
36,E3-07.小日向1丁目,0,15,15,35.713388,139.737009,2024-02-08 14:51:04
37,C1-47.パークプレイス三田,8,1,9,35.641791,139.740734,2024-02-08 14:51:04
38,I1-38.ローソン 八潮三丁目店,21,24,45,35.594544,139.760423,2024-02-08 14:51:04
39,C2-24.Dash Living HigashiAzabu,6,0,6,35.655135,139.744449,2024-02-08 14:51:04
40,J1-04.菅刈公園,7,0,7,35.650351,139.692853,2024-02-08 14:51:04
41,O4-09.ローソン杉並本天沼一丁目店,0,3,3,35.712496,139.632778,2024-02-08 14:51:04
42,T3-29.平和台もものき緑地,1,2,3,35.755773,139.661913,2024-02-08 14:51:04
43,D2-10.市谷砂土原町3丁目,3,8,11,35.696242,139.735776,2024-02-08 14:51:04
44,C1-48.竹芝客船ターミナル,10,5,15,35.655139,139.762812,2024-02-08 14:51:04
45,B1-06.伊場仙ビル,3,2,5,35.687624,139.777125,2024-02-08 14:51:04
46,B2-01.鉄砲洲児童公園（西側）,0,21,21,35.67224,139.779348,2024-02-08 14:51:04
47,B1-04.産業会館,2,2,4,35.694164,139.787057,2024-02-08 14:51:04
48,B1-05.日本橋保健センター,0,11,11,35.687419,139.779053,2024-02-08 14:51:04
49,B2-05.ＮＴＴ東日本築地ビル,0,5,5,35.670674,139.775993,2024-02-08 14:51:04
50,B2-02.柳通り（東京スクエアガーデン前）,10,2,12,35.676393,139.768319,2024-02-08 14:51:04
51,B2-03.男女平等センター（ブーケ21）,8,1,9,35.673923,139.778671,2024-02-08 14:51:04
52,C2-13.麻布運動場,8,0,8,35.651718,139.728165,2024-02-08 14:51:04
53,D2-08.旧市ヶ谷商業高校,0,16,16,35.70074,139.731363,2024-02-08 14:51:04
54,C1-35.セブン-イレブン 三田駅北店,4,0,4,35.649032,139.750147,2024-02-08 14:51:04
55,B4-12.THE TOKYO TOWERS,0,97,97,35.655497,139.774556,2024-02-08 14:51:04
56,C5-21.セブン-イレブン 芝浦3丁目店,4,1,5,35.642399,139.746992,2024-02-08 14:51:04
57,H1-67.セブン-イレブン 江東亀戸9丁目店,1,13,14,35.69766,139.843408,2024-02-08 14:51:04
58,C2-15.住友不動産六本木グランドタワー,0,13,13,35.664367,139.737185,2024-02-08 14:51:04
59,C2-14.元麻布ヒルズ,1,8,9,35.653608,139.73138,2024-02-08 14:51:04
60,M6-14.ドコモショップ笹塚店,0,5,5,35.67323,139.66393,2024-02-08 14:51:04
61,N4-07.南台2丁目,2,10,12,35.68509,139.671102,2024-02-08 14:51:04
62,K1-68.ART FACTORY 城南島,5,3,8,35.580511,139.775957,2024-02-08 14:51:04
63,H1-178.北砂7丁目団地(第二),0,4,4,35.678031,139.837193,2024-02-08 14:51:04
64,H1-179.北砂7丁目団地(第三),0,11,11,35.678246,139.8366,2024-02-08 14:51:04
65,A1-17.雉子橋集積所,6,0,6,35.692605,139.755761,2024-02-08 14:51:04
66,H1-177.北砂7丁目団地(第一),0,11,11,35.678537,139.837391,2024-02-08 14:51:04
67,K1-95.城南島海浜公園,10,6,16,35.578259,139.783505,2024-02-08 14:51:04
68,B3-17.銀座6丁目-SQUARE,7,0,7,35.66711,139.76643,2024-02-08 14:51:04
69,J1-33.芳窪街かど公園,12,1,13,35.629861,139.666293,2024-02-08 14:51:04
70,N3-07.なかのZERO,2,3,5,35.70442,139.67141,2024-02-08 14:51:04
71,N4-04.弥生町5丁目,4,8,12,35.690897,139.668345,2024-02-08 14:51:04
72,A3-44.THE WAVES AKIHABARA,0,5,5,35.694679,139.779504,2024-02-08 14:51:04
73,K1-138.羽田エアポートガーデン,4,5,9,35.544534,139.763244,2024-02-08 14:51:04
74,C3-26.ホテルリブマックス赤坂,2,3,5,35.67011,139.733375,2024-02-08 14:51:04
75,C1-52.NTT三田ビル,3,2,5,35.652549,139.747789,2024-02-08 14:51:04
76,D1-07.Dash Living Shinjuku,4,0,4,35.689757,139.710091,2024-02-08 14:51:04
77,O4-07.ローソン成田西三丁目店,0,5,5,35.690311,139.62178,2024-02-08 14:51:04
78,H1-152.コンポジット亀戸ウエスト,0,10,10,35.699187,139.82429,2024-02-08 14:51:04
79,E1-13.エルアージュ小石川,0,26,26,35.71399,139.75137,2024-02-08 14:51:04
80,B4-22.リビオレゾン勝どきNEX,0,44,44,35.65554,139.77102,2024-02-08 14:51:04
81,H1-176.JMFビル東陽町02,3,3,6,35.667677,139.823552,2024-02-08 14:51:04
82,H1-102.ファミリーマート東砂七丁目店,0,16,16,35.672714,139.837914,2024-02-08 14:51:04
83,H1-101.ファミリーマート新木場一丁目店,0,6,6,35.642571,139.836766,2024-02-08 14:51:04
84,K1-67.京浜島防災広場,0,23,23,35.570508,139.764013,2024-02-08 14:51:04
85,K1-66.昭和島二丁目公園,0,12,12,35.575097,139.751446,2024-02-08 14:51:04
86,I1-80.リバーサイド品川港南ビル,6,2,8,35.622714,139.74471,2024-02-08 14:51:04
87,J1-10.NTTデータ駒場研修センター,6,4,10,35.655779,139.680948,2024-02-08 14:51:04
88,A2-17.竹橋ビル,8,0,8,35.692396,139.75639,2024-02-08 14:51:04
89,H1-91.亀戸駅北口第三自転車駐車場,13,5,18,35.696913,139.823911,2024-02-08 14:51:04
90,H1-92.亀戸駅東口第二自転車駐車場,7,8,15,35.69788,139.830559,2024-02-08 14:51:04
91,K1-59.京急梅屋敷第1駐車場,5,2,7,35.565768,139.727396,2024-02-08 14:51:04
92,K1-60.京急平和島第1駐車場,9,0,9,35.576336,139.733691,2024-02-08 14:51:04
93,I1-42.京急青横駐車場,3,0,3,35.611582,139.742528,2024-02-08 14:51:04
94,I1-43.京急南大井駐車場,3,5,8,35.594722,139.737101,2024-02-08 14:51:04
95,O7-05.ジーベック方南町,1,1,2,35.680849,139.65626,2024-02-08 14:51:04
96,H1-100.URアーバンライフ亀戸,21,7,28,35.697935,139.821855,2024-02-08 14:51:04
97,A6-10.紀尾井町ビル（西側）,9,3,12,35.682516,139.736494,2024-02-08 14:51:04
98,C3-02.赤坂地区総合支所,0,7,7,35.674788,139.731423,2024-02-08 14:51:04
99,C2-08.ファミリーマート西麻布霞町店,0,5,5,35.661673,139.721118,2024-02-08 14:51:04
100,A6-09.紀尾井町ビル（北側）,6,0,6,35.682902,139.736494,2024-02-08 14:51:04
101,H1-28.有明客船ターミナル,9,2,11,35.630063,139.792209,2024-02-08 14:51:04
102,B1-12.ファミリーマート堀留町二丁目店,0,7,7,35.687786,139.78205,2024-02-08 14:51:04
103,H1-26.青海客船ターミナル,14,1,15,35.619234,139.774485,2024-02-08 14:51:04
104,H1-27.パレットタウン乗船場,10,0,10,35.624467,139.781305,2024-02-08 14:51:04
105,O1-04.井草1-34,7,8,15,35.72758,139.62432,2024-02-08 14:51:04
106,C1-76.浜松町駅北口交通広場(ハマサイト前),16,0,16,35.656647,139.758301,2024-02-08 14:51:04
107,J1-52.駒沢一丁目公園前,7,2,9,35.629807,139.662398,2024-02-08 14:51:04
108,C1-75.虎ノ門PFビル,6,1,7,35.665466,139.748014,2024-02-08 14:51:04
109,B2-18.旭ビルディング,11,0,11,35.678291,139.78157,2024-02-08 14:51:04
110,N2-09.松山駐車場No.1,2,4,6,35.722991,139.673048,2024-02-08 14:51:04
111,I1-82.トミンハイム西五反田四丁目,2,4,6,35.627386,139.711182,2024-02-08 14:51:04
112,O4-03.ザ・ハウス,0,12,12,35.707035,139.633066,2024-02-08 14:51:04
113,O4-04.阿佐谷南3-43,15,1,16,35.704147,139.631955,2024-02-08 14:51:04
114,K1-83.北千束北児童公園,6,0,6,35.611085,139.68599,2024-02-08 14:51:04
115,I1-95.東京レールゲート EAST,7,3,10,35.584998,139.761055,2024-02-08 14:51:04
116,M5-19.グランリヴィエール代々木,3,2,5,35.68285,139.698528,2024-02-08 14:51:04
117,H1-192.ウエリスアーバン水天宮前,3,1,4,35.678296,139.791949,2024-02-08 14:51:04
118,N2-08.江古田区民活動センター,1,2,3,35.728893,139.670119,2024-02-08 14:51:04
119,D7-04.セブン-イレブン 新宿下落合3丁目店,2,1,3,35.722645,139.701982,2024-02-08 14:51:04
120,K1-82.西蒲田公園,7,0,7,35.561499,139.71123,2024-02-08 14:51:04
121,H1-68.芝浦工業大学附属中学高等学校,0,29,29,35.649274,139.792213,2024-02-08 14:51:04
122,K1-24.東糀谷防災公園,0,20,20,35.557074,139.74575,2024-02-08 14:51:04
123,H1-03.東雲駅,6,9,15,35.640736,139.804331,2024-02-08 14:51:04
124,K1-26.大森諏訪公園,0,13,13,35.574785,139.730762,2024-02-08 14:51:04
125,K1-25.鶴渡公園,2,1,3,35.56892,139.725082,2024-02-08 14:51:04
126,N3-10.エーエスホームズⅡ駐車場,5,1,6,35.702659,139.662563,2024-02-08 14:51:04
127,J1-37.中目黒公園,12,6,18,35.640398,139.704069,2024-02-08 14:51:04
128,A1-10.ヒューリック九段ビル,6,0,6,35.696449,139.750784,2024-02-08 14:51:04
129,K1-93.六間堀仲羽公園,3,1,4,35.548864,139.74484,2024-02-08 14:51:04
130,T2-53.上練馬公園,2,2,4,35.772863,139.626969,2024-02-08 14:51:04
131,M5-01.初台駅南口,0,13,13,35.680154,139.685937,2024-02-08 14:51:04
132,C1-60.専売ビル,14,0,14,35.647659,139.745055,2024-02-08 14:51:04
133,K1-85.大田区青少年交流センター ゆいっつ,2,2,4,35.583555,139.743381,2024-02-08 14:51:04
134,I1-64.株式会社ユアス ゆうパック取扱所：ポストのうしろ,8,2,10,35.622965,139.731014,2024-02-08 14:51:04
135,C4-09.ケーヨーデイツー三田店,2,3,5,35.646375,139.740061,2024-02-08 14:51:04
136,C1-61.環三浜松町駅南,24,14,38,35.653096,139.75739,2024-02-08 14:51:04
137,K1-84.佐伯山緑地,2,11,13,35.581698,139.71491,2024-02-08 14:51:04
138,C1-59.セレスティン芝三井ビルディング,4,7,11,35.650845,139.748346,2024-02-08 14:51:04
139,G2-07.レオーネ押上cube,3,1,4,35.706167,139.815955,2024-02-08 14:51:04
140,E1-06.文京シビックセンター,10,9,19,35.708265,139.751983,2024-02-08 14:51:04
141,D2-13.THE CENTER TOKYO,0,14,14,35.695646,139.725722,2024-02-08 14:51:04
142,E5-22.千駄木2丁目,0,6,6,35.724828,139.762583,2024-02-08 14:51:04
143,C4-07.品川プリンスホテル,8,2,10,35.628266,139.734171,2024-02-08 14:51:04
144,A3-43.unito CHIYODA,1,2,3,35.69474,139.77929,2024-02-08 14:51:04
145,C4-06.白金プラチナレジデンス,0,24,24,35.644134,139.723432,2024-02-08 14:51:04
146,I1-63.セブン-イレブン西五反田店,3,0,3,35.62765,139.719212,2024-02-08 14:51:04
147,H1-53.豊洲シビックセンター,7,11,18,35.653991,139.795513,2024-02-08 14:51:04
148,T3-16.練馬区役所東庁舎(第一),10,0,10,35.735428,139.652379,2024-02-08 14:51:04
149,T2-68.さくら原っぱ緑地,2,3,5,35.731372,139.619164,2024-02-08 14:51:04
150,T2-69.久保新田さくら公園,1,3,4,35.76525,139.575978,2024-02-08 14:51:04
151,H1-187.森下文化センター,0,5,5,35.685344,139.80234,2024-02-08 14:51:04
152,E4-04.セブン-イレブン 文京本駒込１丁目店,3,2,5,35.724707,139.750469,2024-02-08 14:51:04
153,M2-13.恵比寿プライムスクエアタワー南,8,0,8,35.649257,139.713272,2024-02-08 14:51:04
154,H1-48.セブン-イレブン 江東潮見２丁目店,0,10,10,35.658249,139.815775,2024-02-08 14:51:04
155,H1-51.豊洲交通広場　東,20,6,26,35.654958,139.795718,2024-02-08 14:51:04
156,H1-52.辰巳駅,0,15,15,35.646756,139.809295,2024-02-08 14:51:04
157,D7-01.下落合図書館,7,8,15,35.715894,139.698578,2024-02-08 14:51:04
158,H1-50.豊洲交通広場　北,5,5,10,35.655457,139.795161,2024-02-08 14:51:04
159,A6-14.MG市ヶ谷ビルディング,0,3,3,35.690861,139.736393,2024-02-08 14:51:04
160,T2-21.ファミリーマート 練馬大泉町一丁目店,2,2,4,35.768448,139.601679,2024-02-08 14:51:04
161,A6-15.東急番町ビル,3,2,5,35.688929,139.7358,2024-02-08 14:51:04
162,A1-18.東京区政会館別館(特別区研修所),3,0,3,35.696202,139.752351,2024-02-08 14:51:04
163,T3-18.練馬駅北,10,9,19,35.738585,139.653396,2024-02-08 14:51:04
164,C1-43.KDX浜松町プレイス,4,2,6,35.658169,139.752509,2024-02-08 14:51:04
165,C5-27.プレミア海岸ビル,11,8,19,35.648948,139.757895,2024-02-08 14:51:04
166,I1-29.ローソン 勝島一丁目店,0,19,19,35.599987,139.745195,2024-02-08 14:51:04
167,H1-72.ネクストサイト深川ビル,19,2,21,35.674578,139.797396,2024-02-08 14:51:04
168,T1-11.むつみ台,1,1,2,35.768528,139.639807,2024-02-08 14:51:04
169,T1-10.月見大橋下,2,3,5,35.758366,139.628982,2024-02-08 14:51:04
170,H1-167.大島八丁目公園,4,6,10,35.688074,139.838932,2024-02-08 14:51:04
171,K1-36.セブン-イレブン 大田区南雪谷5丁目店,0,11,11,35.587815,139.691748,2024-02-08 14:51:04
172,L1-01.羽根木公園,5,7,12,35.66088,139.654546,2024-02-08 14:51:04
173,P1-02.雑司ヶ谷一丁目,8,0,8,35.721738,139.723103,2024-02-08 14:51:04
174,I1-66.南大井文化センター駐車場,1,5,6,35.596733,139.73804,2024-02-08 14:51:04
175,L1-05.NTT烏山ビル,0,4,4,35.669285,139.597931,2024-02-08 14:51:04
176,L1-04.下馬中央公園,1,3,4,35.63367,139.678139,2024-02-08 14:51:04
177,L1-03.世田谷城阯公園,0,6,6,35.645838,139.647799,2024-02-08 14:51:04
178,L1-02.若林公園,5,2,7,35.647075,139.654472,2024-02-08 14:51:04
179,T2-30.ファミリーマート 練馬東大泉四丁目店,3,1,4,35.750804,139.58243,2024-02-08 14:51:04
180,L1-07.NTT成城ビル,2,1,3,35.648021,139.606529,2024-02-08 14:51:04
181,L1-06.NTT瀬田ビル,0,12,12,35.618357,139.626191,2024-02-08 14:51:04
182,T3-12.春日町西公園,3,1,4,35.748092,139.636587,2024-02-08 14:51:04
183,T3-13.平和台児童公園,2,2,4,35.757298,139.664139,2024-02-08 14:51:04
184,T2-38.ファミリーマート 練馬上石神井四丁目店,7,2,9,35.727195,139.590179,2024-02-08 14:51:04
185,B1-28.アイルイムーブル日本橋,9,0,9,35.684502,139.77906,2024-02-08 14:51:04
186,A2-28.NTTコミュニケーションズ一ツ橋ビル駐車場,8,0,8,35.6915,139.75685,2024-02-08 14:51:04
187,C3-32.乃木公園,4,1,5,35.667936,139.72745,2024-02-08 14:51:04
188,T3-14.わらべ児童遊園,3,1,4,35.759774,139.654529,2024-02-08 14:51:04
189,T2-52.田柄中央児童公園,3,2,5,35.762395,139.641522,2024-02-08 14:51:04
190,M4-06.THE SHARE 原宿,9,1,10,35.671823,139.708158,2024-02-08 14:51:04
191,K1-10.セブン‐イレブン 大田区西糀谷１丁目店,4,0,4,35.559647,139.730098,2024-02-08 14:51:04
192,K1-09.セブン‐イレブン 大田区西蒲田２丁目店,0,19,19,35.570763,139.705895,2024-02-08 14:51:04
193,H1-63.東京スイソミル,0,14,14,35.65637,139.811765,2024-02-08 14:51:04
194,B1-16.小網町児童遊園,4,1,5,35.683695,139.780043,2024-02-08 14:51:04
195,H1-61.Brilliaランニングスタジアムマギーズ東京前,4,5,9,35.648281,139.786112,2024-02-08 14:51:04
196,K1-08.セブン‐イレブン 大田区東蒲田キネマ通り店,3,0,3,35.562368,139.730143,2024-02-08 14:51:04
197,C1-34.城山ガーデン,8,0,8,35.664479,139.743731,2024-02-08 14:51:04
198,H1-62.扇橋一丁目公園南,0,42,42,35.683343,139.812161,2024-02-08 14:51:04
199,J1-23.清水池公園,8,15,23,35.623756,139.692517,2024-02-08 14:51:04
200,C5-18.パークタワー品川ベイワード,10,0,10,35.634529,139.748378,2024-02-08 14:51:04
201,E4-07.ファミリーマート 本駒込二丁目店,3,1,4,35.727279,139.74627,2024-02-08 14:51:04
202,C5-45.パークアクシス芝浦キャナル,6,0,6,35.644794,139.755688,2024-02-08 14:51:04
203,A2-02.西神田公園（北側）,7,2,9,35.698591,139.755113,2024-02-08 14:51:04
204,T2-49.善福寺公園テニスクラブ,5,4,9,35.719674,139.593696,2024-02-08 14:51:04
205,H1-193.ライフ豊洲店,26,1,27,35.651833,139.79962,2024-02-08 14:51:04
206,A2-01.神田駿河台下,53,0,53,35.695762,139.761585,2024-02-08 14:51:04
207,I1-51.京急鈴ヶ森駐車場,0,15,15,35.589573,139.735585,2024-02-08 14:51:04
208,T2-36.サントピア テニスパーク,5,5,10,35.75195,139.616028,2024-02-08 14:51:04
209,G4-13. Parking in 両国駅前第2,0,3,3,35.696492,139.791591,2024-02-08 14:51:04
210,K1-120.蒲田駅消費者生活センター横自転車駐車場 屋上部,6,0,6,35.560125,139.71569,2024-02-08 14:51:04
211,N3-18.藤和シティコープ新中野3,5,1,6,35.69942,139.673964,2024-02-08 14:51:04
212,K1-145.トヨタモビリティ東京馬込テクニカル研修センター,7,6,13,35.58209,139.701362,2024-02-08 14:51:04
213,K1-100.多摩川台公園,5,0,5,35.589794,139.666955,2024-02-08 14:51:04
214,C1-54.ニッセイ虎ノ門ビル,11,1,12,35.664344,139.746662,2024-02-08 14:51:04
215,I1-52.カスタリアタワー品川シーサイド,9,0,9,35.607557,139.746866,2024-02-08 14:51:04
216,I1-53.天王洲公園,2,2,4,35.620355,139.749339,2024-02-08 14:51:04
217,C2-18.ブランシェ東麻布,0,3,3,35.656769,139.743224,2024-02-08 14:51:04
218,A3-45.鍛冶町2丁目,12,5,17,35.691578,139.77138,2024-02-08 14:51:04
219,H1-87.パークアクシス木場キャナルウエスト,0,18,18,35.662514,139.803694,2024-02-08 14:51:04
220,D6-20.淀橋けやき橋公園,6,9,15,35.693544,139.685806,2024-02-08 14:51:04
221,A3-46.神田須田町2丁目,0,0,0,35.695457,139.772972,2024-02-08 14:51:04
222,B3-13.国立がん研究センター,11,0,11,35.664871,139.767188,2024-02-08 14:51:04
223,I1-35.シーフォートスクエア,16,2,18,35.622954,139.750593,2024-02-08 14:51:04
224,K1-55.カバヤビル,6,12,18,35.576275,139.713704,2024-02-08 14:51:04
225,C3-24.SHARE GREEN 南青山 西エントランス,0,7,7,35.668419,139.724676,2024-02-08 14:51:04
226,A5-06.APA HOTEL PRIDE〈国会議事堂前〉,10,0,10,35.674468,139.741328,2024-02-08 14:51:04
227,A6-17.東京ガーデンテラス紀尾井町（プリンス通り側）,12,0,12,35.680431,139.738203,2024-02-08 14:51:04
228,B4-07.勝どき駅地下駐輪場,56,4,60,35.658135,139.776131,2024-02-08 14:51:04
229,B4-08.東京ミッドベイ勝どき（西仲通り）,5,9,14,35.656449,139.771302,2024-02-08 14:51:04
230,B3-04.築地市場駅地下駐輪場,17,0,17,35.664265,139.767426,2024-02-08 14:51:04
231,C5-10.シーバンス,11,4,15,35.649959,139.756068,2024-02-08 14:51:04
232,H1-34.門前仲町駅,48,2,50,35.67391,139.796165,2024-02-08 14:51:04
233,C3-10.ファミリーマート特許庁前店,0,7,7,35.670364,139.744684,2024-02-08 14:51:04
234,A1-01.千代田区役所,6,0,6,35.693799,139.753281,2024-02-08 14:51:04
235,A1-03.東京区政会館（メトロA5出口）,7,0,7,35.701073,139.747525,2024-02-08 14:51:04
236,B3-06.朝日新聞東京本社,2,2,4,35.664457,139.767214,2024-02-08 14:51:04
237,A1-04.東京区政会館（西側駐輪場）,6,1,7,35.701347,139.746951,2024-02-08 14:51:04
238,T1-03.四季の香公園,5,0,5,35.760585,139.626284,2024-02-08 14:51:04
239,T1-04.春の風公園,3,0,3,35.75731,139.624922,2024-02-08 14:51:04
240,T1-05.夏の雲公園,5,0,5,35.753964,139.629116,2024-02-08 14:51:04
241,H1-194.セブン-イレブン江東北砂5丁目店,0,5,5,35.68268,139.8353,2024-02-08 14:51:04
242,O5-03.新高円寺地下自転車駐輪場,4,9,13,35.697265,139.649397,2024-02-08 14:51:04
243,O3-06.アミーズ荻窪,3,1,4,35.714616,139.625116,2024-02-08 14:51:04
244,T2-03.リヴィンオズ大泉店,7,1,8,35.752383,139.594855,2024-02-08 14:51:04
245,O6-06.上高井戸1丁目,0,7,7,35.673055,139.611293,2024-02-08 14:51:04
246,T2-05.石神井図書館,3,1,4,35.736076,139.599676,2024-02-08 14:51:04
247,T2-06.総合体育館,3,0,3,35.748957,139.621385,2024-02-08 14:51:04
248,O5-02.馬橋ハイツ,4,2,6,35.705686,139.642587,2024-02-08 14:51:04
249,N1-07.プランドール上鷺宮,1,6,7,35.733292,139.630369,2024-02-08 14:51:04
250,E1-18.アーバネックス小石川春日,3,4,7,35.709261,139.746374,2024-02-08 14:51:04
251,T3-03.新桜台駅自転車駐車場,5,2,7,35.740378,139.667502,2024-02-08 14:51:04
252,O3-05.Nちゃりパーク,16,6,22,35.70389,139.6185,2024-02-08 14:51:04
253,O5-01.朝霞ハイツ,7,4,11,35.71038,139.64519,2024-02-08 14:51:04
254,L1-11.アイムタウン上祖師谷,2,1,3,35.656849,139.594422,2024-02-08 14:51:04
255,L1-12.鈴木リースホーム駐車場,11,3,14,35.646648,139.633038,2024-02-08 14:51:04
256,L1-13.わびさびホステル,2,2,4,35.647393,139.667085,2024-02-08 14:51:04
257,G2-05.リアナスカイパーク押上,5,0,5,35.715733,139.815451,2024-02-08 14:51:04
258,T3-02.早宮第二自転車駐車場,7,4,11,35.756846,139.652154,2024-02-08 14:51:04
259,I1-37.ガーデンシティ品川御殿山,5,4,9,35.623466,139.734359,2024-02-08 14:51:04
260,T2-47.上石神井駅北第二自転車駐車場,6,4,10,35.726523,139.5905,2024-02-08 14:51:04
261,C1-51.環二新橋四丁目,10,2,12,35.663843,139.757697,2024-02-08 14:51:04
262,M6-07.笹塚東,15,6,21,35.675436,139.670594,2024-02-08 14:51:04
263,M3-10.ウノサワ東急ビル,8,0,8,35.647757,139.712981,2024-02-08 14:51:04
264,C2-26.一の橋公園,4,3,7,35.655367,139.738075,2024-02-08 14:51:04
265,H1-14.ホテルリブマックス東京潮見駅前,4,2,6,35.658351,139.818229,2024-02-08 14:51:04
266,D2-12.ヴィアイン飯田橋後楽園,0,14,14,35.705774,139.743366,2024-02-08 14:51:04
267,D3-08.ホテルリブマックス高田馬場駅前,7,1,8,35.712952,139.701356,2024-02-08 14:51:04
268,H1-103.清澄庭園,7,1,8,35.680948,139.796917,2024-02-08 14:51:04
269,H1-104.木場公園,0,16,16,35.676488,139.809616,2024-02-08 14:51:04
270,H1-105.猿江恩賜公園,8,0,8,35.692277,139.817491,2024-02-08 14:51:04
271,G4-07.ディアレイシャス両国,2,2,4,35.69955,139.803204,2024-02-08 14:51:04
272,T2-46.大泉郵便局バス停自転車駐車場,0,9,9,35.766491,139.587232,2024-02-08 14:51:04
273,I1-18.東品川公園,5,0,5,35.61379,139.746617,2024-02-08 14:51:04
274,J1-03.西郷山公園,5,1,6,35.650688,139.696696,2024-02-08 14:51:04
275,J1-02.駒場野公園,10,4,14,35.657718,139.681043,2024-02-08 14:51:04
276,D2-14.ローソン 神楽坂駅北店,0,16,16,35.704201,139.735815,2024-02-08 14:51:04
277,K1-65.下丸子3丁目,6,6,12,35.571711,139.685337,2024-02-08 14:51:04
278,T2-43.学園通り自転車駐車場,8,0,8,35.7547,139.5871,2024-02-08 14:51:04
279,I1-46.セブン-イレブン 品川東中延2丁目店,0,8,8,35.608721,139.714158,2024-02-08 14:51:04
280,T2-04.石神井公園駅南口,9,3,12,35.743354,139.606592,2024-02-08 14:51:04
281,J1-06.観音橋自転車置場,17,28,45,35.642251,139.69692,2024-02-08 14:51:04
282,J1-05.東山公園　北,0,12,12,35.64853,139.686309,2024-02-08 14:51:04
283,J1-45.プラウド中目黒,0,2,2,35.63767,139.7045,2024-02-08 14:51:04
284,H1-168.大島五丁目公園,12,1,13,35.68642,139.836151,2024-02-08 14:51:04
285,J1-47.本町みなみ街かど公園,4,13,17,35.61847,139.70019,2024-02-08 14:51:04
286,J1-48.グランドエクセル祐天寺,0,17,17,35.64372,139.68777,2024-02-08 14:51:04
287,K1-101.小池公園,0,5,5,35.599541,139.697962,2024-02-08 14:51:04
288,H1-171.LOGI’Q南砂町,7,1,8,35.672877,139.842339,2024-02-08 14:51:04
289,H1-153.三井リンクラボ新木場1,6,4,10,35.63851,139.823534,2024-02-08 14:51:04
290,H1-154.やぐら橋下,19,1,20,35.631132,139.792726,2024-02-08 14:51:04
291,D5-11.NTTコミュニケーションズ新宿ビル,2,6,8,35.699312,139.696468,2024-02-08 14:51:04
292,C5-31.ヒルトン東京お台場,3,7,10,35.626267,139.771438,2024-02-08 14:51:04
293,K1-78.城南鋳物団地協同組合,0,10,10,35.567562,139.766854,2024-02-08 14:51:04
294,I1-68.八潮公園第二,0,7,7,35.600003,139.754288,2024-02-08 14:51:04
295,I1-67.八潮公園第一,0,10,10,35.601149,139.754284,2024-02-08 14:51:04
296,H1-123.ダイワロイネットホテル東京有明,19,0,19,35.634316,139.793199,2024-02-08 14:51:04
297,J1-24.ボヌールREIWA,4,1,5,35.612389,139.676238,2024-02-08 14:51:04
298,B2-12.東京ダイヤビルディング（東側）,16,2,18,35.674835,139.785656,2024-02-08 14:51:04
299,J1-15.二の橋自転車置場2,14,2,16,35.614391,139.678396,2024-02-08 14:51:04
300,H1-77.ライフ東砂店,0,10,10,35.684641,139.844243,2024-02-08 14:51:04
301,D1-09.NTT四谷ビル,1,2,3,35.691188,139.712079,2024-02-08 14:51:04
302,E4-11.プライマル千石,0,14,14,35.727519,139.742815,2024-02-08 14:51:04
303,I1-23.東海橋防災船着場,0,9,9,35.616114,139.74033,2024-02-08 14:51:04
304,A4-12.東京ミッドタウン日比谷,0,5,5,35.674274,139.759111,2024-02-08 14:51:04
305,K1-46.池上駅前自転車駐車場,6,6,12,35.571478,139.702779,2024-02-08 14:51:04
306,I1-24.しながわ区民公園(中央口),1,13,14,35.593611,139.738056,2024-02-08 14:51:04
307,T2-13.セブン-イレブン 練馬石神井町8丁目店,0,5,5,35.750414,139.600011,2024-02-08 14:51:04
308,O3-04.アヴァンセ阿佐ヶ谷,1,1,2,35.712,139.62816,2024-02-08 14:51:04
309,B4-01.黎明橋公園（駐輪場）,0,12,12,35.656071,139.780068,2024-02-08 14:51:04
310,T2-32.セブン-イレブン 練馬東大泉NTTビル店,4,4,8,35.750761,139.594457,2024-02-08 14:51:04
311,K1-142.コーラル洗足池,9,1,10,35.604567,139.689096,2024-02-08 14:51:04
312,K1-28.鵜の木特別出張所,4,0,4,35.574886,139.685122,2024-02-08 14:51:04
313,T1-02.ホテルカデンツァ東京,12,0,12,35.755106,139.621675,2024-02-08 14:51:04
314,C2-16.ザ・ベルグレイヴィア麻布,0,6,6,35.657264,139.743821,2024-02-08 14:51:04
315,N3-11.上高田区民活動センター,3,2,5,35.711501,139.672761,2024-02-08 14:51:04
316,T3-30.北西大松公園,2,2,4,35.765979,139.64931,2024-02-08 14:51:04
317,D6-05.新宿中央公園（水の広場）,5,1,6,35.690474,139.690219,2024-02-08 14:51:04
318,D6-07.新宿フロントタワー,3,6,9,35.696387,139.689924,2024-02-08 14:51:04
319,T2-73.早実グラウンド記念公園,2,2,4,35.734615,139.576214,2024-02-08 14:51:04
320,O7-03.永福町西幸モータープール東,2,9,11,35.67156,139.64609,2024-02-08 14:51:04
321,D1-03.新左門児童遊園,0,4,4,35.684523,139.720519,2024-02-08 14:51:04
322,D1-04.四谷見附公園,0,31,31,35.683448,139.728425,2024-02-08 14:51:04
323,I1-54.天王洲オーシャンスクエア,12,4,16,35.622356,139.749468,2024-02-08 14:51:04
324,D6-01.新宿区役所本庁舎,46,0,46,35.693602,139.703229,2024-02-08 14:51:04
325,D6-02.新宿区役所第二分庁舎,34,1,35,35.693976,139.706134,2024-02-08 14:51:04
326,D6-03.新宿中央公園（ポケットパーク）,9,0,9,35.691559,139.690029,2024-02-08 14:51:04
327,D6-04.新宿中央公園（ちびっこ広場）,7,3,10,35.686649,139.689821,2024-02-08 14:51:04
328,A6-21.日本工営ビル,2,0,2,35.684584,139.734442,2024-02-08 14:51:04
329,I1-77.セブン-イレブン品川西中延1丁目店,0,19,19,35.612217,139.708164,2024-02-08 14:51:04
330,T1-01.光が丘駅前広場,12,1,13,35.759164,139.629466,2024-02-08 14:51:04
331,T2-37.上石神井2丁目,2,6,8,35.729615,139.59532,2024-02-08 14:51:04
332,I1-75.セブン-イレブン品川二葉4丁目店,0,6,6,35.603275,139.713428,2024-02-08 14:51:04
333,M5-13.セブン-イレブン初台店,0,13,13,35.675049,139.68444,2024-02-08 14:51:04
334,D6-24.ＮＴＴ東日本 本社ビル,8,4,12,35.683102,139.688852,2024-02-08 14:51:04
335,H1-134.豊洲ぐるり公園,10,12,22,35.643141,139.777821,2024-02-08 14:51:04
336,H1-133.北砂2丁目公園,0,28,28,35.679001,139.825809,2024-02-08 14:51:04
337,E3-08.サガラマンション,0,4,4,35.722833,139.734662,2024-02-08 14:51:04
338,O4-05.阿佐ヶ谷南1-30,1,2,3,35.700703,139.639985,2024-02-08 14:51:04
339,O5-06.EXAM高円寺南,5,0,5,35.70273,139.65864,2024-02-08 14:51:04
340,G2-03.押上１丁目２６-４,5,0,5,35.710323,139.815215,2024-02-08 14:51:04
341,K1-132.多摩川駅前自転車等駐車場,15,0,15,35.587232,139.669519,2024-02-08 14:51:04
342,C5-47.oak港南品川,22,3,25,35.62413,139.744831,2024-02-08 14:51:04
343,D3-15.カースルいずみ,8,6,14,35.711324,139.711976,2024-02-08 14:51:04
344,C5-15.セブン-イレブン 港区芝浦ふ頭店,0,5,5,35.640215,139.755971,2024-02-08 14:51:04
345,C5-14.セブン-イレブン 港区汐彩橋店,0,13,13,35.640481,139.753659,2024-02-08 14:51:04
346,D5-01.新宿コズミックセンター,0,8,8,35.705244,139.70841,2024-02-08 14:51:04
347,H1-45.夢の島競技場,18,2,20,35.648596,139.824936,2024-02-08 14:51:04
348,E1-01.後楽橋横,25,0,25,35.702746,139.752009,2024-02-08 14:51:04
349,B1-15.ロイヤルパークホテル,0,15,15,35.682332,139.78722,2024-02-08 14:51:04
350,C4-05.白金台駅自転車駐車場,4,10,14,35.638927,139.727083,2024-02-08 14:51:04
351,E1-02.東京ドーム（ミーツポート）,7,2,9,35.70311,139.754951,2024-02-08 14:51:04
352,M2-06.あいおいニッセイ同和損保恵比寿ビル,6,1,7,35.647237,139.71512,2024-02-08 14:51:04
353,J1-12.工大橋下流自転車置場,3,0,3,35.605828,139.680265,2024-02-08 14:51:04
354,C5-25.NEX-TEC芝浦,37,1,38,35.639571,139.755551,2024-02-08 14:51:04
355,H1-175.ダイアパレス大島駅前,1,1,2,35.689543,139.836394,2024-02-08 14:51:04
356,C1-65.東京ポートシティ竹芝,11,2,13,35.654757,139.761516,2024-02-08 14:51:04
357,O2-03.西荻北5-8-17,3,2,5,35.709712,139.601846,2024-02-08 14:51:04
358,B2-21.八重洲二丁目北地区広場,0,5,5,35.67942,139.77004,2024-02-08 14:51:04
359,I1-101.下神明駅前,25,0,25,35.60838,139.726587,2024-02-08 14:51:04
360,N2-04.野方2丁目,5,1,6,35.713018,139.656768,2024-02-08 14:51:04
361,N2-05.野方3丁目,0,11,11,35.717877,139.654732,2024-02-08 14:51:04
362,K1-88.大田久が原西郵便局,0,6,6,35.582756,139.6925,2024-02-08 14:51:04
363,C5-51.トミンタワー台場一番街,2,4,6,35.634627,139.77663,2024-02-08 14:51:04
364,C4-10.亀塚公園,10,0,10,35.642764,139.741174,2024-02-08 14:51:04
365,H1-190.福山通運 東京支店,0,23,23,35.664845,139.796643,2024-02-08 14:51:04
366,C1-80.浜松町262ビル,9,3,12,35.654289,139.75557,2024-02-08 14:51:04
367,B2-19.リエトコートアルクスタワー,2,7,9,35.670506,139.77854,2024-02-08 14:51:04
368,C1-79.髙松コンストラクショングループ 東京本社ビル,0,6,6,35.648765,139.753363,2024-02-08 14:51:04
369,C5-43.オアーゼ芝浦MJビル,8,0,8,35.644798,139.752697,2024-02-08 14:51:04
370,J1-44.五本木2丁目,1,7,8,35.634441,139.687186,2024-02-08 14:51:04
371,B2-17.アーバネックス八丁堀,3,0,3,35.67518,139.77364,2024-02-08 14:51:04
372,M6-16.パールマンション,2,0,2,35.67464,139.67876,2024-02-08 14:51:04
373,G4-06.ドムス・スタイル両国,1,6,7,35.700453,139.798978,2024-02-08 14:51:04
374,G2-04.ラ　ステュディオ押上,3,2,5,35.712157,139.815298,2024-02-08 14:51:04
375,T3-15.セブン-イレブン練馬北町8丁目店,6,0,6,35.768105,139.646049,2024-02-08 14:51:04
376,C1-77.芝公園,13,4,17,35.65513,139.749645,2024-02-08 14:51:04
377,I1-27.小関橋公園,0,4,4,35.620699,139.730904,2024-02-08 14:51:04
378,B3-01.中央区役所,6,0,6,35.670855,139.772052,2024-02-08 14:51:04
379,A6-08.二番町ガーデン,4,1,5,35.685489,139.734562,2024-02-08 14:51:04
380,B1-01.十思公園,0,9,9,35.691058,139.777915,2024-02-08 14:51:04
381,B4-02.月島特別出張所,0,36,36,35.662197,139.782719,2024-02-08 14:51:04
382,A4-05.大手町タワー,12,5,17,35.685938,139.764886,2024-02-08 14:51:04
383,H1-22.豊洲市場（7街区）,22,48,70,35.6447,139.784512,2024-02-08 14:51:04
384,A6-07.二番町センタービル,0,3,3,35.685966,139.736328,2024-02-08 14:51:04
385,A2-12.神保町三井ビルディング,10,0,10,35.694532,139.760695,2024-02-08 14:51:04
386,E2-06.oto no ha Cafe,0,4,4,35.713991,139.725665,2024-02-08 14:51:04
387,B4-10.リバーシティ,0,12,12,35.668795,139.784784,2024-02-08 14:51:04
388,B1-03.常盤公園（北側）,7,2,9,35.688405,139.770068,2024-02-08 14:51:04
389,C5-19.グランドメゾン田町,7,0,7,35.645537,139.754899,2024-02-08 14:51:04
390,K1-11.ファミリーマート かわだ多摩川２丁目店,0,5,5,35.558289,139.697403,2024-02-08 14:51:04
391,J1-43.アルコタワー・ホテル雅叙園東京,12,0,12,35.63237,139.712681,2024-02-08 14:51:04
392,N1-03.鷺宮南駐輪場,6,3,9,35.721827,139.635949,2024-02-08 14:51:04
393,N2-06.江古田1丁目B,3,3,6,35.72515,139.672614,2024-02-08 14:51:04
394,D7-12.プラウド高田馬場,4,1,5,35.715538,139.701683,2024-02-08 14:51:04
395,K1-118.久が原3丁目,0,9,9,35.580741,139.687152,2024-02-08 14:51:04
396,K1-125.池上駅南口第1,1,1,2,35.571866,139.703214,2024-02-08 14:51:04
397,K1-117.安詳寺,6,13,19,35.581798,139.695222,2024-02-08 14:51:04
398,I1-91.アクロス目黒タワー,7,2,9,35.634019,139.719749,2024-02-08 14:51:04
399,K1-126.池上駅南口第2,2,1,3,35.571815,139.702387,2024-02-08 14:51:04
400,C5-50.お台場レインボー公園,12,0,12,35.633133,139.777315,2024-02-08 14:51:04
401,T3-26.富士見ランド公園,0,8,8,35.73701,139.627244,2024-02-08 14:51:04
402,T1-15.つのの山緑地,4,0,4,35.765144,139.636606,2024-02-08 14:51:04
403,T1-16.ゆりの木通り南公園,3,1,4,35.767582,139.636304,2024-02-08 14:51:04
404,H1-185.UR大島六丁目団地(第二),1,4,5,35.690038,139.833252,2024-02-08 14:51:04
405,H1-186.セブン-イレブン亀戸昭和橋通り店,0,8,8,35.694804,139.831357,2024-02-08 14:51:04
406,K1-96.西馬込駅前自転車駐車場,9,5,14,35.586408,139.705425,2024-02-08 14:51:04
407,H1-184.UR大島六丁目団地(第一),2,2,4,35.689913,139.833279,2024-02-08 14:51:04
408,A6-25.麹町仮住宅,4,0,4,35.679192,139.74019,2024-02-08 14:51:04
409,C1-69.塩釜公園,0,10,10,35.662908,139.755014,2024-02-08 14:51:04
410,C1-68.桜田公園,26,2,28,35.665214,139.757008,2024-02-08 14:51:04
411,A2-14.興和一橋ビル,15,0,15,35.6927,139.759311,2024-02-08 14:51:04
412,C5-41.トヨタモビリティ東京 芝浦店,4,1,5,35.639644,139.745532,2024-02-08 14:51:04
413,T2-22.ファミリーマート 石神井台7丁目店,4,1,5,35.731909,139.579685,2024-02-08 14:51:04
414,A6-20.紀尾井町PREX,6,0,6,35.68369,139.736936,2024-02-08 14:51:04
415,C5-24.GLOBAL FRONT TOWER,0,16,16,35.647713,139.755534,2024-02-08 14:51:04
416,E5-09.文京区 男女平等センター,3,12,15,35.70861,139.75768,2024-02-08 14:51:04
417,K1-37.東京サーハウス前,18,2,20,35.563874,139.685011,2024-02-08 14:51:04
418,B4-15.リバーシティ　イーストタワーズ,0,15,15,35.669188,139.785301,2024-02-08 14:51:04
419,M6-08.Be Good 幡ヶ谷,2,7,9,35.682453,139.677687,2024-02-08 14:51:04
420,D5-09.ハウジングステージ新宿,7,6,13,35.702277,139.701214,2024-02-08 14:51:04
421,D6-21.新宿5丁目,4,3,7,35.691613,139.711233,2024-02-08 14:51:04
422,K1-39.東京モノレール 流通センター駅前,19,10,29,35.581752,139.748705,2024-02-08 14:51:04
423,K1-38.ネクストサイト蒲田ビル,9,0,9,35.558916,139.717253,2024-02-08 14:51:04
424,T3-17.練馬区役所東庁舎(第二),5,0,5,35.735585,139.652544,2024-02-08 14:51:04
425,H1-107.大島小松川公園,0,27,27,35.692641,139.846346,2024-02-08 14:51:04
426,B1-11.浜町川緑道,5,41,46,35.684158,139.787649,2024-02-08 14:51:04
427,A6-19.番町麹町ビルディング,11,1,12,35.685578,139.732078,2024-02-08 14:51:04
428,B3-12.築地場外市場,14,3,17,35.665254,139.769301,2024-02-08 14:51:04
429,I1-40.御殿山トラストタワー,26,0,26,35.622371,139.737457,2024-02-08 14:51:04
430,M5-08.古賀政男音楽博物館,2,0,2,35.668091,139.680243,2024-02-08 14:51:04
431,H1-90.富士倉庫運輸(株) FACE-1前,0,7,7,35.655102,139.805205,2024-02-08 14:51:04
432,A3-38.パークホームズ千代田淡路町,4,0,4,35.695163,139.769566,2024-02-08 14:51:04
433,D2-11.神楽坂アインスタワー,2,4,6,35.702833,139.739,2024-02-08 14:51:04
434,C2-04.飯倉いきいきプラザ,0,4,4,35.656991,139.740739,2024-02-08 14:51:04
435,B1-09.スマイルホテル日本橋三越前,18,0,18,35.686101,139.776089,2024-02-08 14:51:04
436,E5-15.文京千駄木の郷,7,4,11,35.726499,139.759884,2024-02-08 14:51:04
437,C2-05.ありすいきいきプラザ,8,2,10,35.651046,139.727745,2024-02-08 14:51:04
438,C5-06.品川シーズンテラス,19,0,19,35.632303,139.742393,2024-02-08 14:51:04
439,B1-10.箱崎川第二公園,7,0,7,35.680833,139.784267,2024-02-08 14:51:04
440,L1-15.ソフィア,0,3,3,35.663222,139.587803,2024-02-08 14:51:04
441,A3-12.秋葉原UDX北側駐輪場前,14,1,15,35.70111,139.772855,2024-02-08 14:51:04
442,A2-08.KDX御茶ノ水ビル,6,3,9,35.700568,139.76013,2024-02-08 14:51:04
443,A3-07.淡路公園,4,2,6,35.696942,139.767302,2024-02-08 14:51:04
444,A1-08.飯田橋サクラテラス（早稲田通り）,0,13,13,35.699132,139.74462,2024-02-08 14:51:04
445,A3-13.富士ソフトビル（駐車場入口横）,3,15,18,35.700486,139.774254,2024-02-08 14:51:04
446,A2-09.テラススクエア,8,0,8,35.6931,139.7599,2024-02-08 14:51:04
447,A6-11.東京ガーデンテラス紀尾井町,17,4,21,35.67962,139.7364,2024-02-08 14:51:04
448,K1-124.矢口2丁目,2,1,3,35.564161,139.695187,2024-02-08 14:51:04
449,N3-15.ライオンズマンション中野東,1,2,3,35.71046,139.6855,2024-02-08 14:51:04
450,M3-11.渋谷道玄坂東急ビル,9,0,9,35.65718,139.698687,2024-02-08 14:51:04
451,H1-180.シティコート大島,8,0,8,35.691954,139.836462,2024-02-08 14:51:04
452,B1-27.日本橋本町4丁目,25,3,28,35.68973,139.77598,2024-02-08 14:51:04
453,M3-22.森谷ビル,15,0,15,35.64514,139.71686,2024-02-08 14:51:04
454,N3-17.東中野3丁目,9,0,9,35.70862,139.680679,2024-02-08 14:51:04
455,N2-10.関根ビル,0,4,4,35.733432,139.671241,2024-02-08 14:51:04
456,T1-06.秋の陽公園,4,1,5,35.762326,139.635226,2024-02-08 14:51:04
457,N1-02.鷺宮東駐輪場,0,14,14,35.721556,139.640397,2024-02-08 14:51:04
458,K1-140.西馬込駅前自転車駐車場(奥),14,0,14,35.586382,139.705116,2024-02-08 14:51:04
459,H1-182.錦糸町プライムタワー,12,1,13,35.695695,139.820507,2024-02-08 14:51:04
460,E5-05.駒込地域活動センター,1,8,9,35.728644,139.752183,2024-02-08 14:51:04
461,M3-06.渋谷第一生命ビル,5,0,5,35.657556,139.704129,2024-02-08 14:51:04
462,T2-42.石神井公園駅北第二自転車駐車場,2,3,5,35.74553,139.608939,2024-02-08 14:51:04
463,K1-144.蒲田五丁目44番自転車駐車場,10,0,10,35.559809,139.716993,2024-02-08 14:51:04
464,M3-07.渋谷ファーストプレイス,10,0,10,35.65506,139.69384,2024-02-08 14:51:04
465,H1-74.タダノ教習センター,9,1,10,35.63848,139.832305,2024-02-08 14:51:04
466,H1-151.コスモリード錦糸町,0,9,9,35.701347,139.819973,2024-02-08 14:51:04
467,T2-23.セブン-イレブン 練馬南大泉5丁目店,6,0,6,35.750185,139.579216,2024-02-08 14:51:04
468,M4-13.J-cube,3,0,3,35.66616,139.70458,2024-02-08 14:51:04
469,T2-65.さくらの辻公園,1,4,5,35.734805,139.599906,2024-02-08 14:51:04
470,T2-24.セブン-イレブン 練馬インター店,0,24,24,35.754586,139.606409,2024-02-08 14:51:04
471,O5-05.モンテ・ベルテ,0,2,2,35.701454,139.650518,2024-02-08 14:51:04
472,J1-42.都立大学駅北口バス停前,3,6,9,35.618622,139.67596,2024-02-08 14:51:04
473,K1-97.トミンタワー多摩川二丁目,3,6,9,35.555561,139.704345,2024-02-08 14:51:04
474,D1-14.コモレ四谷,0,5,5,35.68752,139.72818,2024-02-08 14:51:04
475,K1-106.ファミリーマート上池台夫婦坂店,2,7,9,35.599329,139.703343,2024-02-08 14:51:04
476,J1-39.松見坂公園,0,8,8,35.655483,139.687325,2024-02-08 14:51:04
477,J1-40.西小山公園,6,2,8,35.616541,139.697369,2024-02-08 14:51:04
478,J1-38.林試の森公園 北,6,6,12,35.626355,139.700153,2024-02-08 14:51:04
479,I1-84.セブン-イレブン西品川2丁目店,0,0,0,35.613819,139.728418,2024-02-08 14:51:04
480,D6-26.セブン-イレブン新宿６丁目文化センター通り店,8,0,8,35.694951,139.708219,2024-02-08 14:51:04
481,T2-25.ファミリーマート 高野台二丁目店,0,5,5,35.746045,139.620087,2024-02-08 14:51:04
482,I1-85.GOODOFFICE品川,1,3,4,35.621081,139.741178,2024-02-08 14:51:04
483,K1-74.大田スタジアム,3,3,6,35.587423,139.753871,2024-02-08 14:51:04
484,C1-64.東京虎ノ門グローバルスクエア,3,2,5,35.669941,139.749261,2024-02-08 14:51:04
485,K1-72.ファミリーマート大森西四丁目店,0,6,6,35.573358,139.723105,2024-02-08 14:51:04
486,H1-118.ファミリーマート亀戸駅前店,6,4,10,35.69839,139.825484,2024-02-08 14:51:04
487,I1-62.天王洲Rim,0,6,6,35.622277,139.745638,2024-02-08 14:51:04
488,H1-40.深川東京モダン館,4,1,5,35.674076,139.795008,2024-02-08 14:51:04
489,H1-117.東京パークサイドビル,6,1,7,35.671225,139.808561,2024-02-08 14:51:04
490,J1-01.目黒区総合庁舎,8,1,9,35.640675,139.698088,2024-02-08 14:51:04
491,C5-16.品川インターシティ,22,1,23,35.626704,139.742174,2024-02-08 14:51:04
492,A1-12.北の丸スクエア,6,1,7,35.695515,139.750213,2024-02-08 14:51:04
493,H1-46.セブン-イレブン 江東枝川2丁目店,0,14,14,35.659287,139.807358,2024-02-08 14:51:04
494,A2-25.プラウド神田駿河台,11,2,13,35.698991,139.76091,2024-02-08 14:51:04
495,C5-49.プラウドタワー芝浦,0,12,12,35.638912,139.747422,2024-02-08 14:51:04
496,T3-25.北町みのり公園,1,3,4,35.767627,139.65243,2024-02-08 14:51:04
497,H1-75.ジオ深川住吉,2,7,9,35.684247,139.815638,2024-02-08 14:51:04
498,T1-09.ローソン練馬旭町一丁目店,4,1,5,35.765704,139.625178,2024-02-08 14:51:04
499,T2-26.ファミリーマート 大泉学園町四丁目店,0,7,7,35.767388,139.587625,2024-02-08 14:51:04
500,T2-27.ファミリーマート 大泉長久保通り店,2,3,5,35.773841,139.591456,2024-02-08 14:51:04
501,C3-19.明治記念館西,2,2,4,35.678179,139.720809,2024-02-08 14:51:04
502,I1-11.鮫洲入江広場,12,0,12,35.603984,139.744504,2024-02-08 14:51:04
503,I1-10.品川シーサイド公園第1,14,4,18,35.607717,139.749478,2024-02-08 14:51:04
504,I1-09.東品川海上公園第1,0,10,10,35.616633,139.748945,2024-02-08 14:51:04
505,D3-06.セブン-イレブン高田馬場3丁目中央店,0,7,7,35.713872,139.698301,2024-02-08 14:51:04
506,K1-40.大田文化の森,0,16,16,35.579649,139.720263,2024-02-08 14:51:04
507,C1-41.港区立エコプラザ,7,2,9,35.658709,139.757036,2024-02-08 14:51:04
508,I1-13.八潮北公園,0,11,11,35.613421,139.75375,2024-02-08 14:51:04
509,I1-12.しながわ区民公園（北側）,2,1,3,35.596091,139.740884,2024-02-08 14:51:04
510,T2-09.こぐれの森緑地,4,6,10,35.763741,139.588847,2024-02-08 14:51:04
511,T3-31.パークサイド関口,3,5,8,35.74097,139.63836,2024-02-08 14:51:04
512,H1-183.MFLP新木場1,0,4,4,35.643958,139.838358,2024-02-08 14:51:04
513,T2-33.ウインドヒルズ189,2,4,6,35.74642,139.581204,2024-02-08 14:51:04
514,T2-67.陽和病院,0,7,7,35.761211,139.603316,2024-02-08 14:51:04
515,H1-82.セブンｰイレブン 北砂3丁目明治通り店,0,21,21,35.683514,139.827081,2024-02-08 14:51:04
516,T2-60.武蔵関公園（第一）,9,0,9,35.724747,139.565817,2024-02-08 14:51:04
517,I1-48.NTT 東日本 関東病院(北側),6,3,9,35.632191,139.725002,2024-02-08 14:51:04
518,T2-58.立野公園,3,2,5,35.716776,139.577975,2024-02-08 14:51:04
519,I1-100.東急荏原中延駅駐輪場,5,2,7,35.610444,139.712333,2024-02-08 14:51:04
520,T2-56.大泉公園（第一）,2,2,4,35.77228,139.58325,2024-02-08 14:51:04
521,T2-55.大泉町もみじやま公園,2,1,3,35.767296,139.602321,2024-02-08 14:51:04
522,T2-54.土支田農業公園,1,8,9,35.760939,139.609264,2024-02-08 14:51:04
523,I1-44.大井三ツ又商店街入口,7,0,7,35.604606,139.734483,2024-02-08 14:51:04
524,T2-62.大泉井頭公園,6,4,10,35.746681,139.57754,2024-02-08 14:51:04
525,T2-61.武蔵関公園（第二）,4,0,4,35.727826,139.570056,2024-02-08 14:51:04
526,T3-09.学田公園,4,1,5,35.730428,139.648704,2024-02-08 14:51:04
527,K1-105.東糀谷二丁目児童公園,0,7,7,35.555702,139.740802,2024-02-08 14:51:04
528,T3-04.サンパレス平和台,8,4,12,35.759827,139.659121,2024-02-08 14:51:04
529,K1-104.六郷BASE,1,5,6,35.543573,139.714393,2024-02-08 14:51:04
530,M4-16.神宮前6丁目,2,1,3,35.668673,139.702816,2024-02-08 14:51:04
531,K1-69.京急平和島第2Bバイク駐輪場,1,3,4,35.585747,139.735242,2024-02-08 14:51:04
532,H1-155.メブクス豊洲,0,22,22,35.645726,139.784496,2024-02-08 14:51:04
533,C2-11.一の橋,12,40,52,35.654726,139.737491,2024-02-08 14:51:04
534,C4-11.ザ・パークハウス 三田ガーデン,3,9,12,35.64816,139.737991,2024-02-08 14:51:04
535,H1-161.昭文社制作本部ビル,4,2,6,35.684003,139.794983,2024-02-08 14:51:04
536,N2-07.新井区民活動センター,1,4,5,35.714292,139.663327,2024-02-08 14:51:04
537,K1-87.羽田イノベーションシティ,2,8,10,35.547061,139.756277,2024-02-08 14:51:04
538,N3-16.COURT 5,5,0,5,35.699743,139.664608,2024-02-08 14:51:04
539,C4-01.高輪地区総合支所(5F),2,7,9,35.641833,139.734519,2024-02-08 14:51:04
540,C5-48.セブンイレブン港区海岸三丁目店,3,4,7,35.636808,139.752517,2024-02-08 14:51:04
541,H1-42.江東区スポーツ会館,0,27,27,35.683961,139.821559,2024-02-08 14:51:04
542,B2-10.東京ダイヤビルディング（北側）,0,10,10,35.675702,139.785229,2024-02-08 14:51:04
543,H1-43.東京イースト21,0,15,15,35.675639,139.815255,2024-02-08 14:51:04
544,B3-20.歌舞伎座タワー駐輪場2F,6,1,7,35.670106,139.768041,2024-02-08 14:51:04
545,B3-21.歌舞伎座タワー駐輪場3F,10,0,10,35.6701,139.76801,2024-02-08 14:51:04
546,K1-139.プラットホステル京急 羽田ホーム,8,2,10,35.548104,139.748889,2024-02-08 14:51:04
547,J1-58.目黒女子会館前,3,1,4,35.629011,139.69716,2024-02-08 14:51:04
548,T2-18.ファミリーマート練馬西税務署前店,3,1,4,35.745505,139.580878,2024-02-08 14:51:04
549,C3-23.LIFORK 南青山 北エントランス,14,15,29,35.669916,139.725701,2024-02-08 14:51:04
550,C1-46.新虎通りCORE,16,1,17,35.665124,139.754054,2024-02-08 14:51:04
551,C1-45.浜松町クレアタワー,14,2,16,35.656324,139.755927,2024-02-08 14:51:04
552,K1-53.セブン-イレブン 田園調布郵便局前店,15,5,20,35.589309,139.678587,2024-02-08 14:51:04
553,K1-52.大田区総合体育館,7,0,7,35.564152,139.727422,2024-02-08 14:51:04
554,T1-12.ファミリーマート 高松六丁目店,4,0,4,35.756873,139.616612,2024-02-08 14:51:04
555,D7-07.ローソン 新宿西落合三丁目店,0,5,5,35.725171,139.675897,2024-02-08 14:51:04
556,A6-16.一番町第二TGビル,3,2,5,35.688351,139.744321,2024-02-08 14:51:04
557,C3-33.PASONA SQUARE,12,0,12,35.667462,139.716058,2024-02-08 14:51:04
558,A3-24.岩本町ほほえみプラザ,0,10,10,35.69441,139.777715,2024-02-08 14:51:04
559,H1-35.ヒューリック豊洲プライムスクエア,5,1,6,35.652376,139.797724,2024-02-08 14:51:04
560,C5-11.フェイバリッチタワー品川,0,48,48,35.631729,139.749767,2024-02-08 14:51:04
561,E2-13.デルックス文京神楽坂,2,1,3,35.70781,139.732227,2024-02-08 14:51:04
562,C5-01.こうなん星の公園,31,16,47,35.629697,139.742167,2024-02-08 14:51:04
563,C5-02.港南緑水公園,0,75,75,35.628955,139.750731,2024-02-08 14:51:04
564,A3-22.龍閑児童公園,1,6,7,35.693234,139.779702,2024-02-08 14:51:04
565,A3-21.神田ふれあい通り第３,8,4,12,35.695176,139.772832,2024-02-08 14:51:04
566,H1-30.江東区役所（北側）,6,6,12,35.67338,139.8164,2024-02-08 14:51:04
567,C1-17.港区役所,4,0,4,35.657866,139.751068,2024-02-08 14:51:04
568,H1-31.江東区役所（南側）,12,4,16,35.67214,139.8166,2024-02-08 14:51:04
569,C1-09.愛宕グリーンヒルズ,7,1,8,35.662051,139.748132,2024-02-08 14:51:04
570,D1-02.四谷特別出張所（新宿御苑大木戸門前）,15,2,17,35.687435,139.714169,2024-02-08 14:51:04
571,D1-01.花園西公園,5,0,5,35.690612,139.711631,2024-02-08 14:51:04
572,C1-04.虎ノ門ヒルズ,11,3,14,35.666527,139.748804,2024-02-08 14:51:04
573,C1-05.西新橋2丁目（新虎通り）,14,0,14,35.665593,139.752617,2024-02-08 14:51:04
574,C1-73.日比谷フォートタワー,14,0,14,35.669871,139.753147,2024-02-08 14:51:04
575,K1-102.上池台四丁目公園,0,7,7,35.595119,139.6996,2024-02-08 14:51:04
576,M2-01.恵比寿保健相談所（恵比寿社会教育館）,0,13,13,35.64524,139.71946,2024-02-08 14:51:04
577,I1-98.コーポ荏原,0,5,5,35.60411,139.709784,2024-02-08 14:51:04
578,C3-17.セブン-イレブン 港区溜池山王店,2,16,18,35.670308,139.743242,2024-02-08 14:51:04
579,T2-11.石神井松の風文化公園,2,0,2,35.739471,139.595578,2024-02-08 14:51:04
580,M2-03.サイカパーク恵比寿,13,1,14,35.646581,139.710613,2024-02-08 14:51:04
581,M2-02.アメリカ橋公園,8,0,8,35.643606,139.713099,2024-02-08 14:51:04
582,T2-50.North Ridge 吉祥寺,6,3,9,35.72305,139.579555,2024-02-08 14:51:04
583,J1-35.目黒川田道街かど公園,6,0,6,35.634574,139.710332,2024-02-08 14:51:04
584,H1-174.ジュネス(エントランス側),0,1,1,35.682712,139.823961,2024-02-08 14:51:04
585,M6-17.笹塚一丁目駐輪場,1,6,7,35.672922,139.668729,2024-02-08 14:51:04
586,C4-14.神応ほっとプラザ,4,6,10,35.643711,139.724753,2024-02-08 14:51:04
587,K1-107.馬込駅A2出口,4,6,10,35.596854,139.712139,2024-02-08 14:51:04
588,T3-11.ガラクタ公園,1,2,3,35.740321,139.631256,2024-02-08 14:51:04
589,T2-80.みその緑地,2,3,5,35.756825,139.590528,2024-02-08 14:51:04
590,T3-24.AZEST新桜台,5,2,7,35.743962,139.670315,2024-02-08 14:51:04
591,D4-07.新宿余丁町ビル,0,8,8,35.698512,139.716482,2024-02-08 14:51:04
592,T3-01.練馬春日町駅自転車駐車場,6,1,7,35.751438,139.641265,2024-02-08 14:51:04
593,H1-89.BUDDY スポーツアリーナ,4,10,14,35.637041,139.781088,2024-02-08 14:51:04
594,E5-14.上野広小路駅（湯島側）,1,11,12,35.707313,139.771857,2024-02-08 14:51:04
595,H1-109.Brillia ist 東雲キャナルコート東側,0,42,42,35.648008,139.803487,2024-02-08 14:51:04
596,H1-108.Brillia ist 東雲キャナルコート北側,0,16,16,35.648431,139.803125,2024-02-08 14:51:04
597,C1-53.ホテルリブマックス新橋,4,0,4,35.661149,139.754612,2024-02-08 14:51:04
598,D7-10.染の里 おちあい,1,5,6,35.715211,139.689788,2024-02-08 14:51:04
599,A1-15.富士見みらい館,0,2,2,35.697167,139.745629,2024-02-08 14:51:04
600,E4-15.千石4丁目,2,3,5,35.729153,139.741368,2024-02-08 14:51:04
601,H1-111.ファミリーマート木場六丁目店,0,1,1,35.66688,139.80779,2024-02-08 14:51:04
602,C5-36.お台場海浜公園駅,3,0,3,35.62974,139.778178,2024-02-08 14:51:04
603,H1-10.出会い橋,15,0,15,35.625029,139.777344,2024-02-08 14:51:04
604,H1-11.テレコムセンター駅,6,15,21,35.61813,139.778698,2024-02-08 14:51:04
605,H1-47.トピレックプラザ,0,30,30,35.672481,139.835877,2024-02-08 14:51:04
606,H1-13.アーバンドック ららぽーと豊洲,17,2,19,35.654067,139.792376,2024-02-08 14:51:04
607,T2-66.大泉学園町希望ヶ丘公園,0,4,4,35.778605,139.588883,2024-02-08 14:51:04
608,C5-37.台場駅,0,25,25,35.626388,139.772453,2024-02-08 14:51:04
609,H1-16.豊洲三丁目公園,18,0,18,35.657477,139.796629,2024-02-08 14:51:04
610,H1-17.東雲水辺公園,0,54,54,35.64704,139.80469,2024-02-08 14:51:04
611,C1-72.新田町ビル,6,5,11,35.646307,139.746428,2024-02-08 14:51:04
612,K1-98.鵜の木松山公園,2,5,7,35.577433,139.680752,2024-02-08 14:51:04
613,C1-71.芝商業高校前交差点,0,5,5,35.65583,139.759896,2024-02-08 14:51:04
614,H1-122.東砂スポーツセンター,0,11,11,35.679167,139.839746,2024-02-08 14:51:04
615,O6-05.コージーコート久我山,0,5,5,35.687531,139.60439,2024-02-08 14:51:04
616,T2-39.ローソン 練馬大泉町五丁目店,5,3,8,35.758929,139.597548,2024-02-08 14:51:04
617,J1-50.大岡山公園,2,1,3,35.609958,139.684087,2024-02-08 14:51:04
618,J1-51.池尻大橋駅東口駐輪場,0,5,5,35.650627,139.687228,2024-02-08 14:51:04
619,K1-99.東原くすのき公園,6,2,8,35.584086,139.67898,2024-02-08 14:51:04
620,N3-12.桃園区民活動センター,2,1,3,35.702414,139.667327,2024-02-08 14:51:04
621,H1-191.三井リンクラボ新木場2,13,1,14,35.644863,139.831107,2024-02-08 14:51:04
622,M5-09.代々木上原駅前,5,0,5,35.66865,139.679251,2024-02-08 14:51:04
623,O3-09.NTT井草ビル第3ポート,4,3,7,35.714151,139.61693,2024-02-08 14:51:04
624,T1-07.土支田一丁目（笹目通り）,1,9,10,35.765913,139.619285,2024-02-08 14:51:04
625,K1-22.矢口特別出張所,3,2,5,35.562324,139.690486,2024-02-08 14:51:04
626,T3-08.中新井川児童遊園,2,5,7,35.728268,139.649188,2024-02-08 14:51:04
627,H1-78.ローソン新木場一丁目店,13,1,14,35.645604,139.834941,2024-02-08 14:51:04
628,A6-13.番町会館,5,1,6,35.689131,139.733071,2024-02-08 14:51:04
629,H1-71.セブン-イレブン 江東東陽4丁目,0,6,6,35.670906,139.819386,2024-02-08 14:51:04
630,D2-09.セブン-イレブン 新宿岩戸町店,3,0,3,35.700993,139.736355,2024-02-08 14:51:04
631,I1-08.天王洲アイル第一水辺広場,21,10,31,35.622294,139.751644,2024-02-08 14:51:04
632,I1-07.しながわ水族館,6,10,16,35.590641,139.736354,2024-02-08 14:51:04
633,D3-09.西早稲田3丁目,2,2,4,35.712545,139.713319,2024-02-08 14:51:04
634,E1-16.小石川3丁目緑地,4,17,21,35.714338,139.746346,2024-02-08 14:51:04
635,C5-28.芝浦ルネサイトタワー,6,0,6,35.643683,139.7506,2024-02-08 14:51:04
636,I1-59.文庫の森第一,13,5,18,35.612357,139.721484,2024-02-08 14:51:04
637,I1-60.文庫の森第二,0,4,4,35.611368,139.720424,2024-02-08 14:51:04
638,C1-38.KDX西新橋ビル（西側）,2,2,4,35.66495,139.750459,2024-02-08 14:51:04
639,C1-37.KDX西新橋ビル（北側）,4,1,5,35.665218,139.750827,2024-02-08 14:51:04
640,T2-14.NPC24H東大泉第6パーキング,0,6,6,35.747807,139.593599,2024-02-08 14:51:04
641,C3-12.赤坂センタービルディング前（青山通り）,4,4,8,35.676732,139.733905,2024-02-08 14:51:04
642,H1-36.フジゴルフセンター,0,19,19,35.66605,139.806699,2024-02-08 14:51:04
643,C1-27.虎ノ門2丁目タワー,14,0,14,35.668547,139.747175,2024-02-08 14:51:04
644,C5-12.第2東運ビル,7,0,7,35.633742,139.748281,2024-02-08 14:51:04
645,D6-08.新宿イーストサイドスクエア,6,1,7,35.697158,139.707887,2024-02-08 14:51:04
646,A4-08.永代通り（大手町駅B2c出口前）,24,0,24,35.684349,139.766958,2024-02-08 14:51:04
647,H1-37.東雲駅（東京湾岸道路）,30,5,35,35.640618,139.802455,2024-02-08 14:51:04
648,C3-11.赤坂見附南,0,1,1,35.676566,139.737083,2024-02-08 14:51:04
649,M6-04.本町東べんてん橋公園,0,16,16,35.687126,139.680702,2024-02-08 14:51:04
650,I1-79.品川浦第二,12,2,14,35.621904,139.741429,2024-02-08 14:51:04
651,K1-81.コーナン本羽田萩中店,10,3,13,35.549568,139.731093,2024-02-08 14:51:04
652,D6-25.新宿駅東南口自転車駐輪場,29,3,32,35.689755,139.701323,2024-02-08 14:51:04
653,I1-78.セブン-イレブン西大井店,6,4,10,35.601431,139.718659,2024-02-08 14:51:04
654,H1-136.東砂一丁目公園,1,16,17,35.683542,139.839763,2024-02-08 14:51:04
655,A6-23.セブン-イレブン 千代田三番町店,0,13,13,35.689466,139.745316,2024-02-08 14:51:04
656,C5-34.五色橋ビル,0,13,13,35.636644,139.751798,2024-02-08 14:51:04
657,K1-41.郷土博物館,0,12,12,35.588644,139.710413,2024-02-08 14:51:04
658,G2-06.ディアレイシャス押上スカイヴィレッジ,0,5,5,35.71408,139.810588,2024-02-08 14:51:04
659,O3-11.ハイリビング関根,5,3,8,35.707877,139.618926,2024-02-08 14:51:04
660,O7-02.永福中央公園,6,0,6,35.67121,139.64145,2024-02-08 14:51:04
661,K1-29.萩中文化センター,5,4,9,35.55017,139.728146,2024-02-08 14:51:04
662,K1-30.テクノFRONT森ケ崎,2,2,4,35.567922,139.746181,2024-02-08 14:51:04
663,K1-130.COCOONひろば平和島,17,0,17,35.578728,139.735238,2024-02-08 14:51:04
664,H1-81.豊洲IHIビル（北側）,19,1,20,35.659829,139.793243,2024-02-08 14:51:04
665,E4-03.昭和小学校北側（不忍通り）,25,8,33,35.73166,139.748625,2024-02-08 14:51:04
666,C2-12.六本木ファーストビル,15,0,15,35.66249,139.741397,2024-02-08 14:51:04
667,D3-16.セジョリ江戸川橋,5,9,14,35.708734,139.730509,2024-02-08 14:51:04
668,A5-04.日比谷パークフロント前　日比谷公園南面向い歩道上,5,3,8,35.671514,139.753952,2024-02-08 14:51:04
669,C3-22.OMO3東京赤坂 by 星野リゾート,8,0,8,35.674929,139.736053,2024-02-08 14:51:04
670,B1-20.竜閑さくら橋際街角広場,0,17,17,35.688301,139.768958,2024-02-08 14:51:04
671,H1-83.ローソン江東東雲店,3,10,13,35.642165,139.800439,2024-02-08 14:51:04
672,H1-84.NTT東日本辰巳ビル,0,21,21,35.647091,139.817333,2024-02-08 14:51:04
673,C5-26.ピアシティ芝浦ビル,10,4,14,35.644155,139.756216,2024-02-08 14:51:04
674,T3-28.ほしぞら緑地,0,3,3,35.755137,139.661208,2024-02-08 14:51:04
675,I1-88.セブン-イレブン品川南大井3丁目店,1,0,1,35.58768,139.734515,2024-02-08 14:51:04
676,I1-87.セブン-イレブン西大井滝王子通り店,0,6,6,35.599774,139.723467,2024-02-08 14:51:04
677,G4-11.ホテルマイステイズ浅草,19,3,22,35.703972,139.797327,2024-02-08 14:51:04
678,C5-30.フェイム芝浦インターウェーブ,1,8,9,35.647872,139.75391,2024-02-08 14:51:04
679,M6-13.JICA東京,9,3,12,35.673409,139.675203,2024-02-08 14:51:04
680,A4-13.アーバンネット大手町ビル,5,0,5,35.68557,139.766929,2024-02-08 14:51:04
681,B4-27.リバーシティ西ブロック,10,8,18,35.670491,139.784447,2024-02-08 14:51:04
682,K1-143.大森北1丁目,60,0,60,35.584914,139.730504,2024-02-08 14:51:04
683,E5-24.本郷6丁目,3,2,5,35.712445,139.758157,2024-02-08 14:51:04
684,D2-17.genten市ヶ谷店,10,0,10,35.690657,139.73255,2024-02-08 14:51:04
685,A4-14.東京国際フォーラム（有楽町駅ガード側）,7,0,7,35.675739,139.763712,2024-02-08 14:51:04
686,A2-27.丸紅ビル,5,1,6,35.690958,139.759876,2024-02-08 14:51:04
687,K1-135.北千束2丁目,4,2,6,35.608633,139.693653,2024-02-08 14:51:04
688,A1-19.九段会館テラス,4,0,4,35.694065,139.751801,2024-02-08 14:51:04
689,K1-136.BIG FUN 平和島,1,8,9,35.585489,139.740194,2024-02-08 14:51:04
690,K1-137.京浜島つばさ公園,0,16,16,35.571578,139.770532,2024-02-08 14:51:04
691,D1-16.ルネ新宿御苑タワー,6,2,8,35.690155,139.713377,2024-02-08 14:51:04
692,G6-01.オーキッドレジデンス森下,4,0,4,35.692547,139.799231,2024-02-08 14:51:04
693,T2-63.三原台公園,1,6,7,35.751471,139.599835,2024-02-08 14:51:04
694,O4-01.阿佐ヶ谷南公園,1,1,2,35.70328,139.62981,2024-02-08 14:51:04
695,B4-11.ダンスキューブ勝どき,0,16,16,35.656565,139.775073,2024-02-08 14:51:04
696,D1-06.四谷第六小学校北,10,0,10,35.681754,139.715256,2024-02-08 14:51:04
697,T2-64.高野台中央公園,1,2,3,35.746768,139.613885,2024-02-08 14:51:04
698,H1-169.セブンイレブン江東亀戸7丁目東店,0,10,10,35.697157,139.839835,2024-02-08 14:51:04
699,H1-170.セブンイレブン江東亀戸7丁目南店,0,30,30,35.695937,139.838017,2024-02-08 14:51:04
700,B2-16.ホテルサードニクス東京,3,2,5,35.67684,139.77876,2024-02-08 14:51:04
701,I1-93.中央海浜公園前交差点（南側）,5,0,5,35.595498,139.750654,2024-02-08 14:51:04
702,I1-92.中央海浜公園前交差点（北側）,10,0,10,35.595873,139.75134,2024-02-08 14:51:04
703,B1-26.Dash Living Nihonbashi,5,1,6,35.68802,139.78112,2024-02-08 14:51:04
704,H1-158.東京国際交流館,12,0,12,35.621845,139.776833,2024-02-08 14:51:04
705,J1-32.緑が丘駅前高架下,7,0,7,35.606793,139.678372,2024-02-08 14:51:04
706,K1-90.ファミリーマート大田仲池上一丁目店,1,5,6,35.5873,139.701644,2024-02-08 14:51:04
707,K1-91.穴守稲荷神社,3,7,10,35.550027,139.74973,2024-02-08 14:51:04
708,C1-67.京阪神 虎ノ門ビル,18,3,21,35.669228,139.751668,2024-02-08 14:51:04
709,K1-89.ファミリーマート大田千鳥三丁目店,3,2,5,35.572086,139.68708,2024-02-08 14:51:04
710,I1-97.トミンハイム東品川三丁目第二,15,3,18,35.613387,139.749307,2024-02-08 14:51:04
711,T2-51.練馬区役所石神井庁舎,8,2,10,35.743772,139.603317,2024-02-08 14:51:04
712,T2-75.石神井台二丁目緑地,3,0,3,35.734684,139.593628,2024-02-08 14:51:04
713,E5-19.千駄木公園,1,6,7,35.728333,139.757629,2024-02-08 14:51:04
714,E5-18.団子坂上広場,0,11,11,35.724921,139.75903,2024-02-08 14:51:04
715,A5-07.富国生命ビル,3,2,5,35.670452,139.75557,2024-02-08 14:51:04
716,H1-156.つどい橋下,0,9,9,35.630791,139.787396,2024-02-08 14:51:04
717,H1-159.夢の大橋西,15,1,16,35.627599,139.782953,2024-02-08 14:51:04
718,H1-143.ダイバーシティ東京 プラザ,8,2,10,35.624619,139.776006,2024-02-08 14:51:04
719,I1-57.大井水神公園,72,0,72,35.589972,139.729368,2024-02-08 14:51:04
720,B2-15.KABUTO ONE,3,2,5,35.68168,139.77825,2024-02-08 14:51:04
721,K1-64.多摩川グリーンスクエア,0,12,12,35.545459,139.719489,2024-02-08 14:51:04
722,T2-57.大泉公園（第二）,5,1,6,35.771708,139.583551,2024-02-08 14:51:04
723,A4-06.大手町ファーストスクエア,9,1,10,35.686037,139.764472,2024-02-08 14:51:04
724,C1-50.NTT虎ノ門ビル,11,3,14,35.666075,139.748008,2024-02-08 14:51:04
725,C1-23.三田いきいきプラザ,9,0,9,35.648637,139.749834,2024-02-08 14:51:04
726,H1-29.スカイズタワー＆ガーデン,0,63,63,35.647618,139.792152,2024-02-08 14:51:04
727,C1-21.汐留ビルディング,7,3,10,35.657363,139.75918,2024-02-08 14:51:04
728,A3-16.地蔵橋東児童遊園,2,4,6,35.691069,139.775376,2024-02-08 14:51:04
729,A3-18.美倉橋北児童遊園,0,11,11,35.69703,139.779928,2024-02-08 14:51:04
730,A4-01.丸ビル（南側駐輪場）,12,0,12,35.680514,139.764002,2024-02-08 14:51:04
731,A3-11.練成公園,0,8,8,35.703735,139.770629,2024-02-08 14:51:04
732,A3-10.芳林公園（北側）,0,8,8,35.701978,139.7698,2024-02-08 14:51:04
733,A6-02.いきいきプラザ一番町（西側駐輪場）,4,3,7,35.687031,139.739327,2024-02-08 14:51:04
734,A6-01.東郷元帥記念公園（南側）,2,0,2,35.689879,139.740178,2024-02-08 14:51:04
735,A5-03.参議院第二別館（永田町駅2番出口）,11,5,16,35.677763,139.74271,2024-02-08 14:51:04
736,A4-03.東京国際フォーラム（メトロD5出口）,8,0,8,35.675843,139.763329,2024-02-08 14:51:04
737,K1-15.セブン‐イレブン 大田区西蒲田店,3,0,3,35.56694,139.716331,2024-02-08 14:51:04
738,K1-49.ローソン仲池上一丁目店,0,8,8,35.586585,139.698552,2024-02-08 14:51:04
739,A2-06.東光電気工事 別館（屋内駐輪場）,7,0,7,35.69919,139.75701,2024-02-08 14:51:04
740,M4-01.新宿タカシマヤ,4,2,6,35.68714,139.702775,2024-02-08 14:51:04
741,M4-03.NTTドコモ代々木ビル,6,4,10,35.684451,139.702884,2024-02-08 14:51:04
742,M3-03.代官山 T-SITE,6,2,8,35.649823,139.700139,2024-02-08 14:51:04
743,K1-14.大森地域庁舎,6,3,9,35.578239,139.723262,2024-02-08 14:51:04
744,C5-46.ウエリスアーバン品川タワー,0,12,12,35.630961,139.746875,2024-02-08 14:51:04
745,C4-13.コシダコネクトビル,0,15,15,35.637765,139.739128,2024-02-08 14:51:04
746,K1-127.第二石井ビル,4,1,5,35.559286,139.722611,2024-02-08 14:51:04
747,C1-74.札の辻スクエア,7,1,8,35.645155,139.744543,2024-02-08 14:51:04
748,H1-164.森下三丁目第三児童遊園,1,18,19,35.68546,139.80244,2024-02-08 14:51:04
749,C1-78.CIRCLES新橋,9,0,9,35.66646,139.752138,2024-02-08 14:51:04
750,C3-34.3rd MINAMI AOYAMA,5,1,6,35.668622,139.715957,2024-02-08 14:51:04
751,O4-06.杉並区役所本庁舎,3,2,5,35.699328,139.636343,2024-02-08 14:51:04
752,D3-14.コーシャハイム高田馬場,6,0,6,35.712413,139.70168,2024-02-08 14:51:04
753,D7-11.新宿清掃事務所,2,4,6,35.716359,139.704377,2024-02-08 14:51:04
754,D5-08.ウエリス新宿早稲田の森,0,8,8,35.704597,139.708397,2024-02-08 14:51:04
755,E2-12.水道2丁目,0,20,20,35.709147,139.739183,2024-02-08 14:51:04
756,M6-10.京王コインパーク幡ヶ谷,0,11,11,35.6772,139.678117,2024-02-08 14:51:04
757,E3-05.文京スポーツセンター,50,10,60,35.721045,139.735687,2024-02-08 14:51:04
758,J1-36.WJ Haus,0,6,6,35.629067,139.711779,2024-02-08 14:51:04
759,K1-51.テクノポートカマタ 第2,11,0,11,35.555808,139.722791,2024-02-08 14:51:04
760,D1-13.新宿御苑新宿門【西側】,0,22,22,35.688945,139.706536,2024-02-08 14:51:04
761,I1-31.セブン-イレブン 品川戸越5丁目店,3,3,6,35.608193,139.719139,2024-02-08 14:51:04
762,T3-27.貫井川緑地,1,3,4,35.738427,139.632251,2024-02-08 14:51:04
763,H1-147.大島四丁目団地,15,1,16,35.68744,139.827075,2024-02-08 14:51:04
764,O4-02.成宗さくら公園,2,0,2,35.69638,139.63482,2024-02-08 14:51:04
765,O1-01.上瀬戸公園,2,2,4,35.72077,139.6045,2024-02-08 14:51:04
766,T2-15.NPC24H大泉学園南口パーキング,8,2,10,35.748611,139.584251,2024-02-08 14:51:04
767,O3-03.桃井1丁目5番地,7,0,7,35.71013,139.61194,2024-02-08 14:51:04
768,H1-08.東京テレポート駅,0,50,50,35.627087,139.779779,2024-02-08 14:51:04
769,H1-05.相鉄グランドフレッサ 東京ベイ有明,13,1,14,35.632148,139.79017,2024-02-08 14:51:04
770,H1-06.武蔵野大学,0,15,15,35.630185,139.786618,2024-02-08 14:51:04
771,A4-15.TOKIWAブリッジ,5,4,9,35.686389,139.769237,2024-02-08 14:51:04
772,H1-160.花の広場,9,8,17,35.633908,139.793322,2024-02-08 14:51:04
773,H1-01.豊洲ＩＨＩビル前（晴海通り）,8,2,10,35.658911,139.792531,2024-02-08 14:51:04
774,H1-02.豊洲駅,10,6,16,35.654196,139.79626,2024-02-08 14:51:04
775,J1-19.NTT東日本自由が丘ビル,3,1,4,35.615098,139.675954,2024-02-08 14:51:04
776,C2-19.広尾駅,4,0,4,35.650732,139.72256,2024-02-08 14:51:04
777,H1-114.東京夢の島マリーナ,5,9,14,35.651987,139.830691,2024-02-08 14:51:04
778,K1-71.ファミリーマート大田大森南店,0,5,5,35.562769,139.74327,2024-02-08 14:51:04
779,J1-20.すずめのお宿緑地公園,2,7,9,35.617773,139.685351,2024-02-08 14:51:04
780,H1-115.東京夢の島マリーナ 第4駐車場,2,12,14,35.650235,139.835993,2024-02-08 14:51:04
781,M5-10.富ヶ谷2丁目,16,1,17,35.665961,139.686491,2024-02-08 14:51:04
782,J1-21.中央緑地公園,0,6,6,35.630694,139.690482,2024-02-08 14:51:04
783,H1-116.出会い橋高架下,27,22,49,35.625037,139.777646,2024-02-08 14:51:04
784,M3-12.渋谷南東急ビル,6,0,6,35.656228,139.706284,2024-02-08 14:51:04
785,T2-01.大泉学園駅北口,3,2,5,35.749918,139.58618,2024-02-08 14:51:04
786,K1-06.大森駅入新井自転車駐車場,5,0,5,35.585269,139.726279,2024-02-08 14:51:04
787,D6-06.新宿中央公園（エコギャラリー下）,0,16,16,35.691199,139.687966,2024-02-08 14:51:04
788,D6-14.新宿ファーストウエスト,12,1,13,35.689529,139.695995,2024-02-08 14:51:04
789,D6-15.住友不動産西新宿ビル,9,1,10,35.69465,139.695911,2024-02-08 14:51:04
790,H1-56.南砂三丁目緑地公園西,0,27,27,35.672361,139.829825,2024-02-08 14:51:04
791,T2-74.扇橋公園,2,3,5,35.731791,139.588844,2024-02-08 14:51:04
792,B2-20.SHビル,3,0,3,35.675398,139.779962,2024-02-08 14:51:04
793,I1-17.東品川海上公園第2,0,16,16,35.616364,139.749171,2024-02-08 14:51:04
794,I1-16.品川浦,14,0,14,35.6214,139.741958,2024-02-08 14:51:04
795,A4-11.二重橋前駅(メトロ4番出口),5,0,5,35.680753,139.762069,2024-02-08 14:51:04
796,H1-76.有明物流センター,4,12,16,35.638571,139.78829,2024-02-08 14:51:04
797,K1-43.北馬込わくわく公園,0,13,13,35.600707,139.703216,2024-02-08 14:51:04
798,K1-42.馬込西公園,11,3,14,35.58849,139.70376,2024-02-08 14:51:04
799,T1-08.セブン-イレブン 練馬高松6丁目店,4,0,4,35.756506,139.620347,2024-02-08 14:51:04
800,T2-17.ファミリーマート 練馬石神井町八丁目店,0,4,4,35.74755,139.597968,2024-02-08 14:51:04
801,K1-31.テクノWING,0,10,10,35.546252,139.731708,2024-02-08 14:51:04
802,K1-32.石川町文化センター,5,0,5,35.601958,139.682876,2024-02-08 14:51:04
803,I1-20.しおじ公園,13,7,20,35.59632,139.751279,2024-02-08 14:51:04
804,I1-19.品川シーサイド公園第2,7,0,7,35.607571,139.749108,2024-02-08 14:51:04
805,J1-29.カスタリア目黒鷹番,2,3,5,35.626121,139.688576,2024-02-08 14:51:04
806,H1-127.古石場川親水公園,0,35,35,35.669291,139.795364,2024-02-08 14:51:04
807,D4-05.カスタリア新宿7丁目,0,14,14,35.700732,139.711472,2024-02-08 14:51:04
808,I1-71.セブン-イレブン南大井浜川店,0,2,2,35.596483,139.7355,2024-02-08 14:51:04
809,I1-72.セブン-イレブン大井店,0,16,16,35.600081,139.728193,2024-02-08 14:51:04
810,T3-21.くまのやま緑地,4,1,5,35.747038,139.667965,2024-02-08 14:51:04
811,K1-110.萩中集会所裏,9,5,14,35.550479,139.739538,2024-02-08 14:51:04
812,O2-02.シエール荻窪,30,0,30,35.708265,139.612703,2024-02-08 14:51:04
813,H1-128.豊洲市場（5街区）,26,8,34,35.645162,139.785386,2024-02-08 14:51:04
814,N1-09.若宮レジデンス,2,3,5,35.716184,139.643905,2024-02-08 14:51:04
815,M6-12.LIVART SEASON 幡ヶ谷,0,14,14,35.683156,139.67338,2024-02-08 14:51:04
816,H1-142.東京ベイ潮見プリンスホテル,0,16,16,35.660632,139.817294,2024-02-08 14:51:04
817,G1-01.鐘ヶ淵駅南自転車駐車場,1,8,9,35.732291,139.82012,2024-02-08 14:51:04
818,M1-01.渋谷区役所,8,0,8,35.66362,139.69801,2024-02-08 14:51:04
819,I1-83.かもめ歩道橋,0,22,22,35.600161,139.749902,2024-02-08 14:51:04
820,N4-05.セブン-イレブン中野鍋横店,3,2,5,35.693815,139.668571,2024-02-08 14:51:04
821,D4-02.JICA市ヶ谷ビル（地球ひろば／研究所）,7,0,7,35.694927,139.731328,2024-02-08 14:51:04
822,T3-19.なかみや児童遊園,1,4,5,35.749388,139.651824,2024-02-08 14:51:04
823,N1-08.上鷺自転車保管場所,2,5,7,35.729056,139.627864,2024-02-08 14:51:04
824,O7-06.松木1丁目,2,11,13,35.686015,139.642784,2024-02-08 14:51:04
825,E4-16.ビレッジワン,1,5,6,35.723723,139.740143,2024-02-08 14:51:04
826,D1-15.フロンティア四谷,1,8,9,35.68768,139.71937,2024-02-08 14:51:04
827,K1-128.大森西3丁目,5,6,11,35.571975,139.732137,2024-02-08 14:51:04
828,N1-06.大和区民活動センター,1,4,5,35.713562,139.649075,2024-02-08 14:51:04
829,G4-01.両国ビューホテル1,0,7,7,35.69566,139.79214,2024-02-08 14:51:04
830,G4-02.両国ビューホテル2,1,7,8,35.69562,139.79206,2024-02-08 14:51:04
831,G4-05.両国駅西口臨時自転車駐車場,18,2,20,35.698588,139.792946,2024-02-08 14:51:04
832,G4-03.本所1-6-5,10,4,14,35.702525,139.796632,2024-02-08 14:51:04
833,G5-01.牡丹橋自転車駐車場,14,2,16,35.693059,139.813417,2024-02-08 14:51:04
834,G5-02.横川3-7-10,17,20,37,35.70378,139.814298,2024-02-08 14:51:04
835,G4-04.NTTドコモ墨田ビル,14,7,21,35.697898,139.795345,2024-02-08 14:51:04
836,G2-02.押上1-23-8,1,7,8,35.710111,139.81488,2024-02-08 14:51:04
837,C5-13.区立芝浦西運河沿緑地,17,21,38,35.638245,139.749754,2024-02-08 14:51:04
838,D6-12.東京ビジネスホテル,0,3,3,35.69342,139.710568,2024-02-08 14:51:04
839,D6-11.ホテルリステル新宿,0,3,3,35.693029,139.711327,2024-02-08 14:51:04
840,D6-10.ホテルサンライト新宿,2,0,2,35.694201,139.707047,2024-02-08 14:51:04
841,H1-39.辰巳駅東口自転車駐車場,21,4,25,35.645823,139.812178,2024-02-08 14:51:04
842,H1-38.辰巳駅西口自転車駐車場,89,0,89,35.646857,139.808912,2024-02-08 14:51:04
843,C2-10.元麻布三丁目,0,7,7,35.655865,139.730566,2024-02-08 14:51:04
844,C2-09.麻布地区総合支所,1,1,2,35.660614,139.734771,2024-02-08 14:51:04
845,M3-20.東急ステイ渋谷新南口,8,0,8,35.65494,139.70534,2024-02-08 14:51:04
846,I1-86.ファミリーマート二葉三丁目店,2,1,3,35.601694,139.719778,2024-02-08 14:51:04
847,A2-23.axle御茶ノ水,7,0,7,35.696126,139.763297,2024-02-08 14:51:04
848,C4-02.白金台いきいきプラザ,4,1,5,35.63756,139.724981,2024-02-08 14:51:04
849,N3-04.東中野駅地下駐輪場,0,22,22,35.707883,139.683284,2024-02-08 14:51:04
850,N3-05.中野坂上駅地下駐輪場,0,6,6,35.698068,139.682781,2024-02-08 14:51:04
851,N3-03.青桐公園,0,15,15,35.697024,139.677846,2024-02-08 14:51:04
852,N3-01.中野四季の森公園,6,4,10,35.708487,139.662135,2024-02-08 14:51:04
853,N4-01.本四公園,1,8,9,35.69693,139.672721,2024-02-08 14:51:04
854,N4-02.栄町公園,0,8,8,35.686474,139.671383,2024-02-08 14:51:04
855,K1-57.池上本門寺,5,1,6,35.579585,139.705377,2024-02-08 14:51:04
856,C1-49.汐留シティセンター,13,1,14,35.666213,139.760907,2024-02-08 14:51:04
857,C4-15.クロスレジデンス白金高輪,0,14,14,35.642771,139.733046,2024-02-08 14:51:04
858,K1-56.NTT馬込ビル,0,7,7,35.588106,139.718852,2024-02-08 14:51:04
859,J1-41.CASSIA目黒,2,5,7,35.631319,139.70237,2024-02-08 14:51:04
860,A2-22.専修大学,5,1,6,35.696147,139.753709,2024-02-08 14:51:04
861,T3-20.はやいち公園,2,2,4,35.75312,139.65661,2024-02-08 14:51:04
862,B3-19.本の森ちゅうおう,9,0,9,35.67363,139.77623,2024-02-08 14:51:04
863,K1-86.IMPREST STAY TOKYO 蒲田,21,1,22,35.556267,139.727246,2024-02-08 14:51:04
864,T3-23.氷川台二丁目緑地,3,1,4,35.756575,139.669689,2024-02-08 14:51:04
865,T3-22.氷川台三丁目ちびっこ公園,1,2,3,35.750547,139.66707,2024-02-08 14:51:04
866,B1-23.NANAEI日本橋,3,3,6,35.679616,139.784341,2024-02-08 14:51:04
867,B2-11.京橋エドグラン,11,1,12,35.677576,139.769822,2024-02-08 14:51:04
868,N1-05.大野ハイツ,1,4,5,35.7266,139.62948,2024-02-08 14:51:04
869,B2-09.茅場町一丁目平和ビル,10,0,10,35.680203,139.778679,2024-02-08 14:51:04
870,B2-08.共同ビル（茅場町交差点前）,7,2,9,35.681012,139.778569,2024-02-08 14:51:04
871,B2-07.東京証券会館（北側）,1,0,1,35.680864,139.779331,2024-02-08 14:51:04
872,O3-12.大宮前体育館,0,3,3,35.696567,139.610517,2024-02-08 14:51:04
873,B1-08.明治座,0,21,21,35.688038,139.786561,2024-02-08 14:51:04
874,B4-05.ドコモ・バイクシェア晴海ポート,0,29,29,35.654165,139.781568,2024-02-08 14:51:04
875,B4-04.ＫＤＸ晴海ビル,0,0,0,35.65443,139.77843,2024-02-08 14:51:04
876,B4-03.桜の散歩道（晴海トリトンスクエア前）,8,7,15,35.658665,139.782553,2024-02-08 14:51:04
877,E5-08.セブン-イレブン 文京動坂上店,2,3,5,35.727778,139.756296,2024-02-08 14:51:04
878,H1-65.ローソン南砂日曹橋店,11,3,14,35.669507,139.825553,2024-02-08 14:51:04
879,H1-66.中川船番所資料館,1,6,7,35.687732,139.846383,2024-02-08 14:51:04
880,K1-113.ファミリーマート大田上池台四丁目店,2,5,7,35.594658,139.700133,2024-02-08 14:51:04
881,H1-64.ローソン東雲駅前店,9,1,10,35.640228,139.804267,2024-02-08 14:51:04
882,E1-11.小石川運動場前,12,3,15,35.703914,139.747061,2024-02-08 14:51:04
883,T2-70.三ツ塚けやき緑地,2,2,4,35.720318,139.570762,2024-02-08 14:51:04
884,H1-137.住友不動産ショッピングシティ有明ガーデン,19,1,20,35.638985,139.793653,2024-02-08 14:51:04
885,C5-40.芝浦ふ頭駅前暫定自転車駐車場,2,2,4,35.64096,139.75754,2024-02-08 14:51:04
886,M3-21.渋谷ソラスタ,10,2,12,35.65618,139.69612,2024-02-08 14:51:04
887,D7-03.中井駅北,19,12,31,35.715645,139.687486,2024-02-08 14:51:04
888,K1-119.シーンズ大森パークサイド,4,0,4,35.58223,139.72763,2024-02-08 14:51:04
889,M6-15.cova Hatagaya,0,2,2,35.67741,139.67383,2024-02-08 14:51:04
890,C2-25.アパホテル＆リゾート＜六本木駅東＞,35,6,41,35.661783,139.737242,2024-02-08 14:51:04
891,D4-10.東新宿ポート(余丁町6番),1,5,6,35.696585,139.713081,2024-02-08 14:51:04
892,O1-02.井荻南地下自転車駐車場,6,8,14,35.72424,139.61431,2024-02-08 14:51:04
893,O1-03.LUCKY HOUSE,1,3,4,35.72489,139.62383,2024-02-08 14:51:04
894,D6-30.京王プラザホテル,6,1,7,35.6897,139.694823,2024-02-08 14:51:04
895,D6-29.都庁第二本庁舎前,13,0,13,35.688735,139.692249,2024-02-08 14:51:04
896,O3-02.アートメゾン荻窪,6,2,8,35.71355,139.6199,2024-02-08 14:51:04
897,J1-57.トレインチ自由が丘,4,1,5,35.606667,139.667324,2024-02-08 14:51:04
898,O2-01.サカエフラット荻窪,10,1,11,35.70535,139.61497,2024-02-08 14:51:04
899,O3-01.西田公園,1,6,7,35.69575,139.62065,2024-02-08 14:51:04
900,K1-47.NTT雪ヶ谷ビル,9,2,11,35.598601,139.684747,2024-02-08 14:51:04
901,O7-04.永福町西幸モータープール西,7,1,8,35.67161,139.64527,2024-02-08 14:51:04
902,K1-48.ファミリーマート大田上池台三丁目店,0,16,16,35.590934,139.696915,2024-02-08 14:51:04
903,K1-111.本羽田公園,5,1,6,35.546499,139.736761,2024-02-08 14:51:04
904,C1-58.ウォーターズ竹芝,3,7,10,35.655937,139.763251,2024-02-08 14:51:04
905,K1-109.萩中公園プール駐輪場,8,0,8,35.549323,139.737091,2024-02-08 14:51:04
906,K1-108.仲江名公園,2,1,3,35.557999,139.732564,2024-02-08 14:51:04
907,E1-17.小石川パークスクエア,0,7,7,35.713913,139.745416,2024-02-08 14:51:04
908,D6-23.アパホテル 東新宿 歌舞伎町西,1,1,2,35.697535,139.703633,2024-02-08 14:51:04
909,H1-98.洲崎川緑道公園,0,36,36,35.668705,139.810549,2024-02-08 14:51:04
910,H1-99.南砂三丁目公園,19,4,23,35.669695,139.831874,2024-02-08 14:51:04
911,H1-96.越中島公園,0,20,20,35.668757,139.790156,2024-02-08 14:51:04
912,H1-97.浜園公園,0,15,15,35.661852,139.802224,2024-02-08 14:51:04
913,H1-94.新木場一丁目緑地公園,4,5,9,35.64423,139.835823,2024-02-08 14:51:04
914,H1-95.若洲公園,5,19,24,35.619451,139.834429,2024-02-08 14:51:04
915,J1-09.ファミリーマート佐野久下目黒店,3,1,4,35.629252,139.712716,2024-02-08 14:51:04
916,H1-93.新木場一丁目公園,3,4,7,35.64143,139.835455,2024-02-08 14:51:04
917,I1-55.鈴ヶ森公園,0,19,19,35.593559,139.734704,2024-02-08 14:51:04
918,O6-04.柏の宮公園,1,4,5,35.67834,139.62711,2024-02-08 14:51:04
919,B4-14.Brillia ist Tower 勝どき,0,20,20,35.660526,139.776816,2024-02-08 14:51:04
920,D7-08.上落合3丁目,2,11,13,35.71115,139.68232,2024-02-08 14:51:04
921,H1-21.UR東雲キャナルコート,0,74,74,35.646041,139.804495,2024-02-08 14:51:04
922,H1-20.日本科学未来館,23,7,30,35.619377,139.777582,2024-02-08 14:51:04
923,H1-19.UR豊洲四丁目団地,17,1,18,35.653603,139.80144,2024-02-08 14:51:04
924,T2-45.風致地区バス停第三自転車駐車場,1,6,7,35.771068,139.586798,2024-02-08 14:51:04
925,H1-33.深川ギャザリア（ウエストスクエア）,0,26,26,35.66789,139.803,2024-02-08 14:51:04
926,H1-32.区営塩浜住宅前,0,22,22,35.664591,139.813954,2024-02-08 14:51:04
927,H1-23.KDX豊洲グランスクエア,12,0,12,35.648085,139.798986,2024-02-08 14:51:04
928,C2-22.飯倉公園,10,0,10,35.655649,139.74427,2024-02-08 14:51:04
929,I1-89.下神明駅自転車駐車場,5,0,5,35.608402,139.726118,2024-02-08 14:51:04
930,C5-39.お台場海浜公園東,11,1,12,35.631021,139.778109,2024-02-08 14:51:04
931,C5-38.お台場海浜公園乗船場,0,16,16,35.628743,139.773915,2024-02-08 14:51:04
932,O4-08.ローソン阿佐ヶ谷青梅街道店,0,5,5,35.703203,139.62804,2024-02-08 14:51:04
933,T2-72.高塚南緑地,4,1,5,35.733132,139.570311,2024-02-08 14:51:04
934,O6-03.みなみ荘,6,4,10,35.68073,139.62803,2024-02-08 14:51:04
935,K1-129.ローソン東糀谷一丁目店,0,8,8,35.557427,139.739126,2024-02-08 14:51:04
936,E1-03.東京ドーム（黄色いビル横）,8,0,8,35.70319,139.751888,2024-02-08 14:51:04
937,K1-23.大田区役所本庁舎前,4,1,5,35.561183,139.716339,2024-02-08 14:51:04
938,T2-78.北大泉くれはし公園,1,2,3,35.761474,139.592735,2024-02-08 14:51:04
939,J1-53.ボヌールAllamanda,3,2,5,35.612833,139.675047,2024-02-08 14:51:04
940,A3-39.トーシン東神田ビル,0,4,4,35.694834,139.780333,2024-02-08 14:51:04
941,O6-01.高井戸みどり公園,5,4,9,35.67912,139.61074,2024-02-08 14:51:04
942,T2-79.大泉学園町八丁目緑地,4,2,6,35.774457,139.596182,2024-02-08 14:51:04
943,O5-04.リヴィエール,16,4,20,35.70104,139.65839,2024-02-08 14:51:04
944,N3-08.中野区役所(西側),5,1,6,35.707968,139.663519,2024-02-08 14:51:04
945,I1-99.北品川２丁目,5,0,5,35.61663,139.74192,2024-02-08 14:51:04
946,P1-01.サンシャインシティ,4,2,6,35.728846,139.718577,2024-02-08 14:51:04
947,N3-14.ヴィラソンサ落合,0,7,7,35.713227,139.680966,2024-02-08 14:51:04
948,H1-49.セブン-イレブン 江東新砂３丁目店,0,21,21,35.667892,139.8311,2024-02-08 14:51:04
949,I1-06.大森貝塚遺跡庭園,9,0,9,35.593489,139.72967,2024-02-08 14:51:04
950,M2-12.恵比寿プライムスクエアタワー北,8,1,9,35.650541,139.713361,2024-02-08 14:51:04
951,H1-69.ファミリーマート 江東石島店,0,30,30,35.680474,139.812316,2024-02-08 14:51:04
952,B3-09.築地永谷コーポラス,1,12,13,35.66523,139.776313,2024-02-08 14:51:04
953,E4-10.白山四丁目第二児童遊園横,5,6,11,35.720349,139.746924,2024-02-08 14:51:04
954,I1-03.大井町駅中央口（西側）,2,3,5,35.605617,139.73472,2024-02-08 14:51:04
955,I1-04.大井町歩道橋,5,0,5,35.605146,139.734694,2024-02-08 14:51:04
956,I1-01.品川区役所 本庁舎前,9,1,10,35.609052,139.729825,2024-02-08 14:51:04
957,I1-02.品川区役所 第三庁舎前,9,0,9,35.608161,139.730048,2024-02-08 14:51:04
958,G4-08.ブオンサンヴァレンティーノ,1,4,5,35.691677,139.793857,2024-02-08 14:51:04
959,J1-13.洗足二丁目駐輪場,13,4,17,35.61061,139.693443,2024-02-08 14:51:04
960,J1-16.八雲橋自転車置場,2,4,6,35.617353,139.672256,2024-02-08 14:51:04
961,H1-189.MFLP新木場2,0,37,37,35.634453,139.824,2024-02-08 14:51:04
962,M6-09.ファミリーマート渋谷本町店,0,11,11,35.683756,139.684965,2024-02-08 14:51:04
963,H1-113.123+N東雲店,0,32,32,35.646366,139.801492,2024-02-08 14:51:04
964,J1-17.ファミリーマート原町二丁目店,0,6,6,35.613902,139.691476,2024-02-08 14:51:04
965,E5-21.動坂公園,1,10,11,35.73176,139.756669,2024-02-08 14:51:04
966,E5-20.本郷2丁目,0,8,8,35.704391,139.758575,2024-02-08 14:51:04
967,T2-48.武蔵関駅南第二自転車駐車場,3,1,4,35.726064,139.578015,2024-02-08 14:51:04
968,A6-26.相互半蔵門ビル,9,0,9,35.683378,139.743189,2024-02-08 14:51:04
969,J1-31.守屋図書館,12,8,20,35.634194,139.688833,2024-02-08 14:51:04
970,M3-19.渋谷キャスト,21,0,21,35.662146,139.702793,2024-02-08 14:51:04
971,N1-04.都立家政南駐輪場,0,10,10,35.721679,139.645265,2024-02-08 14:51:04
972,N2-02.江古田1丁目A,1,2,3,35.724988,139.672511,2024-02-08 14:51:04
973,C1-56.鈴与竹芝ビル,3,2,5,35.654873,139.762103,2024-02-08 14:51:04
974,D3-07.戸塚特別出張所,5,2,7,35.71429,139.70507,2024-02-08 14:51:04
975,G4-12.プレミアムキューブ両国,1,6,7,35.70103,139.803341,2024-02-08 14:51:04
976,A2-21.神田神保町3丁目,7,0,7,35.694578,139.754434,2024-02-08 14:51:04
977,B4-19.コーシャタワー佃,0,23,23,35.668044,139.785801,2024-02-08 14:51:04
978,I1-81.戸越6丁目,17,3,20,35.608127,139.717865,2024-02-08 14:51:04
979,A6-24.国立劇場,0,15,15,35.682218,139.743292,2024-02-08 14:51:04
980,E5-23.ビレッジ千駄木,0,6,6,35.722353,139.760966,2024-02-08 14:51:04
981,H1-119.榎戸材木店,0,15,15,35.638319,139.834741,2024-02-08 14:51:04
982,C5-29.Hi-NODE(ハイノード),7,1,8,35.651672,139.760549,2024-02-08 14:51:04
983,J1-22.NTTコミュニケーションズ唐ヶ崎ビル,0,5,5,35.627373,139.692044,2024-02-08 14:51:04
984,A2-18.猿楽町SSビル東,4,1,5,35.698654,139.759762,2024-02-08 14:51:04
985,A2-19.猿楽町SSビル西,3,0,3,35.698641,139.759306,2024-02-08 14:51:04
986,C1-55.アーバンネット内幸町ビル,18,2,20,35.669267,139.756018,2024-02-08 14:51:04
987,D4-06.グリーンフォート河田,0,11,11,35.697143,139.718739,2024-02-08 14:51:04
988,K1-134.東調布公園,2,8,10,35.588363,139.69042,2024-02-08 14:51:04
989,M5-18.Luxe初台,1,3,4,35.679182,139.68596,2024-02-08 14:51:04
990,D7-06.エムアイセミナーハウス,3,1,4,35.721064,139.677128,2024-02-08 14:51:04
991,A3-37.ポータル秋葉原,0,22,22,35.695737,139.78162,2024-02-08 14:51:04
992,M5-11.あおい通り,7,1,8,35.688154,139.698975,2024-02-08 14:51:04
993,E5-04.保健サービスセンター本郷支所,0,5,5,35.727046,139.760439,2024-02-08 14:51:04
994,E5-03.汐見地域活動センター（本郷図書館）,0,5,5,35.725538,139.76116,2024-02-08 14:51:04
995,E5-01.文京総合体育館,30,1,31,35.708121,139.763583,2024-02-08 14:51:04
996,E4-01.千石南自転車駐車場,6,19,25,35.72707,139.746112,2024-02-08 14:51:04
997,E3-03.大塚公園,5,16,21,35.724286,139.730954,2024-02-08 14:51:04
998,E3-02.教育の森公園,5,12,17,35.719345,139.736198,2024-02-08 14:51:04
999,I1-25.セブン-イレブン 品川旗の台2丁目店,0,5,5,35.607084,139.705007,2024-02-08 14:51:04
1000,B1-21.日本橋二丁目街角広場,5,4,9,35.680861,139.774493,2024-02-08 14:51:04
1001,C3-30.東京赤坂NKビル (ヴィアインプライム赤坂),8,1,9,35.672652,139.738908,2024-02-08 14:51:04
1002,A3-36.クロックカフェ東神田,0,5,5,35.694943,139.782718,2024-02-08 14:51:04
1003,E1-14.いきいき礫川,2,7,9,35.711147,139.747386,2024-02-08 14:51:04
1004,D4-09.トミンハイム仲之町,0,15,15,35.69617,139.722021,2024-02-08 14:51:04
1005,L1-08.NTT砧ビル,0,6,6,35.63534,139.601602,2024-02-08 14:51:04
1006,L1-09.コージーK・駒沢,2,1,3,35.632689,139.654804,2024-02-08 14:51:04
1007,L1-10.宮坂2-4-10,0,7,7,35.652913,139.644825,2024-02-08 14:51:04
1008,I1-22.ウィラ大井 (ショッピングモール),0,5,5,35.596579,139.745009,2024-02-08 14:51:04
1009,K1-76.グリーンベルト,9,0,9,35.585178,139.726339,2024-02-08 14:51:04
1010,H1-121.南砂5丁目,0,41,41,35.676603,139.829736,2024-02-08 14:51:04
1011,M3-02.文化総合センター大和田,5,0,5,35.65558,139.69966,2024-02-08 14:51:04
1012,D4-04.ジェノヴィア新宿早稲田グリーンヴェール,2,3,5,35.700033,139.71983,2024-02-08 14:51:04
1013,A3-20.神田ふれあい通り第２,0,2,2,35.695005,139.772747,2024-02-08 14:51:04
1014,H1-120.豊洲5丁目,18,0,18,35.650948,139.799711,2024-02-08 14:51:04
1015,C5-42.DHC芝浦2丁目ビル,3,1,4,35.644241,139.753834,2024-02-08 14:51:04
1016,I1-65.セブン-イレブン品川東大井1丁目店,7,0,7,35.605996,139.743037,2024-02-08 14:51:04
1017,M2-04.広尾東公園,5,1,6,35.653382,139.721059,2024-02-08 14:51:04
1018,M3-13.渋谷駅東口地下駐輪場,18,1,19,35.657682,139.703307,2024-02-08 14:51:04
1019,A3-19.神田ふれあい通り第１,0,5,5,35.694904,139.772712,2024-02-08 14:51:04
1020,O6-07.ローソン杉並宮前一丁目店,2,3,5,35.689639,139.613516,2024-02-08 14:51:04
1021,T3-10.貫井一丁目緑地,0,3,3,35.736378,139.632485,2024-02-08 14:51:04
1022,M2-05.日本赤十字医療センター,3,7,10,35.65519,139.718559,2024-02-08 14:51:04
1023,T2-20.パークサイド石神井,0,11,11,35.741769,139.591103,2024-02-08 14:51:04
1024,N4-06.ローソン中野本町新橋通り店,0,6,6,35.695819,139.674326,2024-02-08 14:51:04
1025,T3-07.徳殿公園,3,1,4,35.726728,139.65874,2024-02-08 14:51:04
1026,K1-35.セブン-イレブン 大田区西六郷2丁目店,0,13,13,35.549778,139.707362,2024-02-08 14:51:04
1027,A3-27.秋葉原駅中央口（ヨドバシカメラ前）,6,4,10,35.698986,139.774099,2024-02-08 14:51:04
1028,A3-28.秋葉原駅電気街口(西側交通広場),5,0,5,35.699173,139.772629,2024-02-08 14:51:04
1029,H1-57.新木場駅,32,29,61,35.64508,139.826456,2024-02-08 14:51:04
1030,H1-58.潮見駅,0,28,28,35.658703,139.817251,2024-02-08 14:51:04
1031,D7-02.セブン-イレブン 新宿中落合3丁目店,0,15,15,35.722202,139.691712,2024-02-08 14:51:04
1032,D2-06.飯田濠,10,4,14,35.70057,139.74301,2024-02-08 14:51:04
1033,C5-17.鈴与浜松町ビル,5,5,10,35.651103,139.759092,2024-02-08 14:51:04
1034,H1-59.LYURO 東京清澄,0,24,24,35.681316,139.792176,2024-02-08 14:51:04
1035,H1-60.荒川・砂町庭球場西,0,31,31,35.679678,139.844892,2024-02-08 14:51:04
1036,K1-44.中馬込貝塚公園,1,4,5,35.594795,139.704951,2024-02-08 14:51:04
1037,M6-11.京王サイクルパーク笹塚,0,6,6,35.674337,139.668801,2024-02-08 14:51:04
1038,J1-49.伊勢脇公園,3,1,4,35.638864,139.696568,2024-02-08 14:51:04
1039,K1-45.たぬき山公園,2,6,8,35.592801,139.715472,2024-02-08 14:51:04
1040,D2-01.あずさセンタービル,12,6,18,35.702286,139.741093,2024-02-08 14:51:04
1041,C1-02.西新橋1丁目（外堀通り）,5,1,6,35.668791,139.753582,2024-02-08 14:51:04
1042,O3-07.NTT井草ビル第1ポート,2,1,3,35.714044,139.61688,2024-02-08 14:51:04
1043,T2-41.ローソン 練馬東大泉五丁目店,0,4,4,35.74248,139.58715,2024-02-08 14:51:04
1044,H1-144.南砂住宅,0,17,17,35.674199,139.822018,2024-02-08 14:51:04
1045,C3-28.ヒューリックＪＰ赤坂ビル,11,0,11,35.672477,139.739743,2024-02-08 14:51:04
1046,H1-145.東雲都橋住宅,0,10,10,35.643131,139.797784,2024-02-08 14:51:04
1047,I1-58.品川区役所　第二庁舎前,18,0,18,35.609664,139.730006,2024-02-08 14:51:04
1048,K1-92.蒲田駅西口自転車駐車場,25,0,25,35.561101,139.715173,2024-02-08 14:51:04
1049,A2-24.水道橋駅西口前,6,0,6,35.702271,139.752619,2024-02-08 14:51:04
1050,K1-94.昭和島駅前,0,26,26,35.572188,139.749613,2024-02-08 14:51:04
1051,M5-15.新宿マインズタワー,16,4,20,35.686567,139.699355,2024-02-08 14:51:04
1052,D7-13.日本光電本社南側,11,4,15,35.71936,139.679083,2024-02-08 14:51:04
1053,N3-09.中野区役所(北側),3,2,5,35.708259,139.663829,2024-02-08 14:51:04
1054,H1-163.森下公園,1,3,4,35.68663,139.799529,2024-02-08 14:51:04
1055,B4-23.交通広場（豊海町）,0,11,11,35.653771,139.769295,2024-02-08 14:51:04
1056,D6-18.ヨドバシカメラ 新宿西口本店前,0,6,6,35.689689,139.698231,2024-02-08 14:51:04
1057,I1-47.NTT 東日本 関東病院(南側),7,0,7,35.630151,139.725215,2024-02-08 14:51:04
1058,H1-112.ファミリーマート江東塩浜二丁目店,3,0,3,35.66305,139.8087,2024-02-08 14:51:04
1059,K1-103.雪谷特別出張所,0,7,7,35.594515,139.691219,2024-02-08 14:51:04
1060,E5-17.Village藍染,0,5,5,35.720896,139.76422,2024-02-08 14:51:04
1061,I1-49.京急鮫洲バイク駐輪場,6,0,6,35.603815,139.741362,2024-02-08 14:51:04
1062,I1-50.京急立会川第2バイク駐輪場,0,10,10,35.599196,139.739158,2024-02-08 14:51:04
1063,E4-14.NTT東日本大塚ビル,0,17,17,35.726188,139.741375,2024-02-08 14:51:04
1064,M2-07.ファミリーマート恵比寿駅東店,7,0,7,35.6471,139.712818,2024-02-08 14:51:04
1065,M4-07.千駄ヶ谷駅前,2,1,3,35.68082,139.71188,2024-02-08 14:51:04
1066,O5-07.バーンホーフ キクチ,11,9,20,35.698169,139.655665,2024-02-08 14:51:04
1067,J1-11.コンフォリア目黒青葉台,0,6,6,35.649023,139.696086,2024-02-08 14:51:04
1068,L1-14.給田3丁目,0,13,13,35.664335,139.590114,2024-02-08 14:51:04
1069,B4-06.月島駅地下駐輪場,1,16,17,35.66291,139.782564,2024-02-08 14:51:04
1070,C5-09.グランパーク,19,1,20,35.643202,139.746244,2024-02-08 14:51:04
1071,C5-08.AQUACITY芝浦,6,4,10,35.637366,139.74844,2024-02-08 14:51:04
1072,C3-08.赤坂パークビルヂング,5,0,5,35.671792,139.733668,2024-02-08 14:51:04
1073,C3-07.新青山ビル,17,1,18,35.672659,139.725644,2024-02-08 14:51:04
1074,C3-06.ホテルアジア会館,0,10,10,35.67064,139.728166,2024-02-08 14:51:04
1075,C1-24.三田国際ビル,1,9,10,35.653159,139.744673,2024-02-08 14:51:04
1076,C5-07.港区立港南図書館,0,25,25,35.632842,139.7495,2024-02-08 14:51:04
1077,A3-04.秋葉原公園,0,16,16,35.697642,139.774867,2024-02-08 14:51:04
1078,A3-05.和泉公園（西側入口）,4,2,6,35.698817,139.778898,2024-02-08 14:51:04
1079,A3-02.絶滅メディア博物館（楓ビル）,8,0,8,35.689575,139.767848,2024-02-08 14:51:04
1080,O3-10.メゾンパークス,5,3,8,35.716265,139.618954,2024-02-08 14:51:04
1081,A2-05.神田橋公園,0,2,2,35.689665,139.764091,2024-02-08 14:51:04
1082,A3-01.神田児童公園（西側交番横）,4,2,6,35.692983,139.76773,2024-02-08 14:51:04
1083,A2-03.西神田公園（西側）,5,0,5,35.698338,139.754876,2024-02-08 14:51:04
1084,M6-03.十三号通り公園,0,7,7,35.675198,139.663587,2024-02-08 14:51:04
1085,M6-02.サイカパーク笹塚,0,10,10,35.673444,139.666553,2024-02-08 14:51:04
1086,H1-165.亀戸梅屋敷,0,10,10,35.701318,139.825916,2024-02-08 14:51:04
1087,H1-166.亀戸クロック,16,3,19,35.696574,139.82972,2024-02-08 14:51:04
1088,M5-02.あいおいニッセイ同和損保新宿ビル,1,4,5,35.684423,139.692262,2024-02-08 14:51:04
1089,M6-01.幡ヶ谷駅高架下第一,23,13,36,35.677175,139.676769,2024-02-08 14:51:04
1090,A5-02.山王パークタワー,5,0,5,35.673555,139.741293,2024-02-08 14:51:04
1091,K1-116.旧呑川緑地（大森東五丁目）,6,6,12,35.567176,139.742345,2024-02-08 14:51:04
1092,K1-115.旧呑川緑地（大森中三丁目）,0,7,7,35.565685,139.736195,2024-02-08 14:51:04
1093,K1-114.下丸子公園,7,0,7,35.568722,139.680736,2024-02-08 14:51:04
1094,T3-05.東武練馬駅南,0,10,10,35.767129,139.664365,2024-02-08 14:51:04
1095,T1-14.ファミリーマート 練馬高松五丁目北店,4,0,4,35.761038,139.623148,2024-02-08 14:51:04
1096,C3-29.高橋是清翁記念公園,5,1,6,35.674094,139.728895,2024-02-08 14:51:04
1097,K1-141.蒲田駅西口歩道,4,0,4,35.561291,139.715076,2024-02-08 14:51:04
1098,C3-35.ワールド北青山ビル,17,0,17,35.667069,139.713423,2024-02-08 14:51:04
1099,M5-03.代々木大山公園,11,5,16,35.671282,139.675307,2024-02-08 14:51:04
1100,E5-13.弥生二丁目,3,3,6,35.715592,139.76192,2024-02-08 14:51:04
1101,E5-12.NK本郷ビル,1,5,6,35.704475,139.763041,2024-02-08 14:51:04
1102,B3-18.銀座松竹スクエア,10,0,10,35.668395,139.769849,2024-02-08 14:51:04
1103,C1-44.三田Avanti,4,2,6,35.64115,139.741471,2024-02-08 14:51:04
1104,T2-31.ファミリーマート 石神井台二丁目店,0,7,7,35.739488,139.590273,2024-02-08 14:51:04
1105,H1-150.ホテルヴィラフォンテーヌ南側,9,0,9,35.636978,139.791858,2024-02-08 14:51:04
1106,H1-149.有明ガーデン 公園口,8,0,8,35.639132,139.793047,2024-02-08 14:51:04
1107,H1-148.大島七丁目団地,0,17,17,35.694104,139.840278,2024-02-08 14:51:04
1108,B4-26.東武ストア晴海三丁目店,1,13,14,35.654371,139.779545,2024-02-08 14:51:04
1109,J1-26.田向公園,3,4,7,35.623459,139.687128,2024-02-08 14:51:04
1110,J1-25.碑文谷公園,3,4,7,35.625081,139.682632,2024-02-08 14:51:04
1111,H1-195.東京アクアティクスセンター,5,14,19,35.65238,139.815613,2024-02-08 14:51:04
1112,T1-13.ファミリーマート 練馬土支田二丁目店,0,12,12,35.761613,139.61349,2024-02-08 14:51:04
1113,T2-34.ファミリーマート 練馬富士見台店,0,5,5,35.73969,139.62125,2024-02-08 14:51:04
1114,T2-35.ファミリーマート 石神井台六丁目店,0,5,5,35.738607,139.585331,2024-02-08 14:51:04
1115,C1-81.田町タワー,17,3,20,35.646534,139.748913,2024-02-08 14:51:04
1116,J1-07.目黒川船入場,13,2,15,35.641992,139.701588,2024-02-08 14:51:04
1117,J1-08.目黒区民センター公園,14,4,18,35.634533,139.708868,2024-02-08 14:51:04
1118,D4-01.市谷仲之町,2,4,6,35.695102,139.723345,2024-02-08 14:51:04
1119,M2-11.鉢山町,15,1,16,35.652151,139.698426,2024-02-08 14:51:04
1120,E4-08.ドコモ・バイクシェア向丘ポート,0,9,9,35.720546,139.756685,2024-02-08 14:51:04
1121,D4-03.市谷加賀町2丁目,0,8,8,35.695636,139.727882,2024-02-08 14:51:04
1122,N1-01.BeGood野方,0,10,10,35.719717,139.64785,2024-02-08 14:51:04
1123,C2-03.アークヒルズサウスタワー,9,2,11,35.666357,139.73923,2024-02-08 14:51:04
1124,C2-01.アークヒルズ（アーク森ビル）,7,3,10,35.667107,139.739565,2024-02-08 14:51:04
1125,C2-02.六本木ヒルズ,25,1,26,35.661158,139.728533,2024-02-08 14:51:04
1126,C5-03.港南公園C,0,31,31,35.624966,139.746657,2024-02-08 14:51:04
1127,C5-04.みなとパーク芝浦,10,0,10,35.646801,139.751208,2024-02-08 14:51:04
1128,C1-16.機械振興会館,6,0,6,35.659442,139.745549,2024-02-08 14:51:04
1129,C1-14.新橋プラザビル,1,3,4,35.664461,139.756082,2024-02-08 14:51:04
1130,H1-73.イシマビル,3,3,6,35.67386,139.79976,2024-02-08 14:51:04
1131,O7-01.西永福公園,4,1,5,35.67753,139.63667,2024-02-08 14:51:04
1132,O6-02.富士見ヶ丘南自転車駐車場,6,2,8,35.68296,139.60861,2024-02-08 14:51:04
1133,K1-50.テクノポートカマタ 第1,6,0,6,35.556199,139.721476,2024-02-08 14:51:04
1134,J1-14.二の橋自転車置場1,38,1,39,35.614856,139.678208,2024-02-08 14:51:04
1135,O3-08.NTT井草ビル第２ポート,1,2,3,35.714077,139.61694,2024-02-08 14:51:04
1136,H1-124.セブン-イレブン 江東海辺店,3,5,8,35.680636,139.817977,2024-02-08 14:51:04
1137,D1-11.三井ガーデンホテル神宮外苑の杜プレミア,5,0,5,35.679807,139.715931,2024-02-08 14:51:04
1138,O7-07.ハレ永福,1,7,8,35.678913,139.639944,2024-02-08 14:51:04
1139,C5-32.トレードピアお台場,4,1,5,35.627891,139.776896,2024-02-08 14:51:04
1140,B4-18.豊海センタービル,0,6,6,35.653531,139.769431,2024-02-08 14:51:04
1141,D5-04.西戸山公園野球場,2,5,7,35.707388,139.700204,2024-02-08 14:51:04
1142,D5-03.北新宿公園,0,15,15,35.702288,139.68862,2024-02-08 14:51:04
1143,D3-04.鶴巻南公園,0,25,25,35.706182,139.723394,2024-02-08 14:51:04
1144,D3-03.甘泉園公園,0,15,15,35.712431,139.715418,2024-02-08 14:51:04
1145,K1-03.池上会館,0,7,7,35.576593,139.706597,2024-02-08 14:51:04
1146,K1-02.平和の森公園,12,2,14,35.579049,139.739878,2024-02-08 14:51:04
1147,K1-01.大森海苔のふるさと館,0,11,11,35.57685,139.742496,2024-02-08 14:51:04
1148,D6-13.新宿中央公園（ジャブジャブ池下）,8,1,9,35.687652,139.689254,2024-02-08 14:51:04
1149,T2-28.ファミリーマート 南大泉六丁目店,3,2,5,35.752217,139.571095,2024-02-08 14:51:04
1150,K1-05.平和島公園プール,13,4,17,35.581832,139.741581,2024-02-08 14:51:04
1151,K1-04.京急蒲田駅東口,19,1,20,35.559483,139.724273,2024-02-08 14:51:04
1152,E2-10.音羽パークロード（北入口）,13,2,15,35.716586,139.727705,2024-02-08 14:51:04
1153,E2-11.音羽パークロード（キャッチボール場横）,15,4,19,35.715382,139.728533,2024-02-08 14:51:04
1154,I1-21.大井競馬場(正門前),10,0,10,35.593887,139.741204,2024-02-08 14:51:04
1155,J1-27.衾町公園,1,0,1,35.623215,139.668472,2024-02-08 14:51:04
1156,T2-44.中島橋自転車駐車場,5,2,7,35.75372,139.584332,2024-02-08 14:51:04
1157,B3-15.ACホテル・バイ・マリオット東京銀座,8,0,8,35.668845,139.765144,2024-02-08 14:51:04
1158,D5-07.百人町1丁目,4,2,6,35.699252,139.697606,2024-02-08 14:51:04
1159,C4-04.ショパン高輪,0,6,6,35.632128,139.732097,2024-02-08 14:51:04
1160,B1-18.セブン-イレブン 日本橋小網町店,1,2,3,35.681352,139.781436,2024-02-08 14:51:04
1161,T2-71.わかば児童公園,4,3,7,35.7211,139.574669,2024-02-08 14:51:04
1162,M3-15.co-ba ebisu,3,3,6,35.647076,139.703964,2024-02-08 14:51:04
1163,C2-20.三井ガーデンホテル六本木プレミア,4,0,4,35.66206,139.735501,2024-02-08 14:51:04
1164,I1-70.五反田リバーステーション,2,3,5,35.624566,139.72448,2024-02-08 14:51:04
1165,E5-25.ジェノヴィア東大前グリーンヴェール,7,3,10,35.711875,139.759306,2024-02-08 14:51:04
1166,D1-12.ジェノヴィア新宿御苑グリーンヴェール,2,5,7,35.689017,139.714755,2024-02-08 14:51:04
1167,C5-33.msb Tamachi,30,8,38,35.645682,139.748768,2024-02-08 14:51:04
1168,G4-09.SYFORME MORISHITA Ⅱ 1,1,0,1,35.690348,139.796133,2024-02-08 14:51:04
1169,G4-10.SYFORME MORISHITA Ⅱ 2,4,1,5,35.690307,139.796128,2024-02-08 14:51:04
1170,N3-19.上高田パーキング,0,17,17,35.715878,139.673669,2024-02-08 14:51:04
1171,F6-01.松坂屋上野店,3,1,4,35.707305,139.773657,2024-02-08 14:51:04
1172,F4-01.SYFORME ASAKUSA,1,3,4,35.718832,139.791133,2024-02-08 14:51:04
1173,F2-02.アップルパーク浅草6丁目第3,0,3,3,35.716062,139.799552,2024-02-08 14:51:04
1174,F2-01.松が谷2丁目2,0,20,20,35.71283,139.787754,2024-02-08 14:51:04
1175,F1-02.台東デザイナーズビレッジ,1,6,7,35.706023,139.783751,2024-02-08 14:51:04
1176,F2-03.台東区生涯学習センター,0,6,6,35.717497,139.790055,2024-02-08 14:51:04
1177,K1-146.南馬込6丁目25-11,1,2,3,35.582743,139.710561,2024-02-08 14:51:04
1178,F3-01.清川1丁目18-11,0,17,17,35.724944,139.801684,2024-02-08 14:51:04
1179,F1-03.新御徒町駅自転車駐車場,4,12,16,35.706793,139.782985,2024-02-08 14:51:04
1180,F3-02.台東区リバーサイドスポーツセンター,0,7,7,35.717571,139.804216,2024-02-08 14:51:04
1181,I1-45.セブン-イレブン品川西五反田3丁目店,5,0,5,35.62541,139.718135,2024-02-08 14:51:04
1182,H1-135.北砂5丁目団地,0,31,31,35.684218,139.832843,2024-02-08 14:51:04
1183,C3-16.赤坂ガーデンシティ,0,10,10,35.6738,139.731525,2024-02-08 14:51:04
1184,J1-34.田道広場公園,7,3,10,35.636269,139.709073,2024-02-08 14:51:04
1185,O5-08.セシオン杉並,0,3,3,35.69714,139.65432,2024-02-08 14:51:04
1186,A2-04.ちよだプラットフォームスクウェア,10,0,10,35.691456,139.762228,2024-02-08 14:51:04
1187,I1-102.J.GRAN Court 品川西大井 EAST,3,4,7,35.598244,139.722447,2024-02-08 14:51:04
1188,H1-196.フットサルクラブ東京東陽町,5,1,6,35.665288,139.824294,2024-02-08 14:51:04
1189,F2-04.コンフォラス浅草マンション,0,3,3,35.717241,139.801674,2024-02-08 14:51:04
1190,G5-03.京成リッチモンドホテル東京錦糸町,1,3,4,35.693492,139.81506,2024-02-08 14:51:04
1191,K1-27.六郷文化センター,0,3,3,35.544715,139.707623,2024-02-08 14:51:04
1192,K1-147.トヨタモビリティ東京GRGarage東京蒲田店,2,0,2,35.552741,139.718404,2024-02-08 14:51:04
1193,K1-148.トヨタモビリティ東京 蒲田仲六郷店,6,0,6,35.552068,139.71747,2024-02-08 14:51:04
1194,K1-150.トヨタモビリティ東京 池上第二京浜店,1,4,5,35.568019,139.696379,2024-02-08 14:51:04
1195,K1-149.トヨタモビリティ東京 大田店,2,4,6,35.59336,139.715879,2024-02-08 14:51:04
1196,C1-82.トヨタモビリティ東京 港三田店,0,3,3,35.647831,139.739048,2024-02-08 14:51:04
1197,D4-11.トヨタモビリティ東京 新宿明治通り南店,2,0,2,35.699835,139.70808,2024-02-08 14:51:04
1198,C3-31.赤坂一丁目,13,4,17,35.670239,139.744285,2024-02-08 14:51:04
1199,E1-04.礫川公園,31,10,41,35.707853,139.751518,2024-02-08 14:51:04
1200,M3-23.円山町7-1,1,7,8,35.658229,139.694885,2024-02-08 14:51:04
1201,M3-24.渋谷道玄坂２丁目駐輪場,3,15,18,35.66026,139.69684,2024-02-08 14:51:04
1202,T3-32.練馬北町1丁目,1,4,5,35.764452,139.666299,2024-02-08 14:51:04
1203,H1-197.セブン-イレブン江東南砂葛西橋通り店,0,3,3,35.675361,139.825034,2024-02-08 14:51:04
1204,T2-84.石神井町二丁目緑地,0,3,3,35.748395,139.605958,2024-02-08 14:51:04
1205,T2-82.梅の木児童遊園,0,5,5,35.737899,139.576584,2024-02-08 14:51:04
1206,T2-83.西大泉さくら緑地,4,4,8,35.760442,139.573145,2024-02-08 14:51:04
1207,D7-05.西落合図書館,7,1,8,35.725818,139.678976,2024-02-08 14:51:04
1208,D6-28.東急ステイ新宿,3,0,3,35.690899,139.706348,2024-02-08 14:51:04
1209,T2-85.泉新公園,3,1,4,35.7547,139.601497,2024-02-08 14:51:04
1210,T2-86.石神井町八丁目緑地,2,1,3,35.746956,139.600798,2024-02-08 14:51:04
1211,T2-87.南大泉四丁目児童遊園,0,4,4,35.745607,139.573947,2024-02-08 14:51:04
1212,T2-88.南大泉かたまち緑地,0,4,4,35.739633,139.570457,2024-02-08 14:51:04
1213,T2-89.南大泉三丁目児童遊園,0,3,3,35.742755,139.568335,2024-02-08 14:51:04
1214,E2-05.護国寺駅西自転車駐車場,21,2,23,35.719421,139.725584,2024-02-08 14:51:04
1215,J1-59.第44興和ビル,3,1,4,35.647704,139.693671,2024-02-08 14:51:04
1216,C1-15.東京タワー,11,5,16,35.65928,139.744767,2024-02-08 14:51:04
1217,C5-20.ローソン芝浦二丁目店,3,0,3,35.645254,139.754765,2024-02-08 14:51:04
1218,C2-27.有栖川宮記念公園第一,17,0,17,35.651382,139.724392,2024-02-08 14:51:04
1219,C2-28.有栖川宮記念公園第二,4,4,8,35.651129,139.726003,2024-02-08 14:51:04
1220,C2-29.狸穴公園,4,1,5,35.658204,139.738935,2024-02-08 14:51:04
1221,T2-90.南田中四丁目緑地,2,2,4,35.733195,139.612327,2024-02-08 14:51:04
1222,T2-91.石神井町四丁目緑地,5,0,5,35.745272,139.604579,2024-02-08 14:51:04
1223,A3-41.秋葉原ダイビル,4,1,5,35.698917,139.771856,2024-02-08 14:51:04
1224,J1-54.田道住区センター三田分室,5,0,5,35.638904,139.712518,2024-02-08 14:51:04
1225,H1-140.キャナルパレス住吉,9,6,15,35.689896,139.815116,2024-02-08 14:51:04
1226,C1-57.虎ノ門ツインビルディング,7,0,7,35.667259,139.745643,2024-02-08 14:51:04
1227,K1-54.ファミリーマート大田久が原五丁目店,0,7,7,35.579435,139.698552,2024-02-08 14:51:04
1228,B1-29.ASTILE日本橋浜町,0,8,8,35.685504,139.790817,2024-02-08 14:51:04
1229,N3-20.SYFORME NAKANO-SAKAUE,3,2,5,35.701157,139.679617,2024-02-08 14:51:04
1230,D6-31.東急歌舞伎町タワー駐輪場,4,3,7,35.696207,139.700521,2024-02-08 14:51:04
1231,I1-30.ローソン 大井三丁目店,6,0,6,35.603327,139.729006,2024-02-08 14:51:04
1232,K1-151.PATH仲六郷,10,0,10,35.549465,139.711157,2024-02-08 14:51:04
1233,H1-198.Br Tower 有明 MID CROSS,6,1,7,35.63464,139.783445,2024-02-08 14:51:04
1234,H1-04.石と光の広場（国際展示場駅）,42,19,61,35.63363,139.79082,2024-02-08 14:51:04
1235,B4-24.ミュプレ月島,4,3,7,35.66288,139.78329,2024-02-08 14:51:04
1236,H1-199.ラ・ヴェール東陽町,3,7,10,35.664244,139.814506,2024-02-08 14:51:04
1237,H1-200.ヴェッセル木場南,0,10,10,35.662414,139.813333,2024-02-08 14:51:04
1238,F1-04.台東2丁目21,0,5,5,35.703465,139.780325,2024-02-08 14:51:04
1239,F3-03.ヴェルステージ南千住,0,5,5,35.728704,139.801867,2024-02-08 14:51:04
1240,J1-46.五本木西みどり街かど公園,0,6,6,35.632735,139.683899,2024-02-08 14:51:04
1241,K1-131.東急武蔵新田駅駐輪場,11,4,15,35.567146,139.693344,2024-02-08 14:51:04
1242,K1-152.アットホームスクエア前,0,8,8,35.543327,139.703223,2024-02-08 14:51:04
1243,B2-04.清水建設本社（都営地下鉄宝町駅 Ａ８出口）,15,1,16,35.676119,139.772895,2024-02-08 14:51:04
1244,H1-202.辰巳の森海浜公園,7,5,12,35.648107,139.813572,2024-02-08 14:51:04
1245,H1-201.ウエリスアーバン水天宮前2,4,2,6,35.678099,139.791831,2024-02-08 14:51:04
1246,I1-103.五反田ＪＰビルディング,3,0,3,35.622389,139.721552,2024-02-08 14:51:04
1247,L1-16.上祖師谷7丁目,13,1,14,35.65838,139.59231,2024-02-08 14:51:04
1248,O5-09.AppCruise中野,1,1,2,35.700772,139.66063,2024-02-08 14:51:04
1249,H1-203.セブン-イレブン江東木場３丁目店,0,7,7,35.67517,139.804087,2024-02-08 14:51:04
1250,H1-44.テプコ豊洲ビル,21,3,24,35.648726,139.790877,2024-02-08 14:51:04
1251,L1-17.赤堤3丁目,3,4,7,35.659787,139.636696,2024-02-08 14:51:04
1252,L1-18.上北沢1丁目,20,10,30,35.662796,139.626795,2024-02-08 14:51:04
1253,B3-16.明石町区民館,0,11,11,35.666001,139.778102,2024-02-08 14:51:04
1254,I1-104.源氏前ビル,5,0,5,35.603521,139.712345,2024-02-08 14:51:04
1255,J1-28.宮前公園,0,8,8,35.617699,139.664826,2024-02-08 14:51:04
1256,M6-18.セブン-イレブン渋谷本町3丁目店,2,2,4,35.686521,139.685017,2024-02-08 14:51:04
1257,O7-08.杉並区和泉2-3-17,0,4,4,35.67187,139.65474,2024-02-08 14:51:04
1258,T1-17.セブン-イレブン練馬田柄通店,6,1,7,35.75987,139.640474,2024-02-08 14:51:04
1259,H1-18.東京ビッグサイト,7,9,16,35.631192,139.79401,2024-02-08 14:51:04
1260,M3-01.渋谷マークシティ,11,2,13,35.657726,139.697802,2024-02-08 14:51:04
1261,H1-70.有明スポーツセンター,13,4,17,35.63403,139.784319,2024-02-08 14:51:04
1262,H1-41.深川北スポーツセンター,2,11,13,35.676475,139.804741,2024-02-08 14:51:04
1263,H1-55.深川江戸資料館,3,5,8,35.681089,139.800777,2024-02-08 14:51:04
1264,I1-61.五反田文化センター,3,4,7,35.622588,139.716159,2024-02-08 14:51:04
1265,N3-13.中部すこやか福祉センター,3,2,5,35.700052,139.673715,2024-02-08 14:51:04
1266,A4-02.東京サンケイビル,7,3,10,35.686847,139.765151,2024-02-08 14:51:04
1267,M3-09.ティップ.クロス TOKYO 渋谷,10,9,19,35.661475,139.699296,2024-02-08 14:51:04
1268,B3-02.サンクンガーデン,2,4,6,35.670336,139.771911,2024-02-08 14:51:04
1269,T2-10.勤労福祉会館,5,0,5,35.748153,139.58765,2024-02-08 14:51:04
1270,K1-133.東京港野鳥公園,13,0,13,35.584217,139.759232,2024-02-08 14:51:04
1271,K1-21.六郷特別出張所,0,8,8,35.55079,139.716517,2024-02-08 14:51:04
1272,H1-54.砂町文化センター,3,17,20,35.680052,139.831874,2024-02-08 14:51:04
1273,D1-08.新宿歴史博物館,3,1,4,35.689984,139.725261,2024-02-08 14:51:04
1274,E1-05.春日地下自転車駐車場,23,4,27,35.708291,139.753335,2024-02-08 14:51:04
1275,E1-15.播磨坂事業所,2,0,2,35.71724,139.74289,2024-02-08 14:51:04
1276,E5-02.不忍通りふれあい館,0,12,12,35.719356,139.764308,2024-02-08 14:51:04
1277,E4-02.向丘地域活動センター,8,5,13,35.717357,139.757817,2024-02-08 14:51:04
1278,C3-18.明治記念館,4,1,5,35.678509,139.721207,2024-02-08 14:51:04
1279,D5-05.中央図書館,13,2,15,35.705018,139.706841,2024-02-08 14:51:04
1280,E2-07.肥後細川庭園,10,3,13,35.713223,139.721699,2024-02-08 14:51:04
1281,A1-05.富士見出張所,0,3,3,35.699187,139.746348,2024-02-08 14:51:04
1282,E5-07.湯島三丁目児童遊園,3,5,8,35.707296,139.769393,2024-02-08 14:51:04
1283,D5-10.桜美林大学 新宿キャンパス,1,6,7,35.705154,139.697562,2024-02-08 14:51:04
1284,A3-08.神田明神（神田神社）,11,2,13,35.702029,139.768245,2024-02-08 14:51:04
1285,E2-14.永青文庫 ミュージアム,5,0,5,35.713145,139.723342,2024-02-08 14:51:04
1286,M5-17.小田急サザンタワー,8,0,8,35.6866,139.70014,2024-02-08 14:51:04
1287,K1-16.ファミリーマート 矢口二丁目店,4,2,6,35.563092,139.693548,2024-02-08 14:51:04
1288,H1-206.北砂5丁目団地2,0,11,11,35.683866,139.831809,2024-02-08 14:51:04
1289,G1-02.八広駅高架下,4,10,14,35.727495,139.828499,2024-02-08 14:51:04
1290,F4-02.Risingplace浅草四番館,0,4,4,35.717963,139.791025,2024-02-08 14:51:04
1291,H1-204.大島四丁目団地2,4,4,8,35.68832,139.828829,2024-02-08 14:51:04
1292,H1-205.大島四丁目団地3,5,4,9,35.688236,139.827711,2024-02-08 14:51:04
1293,H1-106.亀戸中央公園,11,7,18,35.699874,139.834263,2024-02-08 14:51:04
1294,E5-30.湯島3丁目15,0,12,12,35.705148,139.769314,2024-02-08 14:51:04
1295,B4-38.HARUMI FLAG SUN VILLAGE,0,24,24,35.650347,139.771785,2024-02-08 14:51:04
1296,B4-32.HARUMI FLAG SEA VILLAGE,0,10,10,35.648731,139.774995,2024-02-08 14:51:04
1297,B4-31.HARUMI FLAG PORT VILLAGE,0,19,19,35.650604,139.77724,2024-02-08 14:51:04
1298,B4-33.HARUMI FLAG SEA VILLAGE,0,15,15,35.649552,139.776369,2024-02-08 14:51:04
1299,B4-36.HARUMI FLAG SEA VILLAGE,2,10,12,35.650742,139.778097,2024-02-08 14:51:04
1300,B4-35.HARUMI FLAG SEA VILLAGE,1,11,12,35.650573,139.777908,2024-02-08 14:51:04
1301,B4-37.HARUMI FLAG SUN VILLAGE,0,16,16,35.649419,139.771447,2024-02-08 14:51:04
1302,B4-34.HARUMI FLAG SEA VILLAGE,2,10,12,35.649932,139.776958,2024-02-08 14:51:04
1303,B4-39.HARUMI FLAG SUN VILLAGE,0,17,17,35.650863,139.772549,2024-02-08 14:51:04
1304,B4-40.HARUMI FLAG SUN VILLAGE,0,15,15,35.651305,139.773379,2024-02-08 14:51:04
1305,B4-41.HARUMI FLAG SUN VILLAGE,0,16,16,35.649854,139.77334,2024-02-08 14:51:04
1306,B4-42.HARUMI FLAG SUN VILLAGE,0,12,12,35.649329,139.772656,2024-02-08 14:51:04
1307,B4-28.HARUMI FLAG PORT VILLAGE,4,7,11,35.651183,139.776119,2024-02-08 14:51:04
1308,B4-50.HARUMI FLAG PARK VILLAGE,2,7,9,35.648295,139.773973,2024-02-08 14:51:04
1309,B4-49.HARUMI FLAG PARK VILLAGE,5,11,16,35.648636,139.774251,2024-02-08 14:51:04
1310,B4-48.HARUMI FLAG PARK VILLAGE,0,5,5,35.649513,139.775287,2024-02-08 14:51:04
1311,B4-47.HARUMI FLAG PARK VILLAGE,2,4,6,35.649119,139.775138,2024-02-08 14:51:04
1312,B4-46.HARUMI FLAG PARK VILLAGE,0,28,28,35.649642,139.773859,2024-02-08 14:51:04
1313,B4-45.HARUMI FLAG PARK VILLAGE,0,26,26,35.649002,139.772764,2024-02-08 14:51:04
1314,B4-44.HARUMI FLAG PARK VILLAGE,3,10,13,35.648221,139.772666,2024-02-08 14:51:04
1315,B4-30.HARUMI FLAG PORT VILLAGE,2,9,11,35.651136,139.778218,2024-02-08 14:51:04
1316,B4-29.HARUMI FLAG PORT VILLAGE,0,13,13,35.651907,139.777391,2024-02-08 14:51:04
1317,L1-19.三軒茶屋1丁目駐輪場,1,3,4,35.639302,139.674744,2024-02-08 14:51:04
1318,O7-09.方南月極パーキング,8,9,17,35.678921,139.658289,2024-02-08 14:51:04
1319,O5-10.ローソン ツルハドラッグ杉並和田店,1,3,4,35.68942,139.662118,2024-02-08 14:51:04
1320,O2-04.西荻北1丁目,2,3,5,35.708082,139.607543,2024-02-08 14:51:04
1321,K1-75.三井不動産インダストリアルパーク羽田,6,4,10,35.556231,139.751408,2024-02-08 14:51:04
1322,F1-05.ホウエイコート秋葉原,0,1,1,35.703024,139.78052,2024-02-08 14:51:04
1323,C3-36.第35興和ビル,2,2,4,35.666349,139.741781,2024-02-08 14:51:04
1324,B4-53.晴海五丁目ターミナル,25,81,106,35.651627,139.773103,2024-02-08 14:51:04
1325,C5-44.ブランズタワー芝浦,9,0,9,35.643105,139.753039,2024-02-08 14:51:04
1326,A3-47.ホテルヴィラフォンテーヌ東京大手町,13,0,13,35.690602,139.766916,2024-02-08 14:51:04
1327,A1-20.菱和パレス九段,3,2,5,35.693021,139.740317,2024-02-08 14:51:04
0,E5-26.本郷4丁目,0,5,5,35.708596,139.758269,2024-02-08 11:15:04
1,A3-42.内神田3丁目,30,5,35,35.692599,139.770109,2024-02-08 11:15:04
2,T2-76.東中前の森緑地,3,2,5,35.748736,139.574839,2024-02-08 11:15:04
3,A2-20.神田スクエア,19,0,19,35.693408,139.762809,2024-02-08 11:15:04
4,K1-79.Tマークシティホテル東京大森,3,4,7,35.586993,139.736491,2024-02-08 11:15:04
5,K1-80.大森北6丁目,1,3,4,35.579849,139.731241,2024-02-08 11:15:04
6,H1-130.トヨタモビリティ東京 深川店,2,8,10,35.676643,139.816054,2024-02-08 11:15:04
7,H1-131.セブン-イレブン 江東佐賀2丁目店,0,18,18,35.679029,139.793535,2024-02-08 11:15:04
8,H1-132.セブン-イレブン 江東三好4丁目店,0,35,35,35.681418,139.809287,2024-02-08 11:15:04
9,A6-22.半蔵門PREX South,12,3,15,35.683433,139.740756,2024-02-08 11:15:04
10,I1-74.セブン-イレブン西五反田6丁目店,3,3,6,35.622403,139.71771,2024-02-08 11:15:04
11,G2-01.東京ソラマチ,1,6,7,35.709777,139.810189,2024-02-08 11:15:04
12,T2-59.平成公園,2,1,3,35.722917,139.587864,2024-02-08 11:15:04
13,I1-26.大崎西口公園,8,0,8,35.617475,139.729221,2024-02-08 11:15:04
14,I1-96.西五反田２丁目,10,0,10,35.627599,139.720463,2024-02-08 11:15:04
15,H1-172.サンヨーパシフィックマンション,0,11,11,35.668856,139.794069,2024-02-08 11:15:04
16,J1-56.青葉台四丁目街かど公園,4,0,4,35.654009,139.692727,2024-02-08 11:15:04
17,H1-173.森下駅前,6,31,37,35.687837,139.79654,2024-02-08 11:15:04
18,E3-01.大塚地域活動センター跡地,5,5,10,35.718656,139.734556,2024-02-08 11:15:04
19,E2-03.目白台運動公園,26,15,41,35.715556,139.721988,2024-02-08 11:15:04
20,T2-77.大泉なかよし緑地,3,1,4,35.759861,139.581682,2024-02-08 11:15:04
21,E2-01.江戸川橋Ｂ自転車駐車場,42,39,81,35.710381,139.732137,2024-02-08 11:15:04
22,E2-02.江戸川公園,8,11,19,35.710958,139.731165,2024-02-08 11:15:04
23,D7-14.大栄パーク西落合１丁目,4,2,6,35.720028,139.678936,2024-02-08 11:15:04
24,E1-07.礫川地域活動センター,0,8,8,35.712015,139.750284,2024-02-08 11:15:04
25,M6-05.七号通り公園,0,15,15,35.67917,139.67493,2024-02-08 11:15:04
26,H1-138.HW.HILLS新大橋,1,9,10,35.687416,139.795588,2024-02-08 11:15:04
27,B4-21.月島駅前第一駐輪場,14,20,34,35.663681,139.785651,2024-02-08 11:15:04
28,N2-03.野方1丁目,5,2,7,35.712179,139.65603,2024-02-08 11:15:04
29,C5-52.港南四丁目第3アパート駐車場,7,4,11,35.630109,139.747094,2024-02-08 11:15:04
30,E5-27.真正館駐車場,0,4,4,35.714875,139.76394,2024-02-08 11:15:04
31,C5-35.品川駅港南口,6,0,6,35.62822,139.741135,2024-02-08 11:15:04
32,N2-01.NTT野方ビル,2,3,5,35.710285,139.66173,2024-02-08 11:15:04
33,D6-27.新宿三井ビルディング二号館,8,1,9,35.686334,139.692881,2024-02-08 11:15:04
34,D1-10.曙橋駐輪場,2,14,16,35.691888,139.724365,2024-02-08 11:15:04
35,I1-39.MID POINT 目黒不動前,3,2,5,35.628116,139.713149,2024-02-08 11:15:04
36,E3-07.小日向1丁目,0,20,20,35.713388,139.737009,2024-02-08 11:15:04
37,C1-47.パークプレイス三田,8,1,9,35.641791,139.740734,2024-02-08 11:15:04
38,I1-38.ローソン 八潮三丁目店,25,20,45,35.594544,139.760423,2024-02-08 11:15:04
39,C2-24.Dash Living HigashiAzabu,6,0,6,35.655135,139.744449,2024-02-08 11:15:04
40,J1-04.菅刈公園,6,2,8,35.650351,139.692853,2024-02-08 11:15:04
41,O4-09.ローソン杉並本天沼一丁目店,0,3,3,35.712496,139.632778,2024-02-08 11:15:04
42,T3-29.平和台もものき緑地,1,2,3,35.755773,139.661913,2024-02-08 11:15:04
43,D2-10.市谷砂土原町3丁目,5,7,12,35.696242,139.735776,2024-02-08 11:15:04
44,C1-48.竹芝客船ターミナル,10,5,15,35.655139,139.762812,2024-02-08 11:15:04
45,B1-06.伊場仙ビル,2,3,5,35.687624,139.777125,2024-02-08 11:15:04
46,B2-01.鉄砲洲児童公園（西側）,0,23,23,35.67224,139.779348,2024-02-08 11:15:04
47,B1-04.産業会館,1,4,5,35.694164,139.787057,2024-02-08 11:15:04
48,B1-05.日本橋保健センター,0,13,13,35.687419,139.779053,2024-02-08 11:15:04
49,B2-05.ＮＴＴ東日本築地ビル,0,7,7,35.670674,139.775993,2024-02-08 11:15:04
50,B2-02.柳通り（東京スクエアガーデン前）,12,0,12,35.676393,139.768319,2024-02-08 11:15:04
51,B2-03.男女平等センター（ブーケ21）,8,3,11,35.673923,139.778671,2024-02-08 11:15:04
52,C2-13.麻布運動場,8,0,8,35.651718,139.728165,2024-02-08 11:15:04
53,D2-08.旧市ヶ谷商業高校,0,18,18,35.70074,139.731363,2024-02-08 11:15:04
54,C1-35.セブン-イレブン 三田駅北店,4,1,5,35.649032,139.750147,2024-02-08 11:15:04
55,B4-12.THE TOKYO TOWERS,0,95,95,35.655497,139.774556,2024-02-08 11:15:04
56,C5-21.セブン-イレブン 芝浦3丁目店,4,1,5,35.642399,139.746992,2024-02-08 11:15:04
57,H1-67.セブン-イレブン 江東亀戸9丁目店,1,14,15,35.69766,139.843408,2024-02-08 11:15:04
58,C2-15.住友不動産六本木グランドタワー,0,15,15,35.664367,139.737185,2024-02-08 11:15:04
59,C2-14.元麻布ヒルズ,0,10,10,35.653608,139.73138,2024-02-08 11:15:04
60,M6-14.ドコモショップ笹塚店,0,5,5,35.67323,139.66393,2024-02-08 11:15:04
61,N4-07.南台2丁目,2,10,12,35.68509,139.671102,2024-02-08 11:15:04
62,K1-68.ART FACTORY 城南島,6,2,8,35.580511,139.775957,2024-02-08 11:15:04
63,H1-178.北砂7丁目団地(第二),0,4,4,35.678031,139.837193,2024-02-08 11:15:04
64,H1-179.北砂7丁目団地(第三),3,8,11,35.678246,139.8366,2024-02-08 11:15:04
65,A1-17.雉子橋集積所,6,0,6,35.692605,139.755761,2024-02-08 11:15:04
66,H1-177.北砂7丁目団地(第一),0,13,13,35.678537,139.837391,2024-02-08 11:15:04
67,K1-95.城南島海浜公園,11,5,16,35.578259,139.783505,2024-02-08 11:15:04
68,B3-17.銀座6丁目-SQUARE,7,0,7,35.66711,139.76643,2024-02-08 11:15:04
69,J1-33.芳窪街かど公園,12,1,13,35.629861,139.666293,2024-02-08 11:15:04
70,N3-07.なかのZERO,1,4,5,35.70442,139.67141,2024-02-08 11:15:04
71,N4-04.弥生町5丁目,3,9,12,35.690897,139.668345,2024-02-08 11:15:04
72,A3-44.THE WAVES AKIHABARA,0,7,7,35.694679,139.779504,2024-02-08 11:15:04
73,K1-138.羽田エアポートガーデン,6,3,9,35.544534,139.763244,2024-02-08 11:15:04
74,C3-26.ホテルリブマックス赤坂,5,0,5,35.67011,139.733375,2024-02-08 11:15:04
75,C1-52.NTT三田ビル,4,2,6,35.652549,139.747789,2024-02-08 11:15:04
76,D1-07.Dash Living Shinjuku,4,0,4,35.689757,139.710091,2024-02-08 11:15:04
77,O4-07.ローソン成田西三丁目店,0,5,5,35.690311,139.62178,2024-02-08 11:15:04
78,H1-152.コンポジット亀戸ウエスト,0,9,9,35.699187,139.82429,2024-02-08 11:15:04
79,E1-13.エルアージュ小石川,0,37,37,35.71399,139.75137,2024-02-08 11:15:04
80,B4-22.リビオレゾン勝どきNEX,0,62,62,35.65554,139.77102,2024-02-08 11:15:04
81,H1-176.JMFビル東陽町02,4,2,6,35.667677,139.823552,2024-02-08 11:15:04
82,H1-102.ファミリーマート東砂七丁目店,0,17,17,35.672714,139.837914,2024-02-08 11:15:04
83,H1-101.ファミリーマート新木場一丁目店,5,1,6,35.642571,139.836766,2024-02-08 11:15:04
84,K1-67.京浜島防災広場,0,15,15,35.570508,139.764013,2024-02-08 11:15:04
85,K1-66.昭和島二丁目公園,0,12,12,35.575097,139.751446,2024-02-08 11:15:04
86,I1-80.リバーサイド品川港南ビル,4,6,10,35.622714,139.74471,2024-02-08 11:15:04
87,J1-10.NTTデータ駒場研修センター,5,6,11,35.655779,139.680948,2024-02-08 11:15:04
88,A2-17.竹橋ビル,8,0,8,35.692396,139.75639,2024-02-08 11:15:04
89,H1-91.亀戸駅北口第三自転車駐車場,13,5,18,35.696913,139.823911,2024-02-08 11:15:04
90,H1-92.亀戸駅東口第二自転車駐車場,8,7,15,35.69788,139.830559,2024-02-08 11:15:04
91,K1-59.京急梅屋敷第1駐車場,7,0,7,35.565768,139.727396,2024-02-08 11:15:04
92,K1-60.京急平和島第1駐車場,1,9,10,35.576336,139.733691,2024-02-08 11:15:04
93,I1-42.京急青横駐車場,3,0,3,35.611582,139.742528,2024-02-08 11:15:04
94,I1-43.京急南大井駐車場,0,9,9,35.594722,139.737101,2024-02-08 11:15:04
95,O7-05.ジーベック方南町,1,1,2,35.680849,139.65626,2024-02-08 11:15:04
96,H1-100.URアーバンライフ亀戸,21,8,29,35.697935,139.821855,2024-02-08 11:15:04
97,A6-10.紀尾井町ビル（西側）,9,3,12,35.682516,139.736494,2024-02-08 11:15:04
98,C3-02.赤坂地区総合支所,0,7,7,35.674788,139.731423,2024-02-08 11:15:04
99,C2-08.ファミリーマート西麻布霞町店,0,10,10,35.661673,139.721118,2024-02-08 11:15:04
100,A6-09.紀尾井町ビル（北側）,6,0,6,35.682902,139.736494,2024-02-08 11:15:04
101,H1-28.有明客船ターミナル,10,1,11,35.630063,139.792209,2024-02-08 11:15:04
102,B1-12.ファミリーマート堀留町二丁目店,0,8,8,35.687786,139.78205,2024-02-08 11:15:04
103,H1-26.青海客船ターミナル,15,0,15,35.619234,139.774485,2024-02-08 11:15:04
104,H1-27.パレットタウン乗船場,10,0,10,35.624467,139.781305,2024-02-08 11:15:04
105,O1-04.井草1-34,8,7,15,35.72758,139.62432,2024-02-08 11:15:04
106,C1-76.浜松町駅北口交通広場(ハマサイト前),16,0,16,35.656647,139.758301,2024-02-08 11:15:04
107,J1-52.駒沢一丁目公園前,7,2,9,35.629807,139.662398,2024-02-08 11:15:04
108,C1-75.虎ノ門PFビル,5,2,7,35.665466,139.748014,2024-02-08 11:15:04
109,B2-18.旭ビルディング,11,0,11,35.678291,139.78157,2024-02-08 11:15:04
110,N2-09.松山駐車場No.1,3,3,6,35.722991,139.673048,2024-02-08 11:15:04
111,I1-82.トミンハイム西五反田四丁目,3,3,6,35.627386,139.711182,2024-02-08 11:15:04
112,O4-03.ザ・ハウス,0,12,12,35.707035,139.633066,2024-02-08 11:15:04
113,O4-04.阿佐谷南3-43,14,2,16,35.704147,139.631955,2024-02-08 11:15:04
114,K1-83.北千束北児童公園,5,1,6,35.611085,139.68599,2024-02-08 11:15:04
115,I1-95.東京レールゲート EAST,7,3,10,35.584998,139.761055,2024-02-08 11:15:04
116,M5-19.グランリヴィエール代々木,2,3,5,35.68285,139.698528,2024-02-08 11:15:04
117,H1-192.ウエリスアーバン水天宮前,3,1,4,35.678296,139.791949,2024-02-08 11:15:04
118,N2-08.江古田区民活動センター,3,1,4,35.728893,139.670119,2024-02-08 11:15:04
119,D7-04.セブン-イレブン 新宿下落合3丁目店,1,2,3,35.722645,139.701982,2024-02-08 11:15:04
120,K1-82.西蒲田公園,6,1,7,35.561499,139.71123,2024-02-08 11:15:04
121,H1-68.芝浦工業大学附属中学高等学校,0,36,36,35.649274,139.792213,2024-02-08 11:15:04
122,K1-24.東糀谷防災公園,1,15,16,35.557074,139.74575,2024-02-08 11:15:04
123,H1-03.東雲駅,13,2,15,35.640736,139.804331,2024-02-08 11:15:04
124,K1-26.大森諏訪公園,0,15,15,35.574785,139.730762,2024-02-08 11:15:04
125,K1-25.鶴渡公園,2,1,3,35.56892,139.725082,2024-02-08 11:15:04
126,N3-10.エーエスホームズⅡ駐車場,6,0,6,35.702659,139.662563,2024-02-08 11:15:04
127,J1-37.中目黒公園,11,7,18,35.640398,139.704069,2024-02-08 11:15:04
128,A1-10.ヒューリック九段ビル,6,0,6,35.696449,139.750784,2024-02-08 11:15:04
129,K1-93.六間堀仲羽公園,2,2,4,35.548864,139.74484,2024-02-08 11:15:04
130,T2-53.上練馬公園,2,2,4,35.772863,139.626969,2024-02-08 11:15:04
131,M5-01.初台駅南口,0,12,12,35.680154,139.685937,2024-02-08 11:15:04
132,C1-60.専売ビル,10,4,14,35.647659,139.745055,2024-02-08 11:15:04
133,K1-85.大田区青少年交流センター ゆいっつ,3,1,4,35.583555,139.743381,2024-02-08 11:15:04
134,I1-64.株式会社ユアス ゆうパック取扱所：ポストのうしろ,9,1,10,35.622965,139.731014,2024-02-08 11:15:04
135,C4-09.ケーヨーデイツー三田店,0,6,6,35.646375,139.740061,2024-02-08 11:15:04
136,C1-61.環三浜松町駅南,23,15,38,35.653096,139.75739,2024-02-08 11:15:04
137,K1-84.佐伯山緑地,0,13,13,35.581698,139.71491,2024-02-08 11:15:04
138,C1-59.セレスティン芝三井ビルディング,5,8,13,35.650845,139.748346,2024-02-08 11:15:04
139,G2-07.レオーネ押上cube,2,2,4,35.706167,139.815955,2024-02-08 11:15:04
140,E1-06.文京シビックセンター,10,10,20,35.708265,139.751983,2024-02-08 11:15:04
141,D2-13.THE CENTER TOKYO,0,23,23,35.695646,139.725722,2024-02-08 11:15:04
142,E5-22.千駄木2丁目,2,4,6,35.724828,139.762583,2024-02-08 11:15:04
143,C4-07.品川プリンスホテル,9,1,10,35.628266,139.734171,2024-02-08 11:15:04
144,A3-43.unito CHIYODA,1,2,3,35.69474,139.77929,2024-02-08 11:15:04
145,C4-06.白金プラチナレジデンス,0,21,21,35.644134,139.723432,2024-02-08 11:15:04
146,I1-63.セブン-イレブン西五反田店,3,0,3,35.62765,139.719212,2024-02-08 11:15:04
147,H1-53.豊洲シビックセンター,18,0,18,35.653991,139.795513,2024-02-08 11:15:04
148,T3-16.練馬区役所東庁舎(第一),9,1,10,35.735428,139.652379,2024-02-08 11:15:04
149,T2-68.さくら原っぱ緑地,2,3,5,35.731372,139.619164,2024-02-08 11:15:04
150,T2-69.久保新田さくら公園,0,4,4,35.76525,139.575978,2024-02-08 11:15:04
151,H1-187.森下文化センター,0,5,5,35.685344,139.80234,2024-02-08 11:15:04
152,E4-04.セブン-イレブン 文京本駒込１丁目店,0,5,5,35.724707,139.750469,2024-02-08 11:15:04
153,M2-13.恵比寿プライムスクエアタワー南,8,0,8,35.649257,139.713272,2024-02-08 11:15:04
154,H1-48.セブン-イレブン 江東潮見２丁目店,0,7,7,35.658249,139.815775,2024-02-08 11:15:04
155,H1-51.豊洲交通広場　東,26,0,26,35.654958,139.795718,2024-02-08 11:15:04
156,H1-52.辰巳駅,14,1,15,35.646756,139.809295,2024-02-08 11:15:04
157,D7-01.下落合図書館,5,11,16,35.715894,139.698578,2024-02-08 11:15:04
158,H1-50.豊洲交通広場　北,11,0,11,35.655457,139.795161,2024-02-08 11:15:04
159,A6-14.MG市ヶ谷ビルディング,1,1,2,35.690861,139.736393,2024-02-08 11:15:04
160,T2-21.ファミリーマート 練馬大泉町一丁目店,1,3,4,35.768448,139.601679,2024-02-08 11:15:04
161,A6-15.東急番町ビル,3,2,5,35.688929,139.7358,2024-02-08 11:15:04
162,A1-18.東京区政会館別館(特別区研修所),3,0,3,35.696202,139.752351,2024-02-08 11:15:04
163,T3-18.練馬駅北,10,9,19,35.738585,139.653396,2024-02-08 11:15:04
164,C1-43.KDX浜松町プレイス,3,3,6,35.658169,139.752509,2024-02-08 11:15:04
165,C5-27.プレミア海岸ビル,9,12,21,35.648948,139.757895,2024-02-08 11:15:04
166,I1-29.ローソン 勝島一丁目店,0,21,21,35.599987,139.745195,2024-02-08 11:15:04
167,H1-72.ネクストサイト深川ビル,20,1,21,35.674578,139.797396,2024-02-08 11:15:04
168,T1-11.むつみ台,0,3,3,35.768528,139.639807,2024-02-08 11:15:04
169,T1-10.月見大橋下,5,0,5,35.758366,139.628982,2024-02-08 11:15:04
170,H1-167.大島八丁目公園,1,9,10,35.688074,139.838932,2024-02-08 11:15:04
171,K1-36.セブン-イレブン 大田区南雪谷5丁目店,0,12,12,35.587815,139.691748,2024-02-08 11:15:04
172,L1-01.羽根木公園,5,8,13,35.66088,139.654546,2024-02-08 11:15:04
173,P1-02.雑司ヶ谷一丁目,8,0,8,35.721738,139.723103,2024-02-08 11:15:04
174,I1-66.南大井文化センター駐車場,2,4,6,35.596733,139.73804,2024-02-08 11:15:04
175,L1-05.NTT烏山ビル,1,2,3,35.669285,139.597931,2024-02-08 11:15:04
176,L1-04.下馬中央公園,0,5,5,35.63367,139.678139,2024-02-08 11:15:04
177,L1-03.世田谷城阯公園,0,6,6,35.645838,139.647799,2024-02-08 11:15:04
178,L1-02.若林公園,5,2,7,35.647075,139.654472,2024-02-08 11:15:04
179,T2-30.ファミリーマート 練馬東大泉四丁目店,4,0,4,35.750804,139.58243,2024-02-08 11:15:04
180,L1-07.NTT成城ビル,2,1,3,35.648021,139.606529,2024-02-08 11:15:04
181,L1-06.NTT瀬田ビル,0,12,12,35.618357,139.626191,2024-02-08 11:15:04
182,T3-12.春日町西公園,3,1,4,35.748092,139.636587,2024-02-08 11:15:04
183,T3-13.平和台児童公園,2,2,4,35.757298,139.664139,2024-02-08 11:15:04
184,T2-38.ファミリーマート 練馬上石神井四丁目店,7,2,9,35.727195,139.590179,2024-02-08 11:15:04
185,B1-28.アイルイムーブル日本橋,8,1,9,35.684502,139.77906,2024-02-08 11:15:04
186,A2-28.NTTコミュニケーションズ一ツ橋ビル駐車場,8,0,8,35.6915,139.75685,2024-02-08 11:15:04
187,C3-32.乃木公園,3,1,4,35.667936,139.72745,2024-02-08 11:15:04
188,T3-14.わらべ児童遊園,3,1,4,35.759774,139.654529,2024-02-08 11:15:04
189,T2-52.田柄中央児童公園,2,3,5,35.762395,139.641522,2024-02-08 11:15:04
190,M4-06.THE SHARE 原宿,9,0,9,35.671823,139.708158,2024-02-08 11:15:04
191,K1-10.セブン‐イレブン 大田区西糀谷１丁目店,1,3,4,35.559647,139.730098,2024-02-08 11:15:04
192,K1-09.セブン‐イレブン 大田区西蒲田２丁目店,0,22,22,35.570763,139.705895,2024-02-08 11:15:04
193,H1-63.東京スイソミル,0,15,15,35.65637,139.811765,2024-02-08 11:15:04
194,B1-16.小網町児童遊園,6,0,6,35.683695,139.780043,2024-02-08 11:15:04
195,H1-61.Brilliaランニングスタジアムマギーズ東京前,7,2,9,35.648281,139.786112,2024-02-08 11:15:04
196,K1-08.セブン‐イレブン 大田区東蒲田キネマ通り店,0,6,6,35.562368,139.730143,2024-02-08 11:15:04
197,C1-34.城山ガーデン,8,0,8,35.664479,139.743731,2024-02-08 11:15:04
198,H1-62.扇橋一丁目公園南,0,42,42,35.683343,139.812161,2024-02-08 11:15:04
199,J1-23.清水池公園,10,13,23,35.623756,139.692517,2024-02-08 11:15:04
200,C5-18.パークタワー品川ベイワード,8,11,19,35.634529,139.748378,2024-02-08 11:15:04
201,E4-07.ファミリーマート 本駒込二丁目店,3,1,4,35.727279,139.74627,2024-02-08 11:15:04
202,C5-45.パークアクシス芝浦キャナル,1,8,9,35.644794,139.755688,2024-02-08 11:15:04
203,A2-02.西神田公園（北側）,7,2,9,35.698591,139.755113,2024-02-08 11:15:04
204,T2-49.善福寺公園テニスクラブ,5,4,9,35.719674,139.593696,2024-02-08 11:15:04
205,H1-193.ライフ豊洲店,27,1,28,35.651833,139.79962,2024-02-08 11:15:04
206,A2-01.神田駿河台下,52,1,53,35.695762,139.761585,2024-02-08 11:15:04
207,I1-51.京急鈴ヶ森駐車場,0,14,14,35.589573,139.735585,2024-02-08 11:15:04
208,T2-36.サントピア テニスパーク,4,6,10,35.75195,139.616028,2024-02-08 11:15:04
209,G4-13. Parking in 両国駅前第2,0,3,3,35.696492,139.791591,2024-02-08 11:15:04
210,K1-120.蒲田駅消費者生活センター横自転車駐車場 屋上部,6,0,6,35.560125,139.71569,2024-02-08 11:15:04
211,N3-18.藤和シティコープ新中野3,5,1,6,35.69942,139.673964,2024-02-08 11:15:04
212,K1-145.トヨタモビリティ東京馬込テクニカル研修センター,6,7,13,35.58209,139.701362,2024-02-08 11:15:04
213,K1-100.多摩川台公園,5,0,5,35.589794,139.666955,2024-02-08 11:15:04
214,C1-54.ニッセイ虎ノ門ビル,12,0,12,35.664344,139.746662,2024-02-08 11:15:04
215,I1-52.カスタリアタワー品川シーサイド,6,4,10,35.607557,139.746866,2024-02-08 11:15:04
216,I1-53.天王洲公園,3,1,4,35.620355,139.749339,2024-02-08 11:15:04
217,C2-18.ブランシェ東麻布,0,3,3,35.656769,139.743224,2024-02-08 11:15:04
218,A3-45.鍛冶町2丁目,12,6,18,35.691578,139.77138,2024-02-08 11:15:04
219,H1-87.パークアクシス木場キャナルウエスト,0,26,26,35.662514,139.803694,2024-02-08 11:15:04
220,D6-20.淀橋けやき橋公園,5,10,15,35.693544,139.685806,2024-02-08 11:15:04
221,A3-46.神田須田町2丁目,0,1,1,35.695457,139.772972,2024-02-08 11:15:04
222,B3-13.国立がん研究センター,11,0,11,35.664871,139.767188,2024-02-08 11:15:04
223,I1-35.シーフォートスクエア,18,0,18,35.622954,139.750593,2024-02-08 11:15:04
224,K1-55.カバヤビル,5,13,18,35.576275,139.713704,2024-02-08 11:15:04
225,C3-24.SHARE GREEN 南青山 西エントランス,0,7,7,35.668419,139.724676,2024-02-08 11:15:04
226,A5-06.APA HOTEL PRIDE〈国会議事堂前〉,10,0,10,35.674468,139.741328,2024-02-08 11:15:04
227,A6-17.東京ガーデンテラス紀尾井町（プリンス通り側）,12,0,12,35.680431,139.738203,2024-02-08 11:15:04
228,B4-07.勝どき駅地下駐輪場,58,3,61,35.658135,139.776131,2024-02-08 11:15:04
229,B4-08.東京ミッドベイ勝どき（西仲通り）,2,16,18,35.656449,139.771302,2024-02-08 11:15:04
230,B3-04.築地市場駅地下駐輪場,17,0,17,35.664265,139.767426,2024-02-08 11:15:04
231,C5-10.シーバンス,11,3,14,35.649959,139.756068,2024-02-08 11:15:04
232,H1-34.門前仲町駅,47,5,52,35.67391,139.796165,2024-02-08 11:15:04
233,C3-10.ファミリーマート特許庁前店,1,5,6,35.670364,139.744684,2024-02-08 11:15:04
234,A1-01.千代田区役所,6,0,6,35.693799,139.753281,2024-02-08 11:15:04
235,A1-03.東京区政会館（メトロA5出口）,7,0,7,35.701073,139.747525,2024-02-08 11:15:04
236,B3-06.朝日新聞東京本社,4,0,4,35.664457,139.767214,2024-02-08 11:15:04
237,A1-04.東京区政会館（西側駐輪場）,7,0,7,35.701347,139.746951,2024-02-08 11:15:04
238,T1-03.四季の香公園,5,0,5,35.760585,139.626284,2024-02-08 11:15:04
239,T1-04.春の風公園,3,0,3,35.75731,139.624922,2024-02-08 11:15:04
240,T1-05.夏の雲公園,5,0,5,35.753964,139.629116,2024-02-08 11:15:04
241,H1-194.セブン-イレブン江東北砂5丁目店,0,5,5,35.68268,139.8353,2024-02-08 11:15:04
242,O5-03.新高円寺地下自転車駐輪場,5,7,12,35.697265,139.649397,2024-02-08 11:15:04
243,O3-06.アミーズ荻窪,3,1,4,35.714616,139.625116,2024-02-08 11:15:04
244,T2-03.リヴィンオズ大泉店,7,1,8,35.752383,139.594855,2024-02-08 11:15:04
245,O6-06.上高井戸1丁目,0,7,7,35.673055,139.611293,2024-02-08 11:15:04
246,T2-05.石神井図書館,3,1,4,35.736076,139.599676,2024-02-08 11:15:04
247,T2-06.総合体育館,2,1,3,35.748957,139.621385,2024-02-08 11:15:04
248,O5-02.馬橋ハイツ,4,2,6,35.705686,139.642587,2024-02-08 11:15:04
249,N1-07.プランドール上鷺宮,2,5,7,35.733292,139.630369,2024-02-08 11:15:04
250,E1-18.アーバネックス小石川春日,0,8,8,35.709261,139.746374,2024-02-08 11:15:04
251,T3-03.新桜台駅自転車駐車場,4,3,7,35.740378,139.667502,2024-02-08 11:15:04
252,O3-05.Nちゃりパーク,18,4,22,35.70389,139.6185,2024-02-08 11:15:04
253,O5-01.朝霞ハイツ,7,4,11,35.71038,139.64519,2024-02-08 11:15:04
254,L1-11.アイムタウン上祖師谷,2,1,3,35.656849,139.594422,2024-02-08 11:15:04
255,L1-12.鈴木リースホーム駐車場,12,2,14,35.646648,139.633038,2024-02-08 11:15:04
256,L1-13.わびさびホステル,1,3,4,35.647393,139.667085,2024-02-08 11:15:04
257,G2-05.リアナスカイパーク押上,5,1,6,35.715733,139.815451,2024-02-08 11:15:04
258,T3-02.早宮第二自転車駐車場,9,2,11,35.756846,139.652154,2024-02-08 11:15:04
259,I1-37.ガーデンシティ品川御殿山,6,3,9,35.623466,139.734359,2024-02-08 11:15:04
260,T2-47.上石神井駅北第二自転車駐車場,7,3,10,35.726523,139.5905,2024-02-08 11:15:04
261,C1-51.環二新橋四丁目,9,3,12,35.663843,139.757697,2024-02-08 11:15:04
262,M6-07.笹塚東,13,8,21,35.675436,139.670594,2024-02-08 11:15:04
263,M3-10.ウノサワ東急ビル,8,0,8,35.647757,139.712981,2024-02-08 11:15:04
264,C2-26.一の橋公園,6,1,7,35.655367,139.738075,2024-02-08 11:15:04
265,H1-14.ホテルリブマックス東京潮見駅前,4,1,5,35.658351,139.818229,2024-02-08 11:15:04
266,D2-12.ヴィアイン飯田橋後楽園,0,12,12,35.705774,139.743366,2024-02-08 11:15:04
267,D3-08.ホテルリブマックス高田馬場駅前,8,0,8,35.712952,139.701356,2024-02-08 11:15:04
268,H1-103.清澄庭園,4,6,10,35.680948,139.796917,2024-02-08 11:15:04
269,H1-104.木場公園,0,18,18,35.676488,139.809616,2024-02-08 11:15:04
270,H1-105.猿江恩賜公園,8,0,8,35.692277,139.817491,2024-02-08 11:15:04
271,G4-07.ディアレイシャス両国,0,4,4,35.69955,139.803204,2024-02-08 11:15:04
272,T2-46.大泉郵便局バス停自転車駐車場,0,9,9,35.766491,139.587232,2024-02-08 11:15:04
273,I1-18.東品川公園,3,4,7,35.61379,139.746617,2024-02-08 11:15:04
274,J1-03.西郷山公園,5,1,6,35.650688,139.696696,2024-02-08 11:15:04
275,J1-02.駒場野公園,10,4,14,35.657718,139.681043,2024-02-08 11:15:04
276,D2-14.ローソン 神楽坂駅北店,0,15,15,35.704201,139.735815,2024-02-08 11:15:04
277,K1-65.下丸子3丁目,7,5,12,35.571711,139.685337,2024-02-08 11:15:04
278,T2-43.学園通り自転車駐車場,8,0,8,35.7547,139.5871,2024-02-08 11:15:04
279,I1-46.セブン-イレブン 品川東中延2丁目店,0,5,5,35.608721,139.714158,2024-02-08 11:15:04
280,T2-04.石神井公園駅南口,13,0,13,35.743354,139.606592,2024-02-08 11:15:04
281,J1-06.観音橋自転車置場,34,11,45,35.642251,139.69692,2024-02-08 11:15:04
282,J1-05.東山公園　北,0,13,13,35.64853,139.686309,2024-02-08 11:15:04
283,J1-45.プラウド中目黒,0,3,3,35.63767,139.7045,2024-02-08 11:15:04
284,H1-168.大島五丁目公園,11,2,13,35.68642,139.836151,2024-02-08 11:15:04
285,J1-47.本町みなみ街かど公園,4,13,17,35.61847,139.70019,2024-02-08 11:15:04
286,J1-48.グランドエクセル祐天寺,0,19,19,35.64372,139.68777,2024-02-08 11:15:04
287,K1-101.小池公園,0,5,5,35.599541,139.697962,2024-02-08 11:15:04
288,H1-171.LOGI’Q南砂町,6,3,9,35.672877,139.842339,2024-02-08 11:15:04
289,H1-153.三井リンクラボ新木場1,9,1,10,35.63851,139.823534,2024-02-08 11:15:04
290,H1-154.やぐら橋下,20,0,20,35.631132,139.792726,2024-02-08 11:15:04
291,D5-11.NTTコミュニケーションズ新宿ビル,4,5,9,35.699312,139.696468,2024-02-08 11:15:04
292,C5-31.ヒルトン東京お台場,3,7,10,35.626267,139.771438,2024-02-08 11:15:04
293,K1-78.城南鋳物団地協同組合,0,10,10,35.567562,139.766854,2024-02-08 11:15:04
294,I1-68.八潮公園第二,0,9,9,35.600003,139.754288,2024-02-08 11:15:04
295,I1-67.八潮公園第一,0,11,11,35.601149,139.754284,2024-02-08 11:15:04
296,H1-123.ダイワロイネットホテル東京有明,19,2,21,35.634316,139.793199,2024-02-08 11:15:04
297,J1-24.ボヌールREIWA,4,1,5,35.612389,139.676238,2024-02-08 11:15:04
298,B2-12.東京ダイヤビルディング（東側）,16,2,18,35.674835,139.785656,2024-02-08 11:15:04
299,J1-15.二の橋自転車置場2,14,2,16,35.614391,139.678396,2024-02-08 11:15:04
300,H1-77.ライフ東砂店,0,9,9,35.684641,139.844243,2024-02-08 11:15:04
301,D1-09.NTT四谷ビル,1,2,3,35.691188,139.712079,2024-02-08 11:15:04
302,E4-11.プライマル千石,0,12,12,35.727519,139.742815,2024-02-08 11:15:04
303,I1-23.東海橋防災船着場,0,15,15,35.616114,139.74033,2024-02-08 11:15:04
304,A4-12.東京ミッドタウン日比谷,4,0,4,35.674274,139.759111,2024-02-08 11:15:04
305,K1-46.池上駅前自転車駐車場,5,7,12,35.571478,139.702779,2024-02-08 11:15:04
306,I1-24.しながわ区民公園(中央口),3,11,14,35.593611,139.738056,2024-02-08 11:15:04
307,T2-13.セブン-イレブン 練馬石神井町8丁目店,0,5,5,35.750414,139.600011,2024-02-08 11:15:04
308,O3-04.アヴァンセ阿佐ヶ谷,2,0,2,35.712,139.62816,2024-02-08 11:15:04
309,B4-01.黎明橋公園（駐輪場）,3,9,12,35.656071,139.780068,2024-02-08 11:15:04
310,T2-32.セブン-イレブン 練馬東大泉NTTビル店,3,5,8,35.750761,139.594457,2024-02-08 11:15:04
311,K1-142.コーラル洗足池,9,1,10,35.604567,139.689096,2024-02-08 11:15:04
312,K1-28.鵜の木特別出張所,4,0,4,35.574886,139.685122,2024-02-08 11:15:04
313,T1-02.ホテルカデンツァ東京,12,0,12,35.755106,139.621675,2024-02-08 11:15:04
314,C2-16.ザ・ベルグレイヴィア麻布,0,8,8,35.657264,139.743821,2024-02-08 11:15:04
315,N3-11.上高田区民活動センター,3,2,5,35.711501,139.672761,2024-02-08 11:15:04
316,T3-30.北西大松公園,2,2,4,35.765979,139.64931,2024-02-08 11:15:04
317,D6-05.新宿中央公園（水の広場）,5,1,6,35.690474,139.690219,2024-02-08 11:15:04
318,D6-07.新宿フロントタワー,3,6,9,35.696387,139.689924,2024-02-08 11:15:04
319,T2-73.早実グラウンド記念公園,3,1,4,35.734615,139.576214,2024-02-08 11:15:04
320,O7-03.永福町西幸モータープール東,3,8,11,35.67156,139.64609,2024-02-08 11:15:04
321,D1-03.新左門児童遊園,0,5,5,35.684523,139.720519,2024-02-08 11:15:04
322,D1-04.四谷見附公園,0,30,30,35.683448,139.728425,2024-02-08 11:15:04
323,I1-54.天王洲オーシャンスクエア,12,3,15,35.622356,139.749468,2024-02-08 11:15:04
324,D6-01.新宿区役所本庁舎,45,2,47,35.693602,139.703229,2024-02-08 11:15:04
325,D6-02.新宿区役所第二分庁舎,34,1,35,35.693976,139.706134,2024-02-08 11:15:04
326,D6-03.新宿中央公園（ポケットパーク）,9,0,9,35.691559,139.690029,2024-02-08 11:15:04
327,D6-04.新宿中央公園（ちびっこ広場）,8,2,10,35.686649,139.689821,2024-02-08 11:15:04
328,A6-21.日本工営ビル,2,2,4,35.684584,139.734442,2024-02-08 11:15:04
329,I1-77.セブン-イレブン品川西中延1丁目店,0,20,20,35.612217,139.708164,2024-02-08 11:15:04
330,T1-01.光が丘駅前広場,11,2,13,35.759164,139.629466,2024-02-08 11:15:04
331,T2-37.上石神井2丁目,2,6,8,35.729615,139.59532,2024-02-08 11:15:04
332,I1-75.セブン-イレブン品川二葉4丁目店,0,6,6,35.603275,139.713428,2024-02-08 11:15:04
333,M5-13.セブン-イレブン初台店,0,15,15,35.675049,139.68444,2024-02-08 11:15:04
334,D6-24.ＮＴＴ東日本 本社ビル,10,2,12,35.683102,139.688852,2024-02-08 11:15:04
335,H1-134.豊洲ぐるり公園,10,12,22,35.643141,139.777821,2024-02-08 11:15:04
336,H1-133.北砂2丁目公園,0,27,27,35.679001,139.825809,2024-02-08 11:15:04
337,E3-08.サガラマンション,0,4,4,35.722833,139.734662,2024-02-08 11:15:04
338,O4-05.阿佐ヶ谷南1-30,1,2,3,35.700703,139.639985,2024-02-08 11:15:04
339,O5-06.EXAM高円寺南,5,0,5,35.70273,139.65864,2024-02-08 11:15:04
340,G2-03.押上１丁目２６-４,5,0,5,35.710323,139.815215,2024-02-08 11:15:04
341,K1-132.多摩川駅前自転車等駐車場,15,0,15,35.587232,139.669519,2024-02-08 11:15:04
342,C5-47.oak港南品川,23,2,25,35.62413,139.744831,2024-02-08 11:15:04
343,D3-15.カースルいずみ,6,7,13,35.711324,139.711976,2024-02-08 11:15:04
344,C5-15.セブン-イレブン 港区芝浦ふ頭店,0,7,7,35.640215,139.755971,2024-02-08 11:15:04
345,C5-14.セブン-イレブン 港区汐彩橋店,0,13,13,35.640481,139.753659,2024-02-08 11:15:04
346,D5-01.新宿コズミックセンター,0,8,8,35.705244,139.70841,2024-02-08 11:15:04
347,H1-45.夢の島競技場,18,2,20,35.648596,139.824936,2024-02-08 11:15:04
348,E1-01.後楽橋横,25,0,25,35.702746,139.752009,2024-02-08 11:15:04
349,B1-15.ロイヤルパークホテル,0,11,11,35.682332,139.78722,2024-02-08 11:15:04
350,C4-05.白金台駅自転車駐車場,5,10,15,35.638927,139.727083,2024-02-08 11:15:04
351,E1-02.東京ドーム（ミーツポート）,7,2,9,35.70311,139.754951,2024-02-08 11:15:04
352,M2-06.あいおいニッセイ同和損保恵比寿ビル,7,0,7,35.647237,139.71512,2024-02-08 11:15:04
353,J1-12.工大橋下流自転車置場,3,1,4,35.605828,139.680265,2024-02-08 11:15:04
354,C5-25.NEX-TEC芝浦,37,1,38,35.639571,139.755551,2024-02-08 11:15:04
355,H1-175.ダイアパレス大島駅前,0,2,2,35.689543,139.836394,2024-02-08 11:15:04
356,C1-65.東京ポートシティ竹芝,10,3,13,35.654757,139.761516,2024-02-08 11:15:04
357,O2-03.西荻北5-8-17,4,1,5,35.709712,139.601846,2024-02-08 11:15:04
358,B2-21.八重洲二丁目北地区広場,4,0,4,35.67942,139.77004,2024-02-08 11:15:04
359,I1-101.下神明駅前,24,0,24,35.60838,139.726587,2024-02-08 11:15:04
360,N2-04.野方2丁目,6,0,6,35.713018,139.656768,2024-02-08 11:15:04
361,N2-05.野方3丁目,0,12,12,35.717877,139.654732,2024-02-08 11:15:04
362,K1-88.大田久が原西郵便局,0,6,6,35.582756,139.6925,2024-02-08 11:15:04
363,C5-51.トミンタワー台場一番街,0,12,12,35.634627,139.77663,2024-02-08 11:15:04
364,C4-10.亀塚公園,10,0,10,35.642764,139.741174,2024-02-08 11:15:04
365,H1-190.福山通運 東京支店,0,28,28,35.664845,139.796643,2024-02-08 11:15:04
366,C1-80.浜松町262ビル,11,1,12,35.654289,139.75557,2024-02-08 11:15:04
367,B2-19.リエトコートアルクスタワー,0,10,10,35.670506,139.77854,2024-02-08 11:15:04
368,C1-79.髙松コンストラクショングループ 東京本社ビル,0,6,6,35.648765,139.753363,2024-02-08 11:15:04
369,C5-43.オアーゼ芝浦MJビル,7,2,9,35.644798,139.752697,2024-02-08 11:15:04
370,J1-44.五本木2丁目,1,7,8,35.634441,139.687186,2024-02-08 11:15:04
371,B2-17.アーバネックス八丁堀,3,0,3,35.67518,139.77364,2024-02-08 11:15:04
372,M6-16.パールマンション,2,0,2,35.67464,139.67876,2024-02-08 11:15:04
373,G4-06.ドムス・スタイル両国,0,7,7,35.700453,139.798978,2024-02-08 11:15:04
374,G2-04.ラ　ステュディオ押上,3,2,5,35.712157,139.815298,2024-02-08 11:15:04
375,T3-15.セブン-イレブン練馬北町8丁目店,6,0,6,35.768105,139.646049,2024-02-08 11:15:04
376,C1-77.芝公園,13,5,18,35.65513,139.749645,2024-02-08 11:15:04
377,I1-27.小関橋公園,3,1,4,35.620699,139.730904,2024-02-08 11:15:04
378,B3-01.中央区役所,0,5,5,35.670855,139.772052,2024-02-08 11:15:04
379,A6-08.二番町ガーデン,5,0,5,35.685489,139.734562,2024-02-08 11:15:04
380,B1-01.十思公園,0,10,10,35.691058,139.777915,2024-02-08 11:15:04
381,B4-02.月島特別出張所,0,42,42,35.662197,139.782719,2024-02-08 11:15:04
382,A4-05.大手町タワー,18,0,18,35.685938,139.764886,2024-02-08 11:15:04
383,H1-22.豊洲市場（7街区）,37,33,70,35.6447,139.784512,2024-02-08 11:15:04
384,A6-07.二番町センタービル,0,2,2,35.685966,139.736328,2024-02-08 11:15:04
385,A2-12.神保町三井ビルディング,10,0,10,35.694532,139.760695,2024-02-08 11:15:04
386,E2-06.oto no ha Cafe,0,4,4,35.713991,139.725665,2024-02-08 11:15:04
387,B4-10.リバーシティ,0,15,15,35.668795,139.784784,2024-02-08 11:15:04
388,B1-03.常盤公園（北側）,8,2,10,35.688405,139.770068,2024-02-08 11:15:04
389,C5-19.グランドメゾン田町,7,0,7,35.645537,139.754899,2024-02-08 11:15:04
390,K1-11.ファミリーマート かわだ多摩川２丁目店,0,3,3,35.558289,139.697403,2024-02-08 11:15:04
391,J1-43.アルコタワー・ホテル雅叙園東京,12,0,12,35.63237,139.712681,2024-02-08 11:15:04
392,N1-03.鷺宮南駐輪場,7,2,9,35.721827,139.635949,2024-02-08 11:15:04
393,N2-06.江古田1丁目B,1,5,6,35.72515,139.672614,2024-02-08 11:15:04
394,D7-12.プラウド高田馬場,4,1,5,35.715538,139.701683,2024-02-08 11:15:04
395,K1-118.久が原3丁目,0,9,9,35.580741,139.687152,2024-02-08 11:15:04
396,K1-125.池上駅南口第1,1,1,2,35.571866,139.703214,2024-02-08 11:15:04
397,K1-117.安詳寺,5,15,20,35.581798,139.695222,2024-02-08 11:15:04
398,I1-91.アクロス目黒タワー,9,1,10,35.634019,139.719749,2024-02-08 11:15:04
399,K1-126.池上駅南口第2,3,0,3,35.571815,139.702387,2024-02-08 11:15:04
400,C5-50.お台場レインボー公園,12,0,12,35.633133,139.777315,2024-02-08 11:15:04
401,T3-26.富士見ランド公園,0,8,8,35.73701,139.627244,2024-02-08 11:15:04
402,T1-15.つのの山緑地,4,0,4,35.765144,139.636606,2024-02-08 11:15:04
403,T1-16.ゆりの木通り南公園,3,1,4,35.767582,139.636304,2024-02-08 11:15:04
404,H1-185.UR大島六丁目団地(第二),0,4,4,35.690038,139.833252,2024-02-08 11:15:04
405,H1-186.セブン-イレブン亀戸昭和橋通り店,0,6,6,35.694804,139.831357,2024-02-08 11:15:04
406,K1-96.西馬込駅前自転車駐車場,9,5,14,35.586408,139.705425,2024-02-08 11:15:04
407,H1-184.UR大島六丁目団地(第一),3,2,5,35.689913,139.833279,2024-02-08 11:15:04
408,A6-25.麹町仮住宅,4,0,4,35.679192,139.74019,2024-02-08 11:15:04
409,C1-69.塩釜公園,0,11,11,35.662908,139.755014,2024-02-08 11:15:04
410,C1-68.桜田公園,25,4,29,35.665214,139.757008,2024-02-08 11:15:04
411,A2-14.興和一橋ビル,15,0,15,35.6927,139.759311,2024-02-08 11:15:04
412,C5-41.トヨタモビリティ東京 芝浦店,4,2,6,35.639644,139.745532,2024-02-08 11:15:04
413,T2-22.ファミリーマート 石神井台7丁目店,4,1,5,35.731909,139.579685,2024-02-08 11:15:04
414,A6-20.紀尾井町PREX,6,0,6,35.68369,139.736936,2024-02-08 11:15:04
415,C5-24.GLOBAL FRONT TOWER,0,14,14,35.647713,139.755534,2024-02-08 11:15:04
416,E5-09.文京区 男女平等センター,4,11,15,35.70861,139.75768,2024-02-08 11:15:04
417,K1-37.東京サーハウス前,17,4,21,35.563874,139.685011,2024-02-08 11:15:04
418,B4-15.リバーシティ　イーストタワーズ,0,17,17,35.669188,139.785301,2024-02-08 11:15:04
419,M6-08.Be Good 幡ヶ谷,0,13,13,35.682453,139.677687,2024-02-08 11:15:04
420,D5-09.ハウジングステージ新宿,7,6,13,35.702277,139.701214,2024-02-08 11:15:04
421,D6-21.新宿5丁目,2,5,7,35.691613,139.711233,2024-02-08 11:15:04
422,K1-39.東京モノレール 流通センター駅前,29,0,29,35.581752,139.748705,2024-02-08 11:15:04
423,K1-38.ネクストサイト蒲田ビル,8,0,8,35.558916,139.717253,2024-02-08 11:15:04
424,T3-17.練馬区役所東庁舎(第二),5,0,5,35.735585,139.652544,2024-02-08 11:15:04
425,H1-107.大島小松川公園,0,28,28,35.692641,139.846346,2024-02-08 11:15:04
426,B1-11.浜町川緑道,17,30,47,35.684158,139.787649,2024-02-08 11:15:04
427,A6-19.番町麹町ビルディング,12,0,12,35.685578,139.732078,2024-02-08 11:15:04
428,B3-12.築地場外市場,18,0,18,35.665254,139.769301,2024-02-08 11:15:04
429,I1-40.御殿山トラストタワー,26,0,26,35.622371,139.737457,2024-02-08 11:15:04
430,M5-08.古賀政男音楽博物館,2,0,2,35.668091,139.680243,2024-02-08 11:15:04
431,H1-90.富士倉庫運輸(株) FACE-1前,0,12,12,35.655102,139.805205,2024-02-08 11:15:04
432,A3-38.パークホームズ千代田淡路町,4,0,4,35.695163,139.769566,2024-02-08 11:15:04
433,D2-11.神楽坂アインスタワー,2,4,6,35.702833,139.739,2024-02-08 11:15:04
434,C2-04.飯倉いきいきプラザ,0,5,5,35.656991,139.740739,2024-02-08 11:15:04
435,B1-09.スマイルホテル日本橋三越前,17,1,18,35.686101,139.776089,2024-02-08 11:15:04
436,E5-15.文京千駄木の郷,7,4,11,35.726499,139.759884,2024-02-08 11:15:04
437,C2-05.ありすいきいきプラザ,9,4,13,35.651046,139.727745,2024-02-08 11:15:04
438,C5-06.品川シーズンテラス,19,0,19,35.632303,139.742393,2024-02-08 11:15:04
439,B1-10.箱崎川第二公園,5,4,9,35.680833,139.784267,2024-02-08 11:15:04
440,L1-15.ソフィア,0,3,3,35.663222,139.587803,2024-02-08 11:15:04
441,A3-12.秋葉原UDX北側駐輪場前,15,0,15,35.70111,139.772855,2024-02-08 11:15:04
442,A2-08.KDX御茶ノ水ビル,6,3,9,35.700568,139.76013,2024-02-08 11:15:04
443,A3-07.淡路公園,6,0,6,35.696942,139.767302,2024-02-08 11:15:04
444,A1-08.飯田橋サクラテラス（早稲田通り）,11,0,11,35.699132,139.74462,2024-02-08 11:15:04
445,A3-13.富士ソフトビル（駐車場入口横）,4,14,18,35.700486,139.774254,2024-02-08 11:15:04
446,A2-09.テラススクエア,8,0,8,35.6931,139.7599,2024-02-08 11:15:04
447,A6-11.東京ガーデンテラス紀尾井町,17,5,22,35.67962,139.7364,2024-02-08 11:15:04
448,K1-124.矢口2丁目,1,5,6,35.564161,139.695187,2024-02-08 11:15:04
449,N3-15.ライオンズマンション中野東,1,2,3,35.71046,139.6855,2024-02-08 11:15:04
450,M3-11.渋谷道玄坂東急ビル,8,2,10,35.65718,139.698687,2024-02-08 11:15:04
451,H1-180.シティコート大島,7,1,8,35.691954,139.836462,2024-02-08 11:15:04
452,B1-27.日本橋本町4丁目,24,3,27,35.68973,139.77598,2024-02-08 11:15:04
453,M3-22.森谷ビル,14,1,15,35.64514,139.71686,2024-02-08 11:15:04
454,N3-17.東中野3丁目,10,0,10,35.70862,139.680679,2024-02-08 11:15:04
455,N2-10.関根ビル,3,2,5,35.733432,139.671241,2024-02-08 11:15:04
456,T1-06.秋の陽公園,5,0,5,35.762326,139.635226,2024-02-08 11:15:04
457,N1-02.鷺宮東駐輪場,0,13,13,35.721556,139.640397,2024-02-08 11:15:04
458,K1-140.西馬込駅前自転車駐車場(奥),14,0,14,35.586382,139.705116,2024-02-08 11:15:04
459,H1-182.錦糸町プライムタワー,13,1,14,35.695695,139.820507,2024-02-08 11:15:04
460,E5-05.駒込地域活動センター,0,9,9,35.728644,139.752183,2024-02-08 11:15:04
461,M3-06.渋谷第一生命ビル,6,0,6,35.657556,139.704129,2024-02-08 11:15:04
462,T2-42.石神井公園駅北第二自転車駐車場,2,3,5,35.74553,139.608939,2024-02-08 11:15:04
463,K1-144.蒲田五丁目44番自転車駐車場,10,0,10,35.559809,139.716993,2024-02-08 11:15:04
464,M3-07.渋谷ファーストプレイス,10,0,10,35.65506,139.69384,2024-02-08 11:15:04
465,H1-74.タダノ教習センター,10,0,10,35.63848,139.832305,2024-02-08 11:15:04
466,H1-151.コスモリード錦糸町,0,9,9,35.701347,139.819973,2024-02-08 11:15:04
467,T2-23.セブン-イレブン 練馬南大泉5丁目店,6,0,6,35.750185,139.579216,2024-02-08 11:15:04
468,M4-13.J-cube,3,0,3,35.66616,139.70458,2024-02-08 11:15:04
469,T2-65.さくらの辻公園,1,4,5,35.734805,139.599906,2024-02-08 11:15:04
470,T2-24.セブン-イレブン 練馬インター店,0,27,27,35.754586,139.606409,2024-02-08 11:15:04
471,O5-05.モンテ・ベルテ,0,2,2,35.701454,139.650518,2024-02-08 11:15:04
472,J1-42.都立大学駅北口バス停前,5,4,9,35.618622,139.67596,2024-02-08 11:15:04
473,K1-97.トミンタワー多摩川二丁目,0,14,14,35.555561,139.704345,2024-02-08 11:15:04
474,D1-14.コモレ四谷,0,7,7,35.68752,139.72818,2024-02-08 11:15:04
475,K1-106.ファミリーマート上池台夫婦坂店,0,9,9,35.599329,139.703343,2024-02-08 11:15:04
476,J1-39.松見坂公園,0,11,11,35.655483,139.687325,2024-02-08 11:15:04
477,J1-40.西小山公園,5,3,8,35.616541,139.697369,2024-02-08 11:15:04
478,J1-38.林試の森公園 北,6,6,12,35.626355,139.700153,2024-02-08 11:15:04
479,I1-84.セブン-イレブン西品川2丁目店,0,2,2,35.613819,139.728418,2024-02-08 11:15:04
480,D6-26.セブン-イレブン新宿６丁目文化センター通り店,8,1,9,35.694951,139.708219,2024-02-08 11:15:04
481,T2-25.ファミリーマート 高野台二丁目店,0,5,5,35.746045,139.620087,2024-02-08 11:15:04
482,I1-85.GOODOFFICE品川,0,6,6,35.621081,139.741178,2024-02-08 11:15:04
483,K1-74.大田スタジアム,3,4,7,35.587423,139.753871,2024-02-08 11:15:04
484,C1-64.東京虎ノ門グローバルスクエア,3,2,5,35.669941,139.749261,2024-02-08 11:15:04
485,K1-72.ファミリーマート大森西四丁目店,0,7,7,35.573358,139.723105,2024-02-08 11:15:04
486,H1-118.ファミリーマート亀戸駅前店,9,2,11,35.69839,139.825484,2024-02-08 11:15:04
487,I1-62.天王洲Rim,0,6,6,35.622277,139.745638,2024-02-08 11:15:04
488,H1-40.深川東京モダン館,4,1,5,35.674076,139.795008,2024-02-08 11:15:04
489,H1-117.東京パークサイドビル,8,3,11,35.671225,139.808561,2024-02-08 11:15:04
490,J1-01.目黒区総合庁舎,8,1,9,35.640675,139.698088,2024-02-08 11:15:04
491,C5-16.品川インターシティ,23,0,23,35.626704,139.742174,2024-02-08 11:15:04
492,A1-12.北の丸スクエア,7,0,7,35.695515,139.750213,2024-02-08 11:15:04
493,H1-46.セブン-イレブン 江東枝川2丁目店,0,28,28,35.659287,139.807358,2024-02-08 11:15:04
494,A2-25.プラウド神田駿河台,11,1,12,35.698991,139.76091,2024-02-08 11:15:04
495,C5-49.プラウドタワー芝浦,0,15,15,35.638912,139.747422,2024-02-08 11:15:04
496,T3-25.北町みのり公園,0,4,4,35.767627,139.65243,2024-02-08 11:15:04
497,H1-75.ジオ深川住吉,0,10,10,35.684247,139.815638,2024-02-08 11:15:04
498,T1-09.ローソン練馬旭町一丁目店,3,2,5,35.765704,139.625178,2024-02-08 11:15:04
499,T2-26.ファミリーマート 大泉学園町四丁目店,0,8,8,35.767388,139.587625,2024-02-08 11:15:04
500,T2-27.ファミリーマート 大泉長久保通り店,2,3,5,35.773841,139.591456,2024-02-08 11:15:04
501,C3-19.明治記念館西,3,1,4,35.678179,139.720809,2024-02-08 11:15:04
502,I1-11.鮫洲入江広場,11,3,14,35.603984,139.744504,2024-02-08 11:15:04
503,I1-10.品川シーサイド公園第1,15,3,18,35.607717,139.749478,2024-02-08 11:15:04
504,I1-09.東品川海上公園第1,0,15,15,35.616633,139.748945,2024-02-08 11:15:04
505,D3-06.セブン-イレブン高田馬場3丁目中央店,0,6,6,35.713872,139.698301,2024-02-08 11:15:04
506,K1-40.大田文化の森,0,16,16,35.579649,139.720263,2024-02-08 11:15:04
507,C1-41.港区立エコプラザ,7,2,9,35.658709,139.757036,2024-02-08 11:15:04
508,I1-13.八潮北公園,0,12,12,35.613421,139.75375,2024-02-08 11:15:04
509,I1-12.しながわ区民公園（北側）,2,2,4,35.596091,139.740884,2024-02-08 11:15:04
510,T2-09.こぐれの森緑地,3,7,10,35.763741,139.588847,2024-02-08 11:15:04
511,T3-31.パークサイド関口,4,4,8,35.74097,139.63836,2024-02-08 11:15:04
512,H1-183.MFLP新木場1,4,0,4,35.643958,139.838358,2024-02-08 11:15:04
513,T2-33.ウインドヒルズ189,3,3,6,35.74642,139.581204,2024-02-08 11:15:04
514,T2-67.陽和病院,0,7,7,35.761211,139.603316,2024-02-08 11:15:04
515,H1-82.セブンｰイレブン 北砂3丁目明治通り店,0,21,21,35.683514,139.827081,2024-02-08 11:15:04
516,T2-60.武蔵関公園（第一）,9,0,9,35.724747,139.565817,2024-02-08 11:15:04
517,I1-48.NTT 東日本 関東病院(北側),5,4,9,35.632191,139.725002,2024-02-08 11:15:04
518,T2-58.立野公園,3,2,5,35.716776,139.577975,2024-02-08 11:15:04
519,I1-100.東急荏原中延駅駐輪場,3,4,7,35.610444,139.712333,2024-02-08 11:15:04
520,T2-56.大泉公園（第一）,2,2,4,35.77228,139.58325,2024-02-08 11:15:04
521,T2-55.大泉町もみじやま公園,0,3,3,35.767296,139.602321,2024-02-08 11:15:04
522,T2-54.土支田農業公園,0,9,9,35.760939,139.609264,2024-02-08 11:15:04
523,I1-44.大井三ツ又商店街入口,7,0,7,35.604606,139.734483,2024-02-08 11:15:04
524,T2-62.大泉井頭公園,6,4,10,35.746681,139.57754,2024-02-08 11:15:04
525,T2-61.武蔵関公園（第二）,4,0,4,35.727826,139.570056,2024-02-08 11:15:04
526,T3-09.学田公園,4,1,5,35.730428,139.648704,2024-02-08 11:15:04
527,K1-105.東糀谷二丁目児童公園,0,8,8,35.555702,139.740802,2024-02-08 11:15:04
528,T3-04.サンパレス平和台,8,4,12,35.759827,139.659121,2024-02-08 11:15:04
529,K1-104.六郷BASE,0,6,6,35.543573,139.714393,2024-02-08 11:15:04
530,M4-16.神宮前6丁目,1,2,3,35.668673,139.702816,2024-02-08 11:15:04
531,K1-69.京急平和島第2Bバイク駐輪場,0,7,7,35.585747,139.735242,2024-02-08 11:15:04
532,H1-155.メブクス豊洲,15,5,20,35.645726,139.784496,2024-02-08 11:15:04
533,C2-11.一の橋,8,44,52,35.654726,139.737491,2024-02-08 11:15:04
534,C4-11.ザ・パークハウス 三田ガーデン,0,14,14,35.64816,139.737991,2024-02-08 11:15:04
535,H1-161.昭文社制作本部ビル,4,2,6,35.684003,139.794983,2024-02-08 11:15:04
536,N2-07.新井区民活動センター,2,3,5,35.714292,139.663327,2024-02-08 11:15:04
537,K1-87.羽田イノベーションシティ,2,8,10,35.547061,139.756277,2024-02-08 11:15:04
538,N3-16.COURT 5,5,0,5,35.699743,139.664608,2024-02-08 11:15:04
539,C4-01.高輪地区総合支所(5F),1,10,11,35.641833,139.734519,2024-02-08 11:15:04
540,C5-48.セブンイレブン港区海岸三丁目店,0,8,8,35.636808,139.752517,2024-02-08 11:15:04
541,H1-42.江東区スポーツ会館,0,29,29,35.683961,139.821559,2024-02-08 11:15:04
542,B2-10.東京ダイヤビルディング（北側）,0,10,10,35.675702,139.785229,2024-02-08 11:15:04
543,H1-43.東京イースト21,0,18,18,35.675639,139.815255,2024-02-08 11:15:04
544,B3-20.歌舞伎座タワー駐輪場2F,8,0,8,35.670106,139.768041,2024-02-08 11:15:04
545,B3-21.歌舞伎座タワー駐輪場3F,9,0,9,35.6701,139.76801,2024-02-08 11:15:04
546,K1-139.プラットホステル京急 羽田ホーム,8,2,10,35.548104,139.748889,2024-02-08 11:15:04
547,J1-58.目黒女子会館前,3,2,5,35.629011,139.69716,2024-02-08 11:15:04
548,T2-18.ファミリーマート練馬西税務署前店,2,2,4,35.745505,139.580878,2024-02-08 11:15:04
549,C3-23.LIFORK 南青山 北エントランス,13,15,28,35.669916,139.725701,2024-02-08 11:15:04
550,C1-46.新虎通りCORE,14,3,17,35.665124,139.754054,2024-02-08 11:15:04
551,C1-45.浜松町クレアタワー,17,2,19,35.656324,139.755927,2024-02-08 11:15:04
552,K1-53.セブン-イレブン 田園調布郵便局前店,15,5,20,35.589309,139.678587,2024-02-08 11:15:04
553,K1-52.大田区総合体育館,7,0,7,35.564152,139.727422,2024-02-08 11:15:04
554,T1-12.ファミリーマート 高松六丁目店,3,1,4,35.756873,139.616612,2024-02-08 11:15:04
555,D7-07.ローソン 新宿西落合三丁目店,0,5,5,35.725171,139.675897,2024-02-08 11:15:04
556,A6-16.一番町第二TGビル,3,2,5,35.688351,139.744321,2024-02-08 11:15:04
557,C3-33.PASONA SQUARE,12,0,12,35.667462,139.716058,2024-02-08 11:15:04
558,A3-24.岩本町ほほえみプラザ,0,11,11,35.69441,139.777715,2024-02-08 11:15:04
559,H1-35.ヒューリック豊洲プライムスクエア,7,0,7,35.652376,139.797724,2024-02-08 11:15:04
560,C5-11.フェイバリッチタワー品川,0,56,56,35.631729,139.749767,2024-02-08 11:15:04
561,E2-13.デルックス文京神楽坂,0,4,4,35.70781,139.732227,2024-02-08 11:15:04
562,C5-01.こうなん星の公園,47,0,47,35.629697,139.742167,2024-02-08 11:15:04
563,C5-02.港南緑水公園,0,80,80,35.628955,139.750731,2024-02-08 11:15:04
564,A3-22.龍閑児童公園,0,8,8,35.693234,139.779702,2024-02-08 11:15:04
565,A3-21.神田ふれあい通り第３,6,6,12,35.695176,139.772832,2024-02-08 11:15:04
566,H1-30.江東区役所（北側）,9,3,12,35.67338,139.8164,2024-02-08 11:15:04
567,C1-17.港区役所,4,0,4,35.657866,139.751068,2024-02-08 11:15:04
568,H1-31.江東区役所（南側）,17,0,17,35.67214,139.8166,2024-02-08 11:15:04
569,C1-09.愛宕グリーンヒルズ,8,1,9,35.662051,139.748132,2024-02-08 11:15:04
570,D1-02.四谷特別出張所（新宿御苑大木戸門前）,16,1,17,35.687435,139.714169,2024-02-08 11:15:04
571,D1-01.花園西公園,5,0,5,35.690612,139.711631,2024-02-08 11:15:04
572,C1-04.虎ノ門ヒルズ,12,2,14,35.666527,139.748804,2024-02-08 11:15:04
573,C1-05.西新橋2丁目（新虎通り）,14,0,14,35.665593,139.752617,2024-02-08 11:15:04
574,C1-73.日比谷フォートタワー,14,0,14,35.669871,139.753147,2024-02-08 11:15:04
575,K1-102.上池台四丁目公園,0,7,7,35.595119,139.6996,2024-02-08 11:15:04
576,M2-01.恵比寿保健相談所（恵比寿社会教育館）,0,14,14,35.64524,139.71946,2024-02-08 11:15:04
577,I1-98.コーポ荏原,2,4,6,35.60411,139.709784,2024-02-08 11:15:04
578,C3-17.セブン-イレブン 港区溜池山王店,0,20,20,35.670308,139.743242,2024-02-08 11:15:04
579,T2-11.石神井松の風文化公園,2,1,3,35.739471,139.595578,2024-02-08 11:15:04
580,M2-03.サイカパーク恵比寿,15,0,15,35.646581,139.710613,2024-02-08 11:15:04
581,M2-02.アメリカ橋公園,7,0,7,35.643606,139.713099,2024-02-08 11:15:04
582,T2-50.North Ridge 吉祥寺,8,1,9,35.72305,139.579555,2024-02-08 11:15:04
583,J1-35.目黒川田道街かど公園,6,0,6,35.634574,139.710332,2024-02-08 11:15:04
584,H1-174.ジュネス(エントランス側),0,2,2,35.682712,139.823961,2024-02-08 11:15:04
585,M6-17.笹塚一丁目駐輪場,2,5,7,35.672922,139.668729,2024-02-08 11:15:04
586,C4-14.神応ほっとプラザ,3,7,10,35.643711,139.724753,2024-02-08 11:15:04
587,K1-107.馬込駅A2出口,5,5,10,35.596854,139.712139,2024-02-08 11:15:04
588,T3-11.ガラクタ公園,1,2,3,35.740321,139.631256,2024-02-08 11:15:04
589,T2-80.みその緑地,2,3,5,35.756825,139.590528,2024-02-08 11:15:04
590,T3-24.AZEST新桜台,5,2,7,35.743962,139.670315,2024-02-08 11:15:04
591,D4-07.新宿余丁町ビル,0,9,9,35.698512,139.716482,2024-02-08 11:15:04
592,T3-01.練馬春日町駅自転車駐車場,7,0,7,35.751438,139.641265,2024-02-08 11:15:04
593,H1-89.BUDDY スポーツアリーナ,7,7,14,35.637041,139.781088,2024-02-08 11:15:04
594,E5-14.上野広小路駅（湯島側）,4,9,13,35.707313,139.771857,2024-02-08 11:15:04
595,H1-109.Brillia ist 東雲キャナルコート東側,0,46,46,35.648008,139.803487,2024-02-08 11:15:04
596,H1-108.Brillia ist 東雲キャナルコート北側,0,21,21,35.648431,139.803125,2024-02-08 11:15:04
597,C1-53.ホテルリブマックス新橋,4,0,4,35.661149,139.754612,2024-02-08 11:15:04
598,D7-10.染の里 おちあい,1,5,6,35.715211,139.689788,2024-02-08 11:15:04
599,A1-15.富士見みらい館,0,6,6,35.697167,139.745629,2024-02-08 11:15:04
600,E4-15.千石4丁目,3,2,5,35.729153,139.741368,2024-02-08 11:15:04
601,H1-111.ファミリーマート木場六丁目店,0,10,10,35.66688,139.80779,2024-02-08 11:15:04
602,C5-36.お台場海浜公園駅,3,0,3,35.62974,139.778178,2024-02-08 11:15:04
603,H1-10.出会い橋,15,0,15,35.625029,139.777344,2024-02-08 11:15:04
604,H1-11.テレコムセンター駅,6,15,21,35.61813,139.778698,2024-02-08 11:15:04
605,H1-47.トピレックプラザ,0,37,37,35.672481,139.835877,2024-02-08 11:15:04
606,H1-13.アーバンドック ららぽーと豊洲,19,0,19,35.654067,139.792376,2024-02-08 11:15:04
607,T2-66.大泉学園町希望ヶ丘公園,0,4,4,35.778605,139.588883,2024-02-08 11:15:04
608,C5-37.台場駅,0,24,24,35.626388,139.772453,2024-02-08 11:15:04
609,H1-16.豊洲三丁目公園,19,0,19,35.657477,139.796629,2024-02-08 11:15:04
610,H1-17.東雲水辺公園,0,69,69,35.64704,139.80469,2024-02-08 11:15:04
611,C1-72.新田町ビル,9,2,11,35.646307,139.746428,2024-02-08 11:15:04
612,K1-98.鵜の木松山公園,2,5,7,35.577433,139.680752,2024-02-08 11:15:04
613,C1-71.芝商業高校前交差点,0,7,7,35.65583,139.759896,2024-02-08 11:15:04
614,H1-122.東砂スポーツセンター,0,11,11,35.679167,139.839746,2024-02-08 11:15:04
615,O6-05.コージーコート久我山,0,5,5,35.687531,139.60439,2024-02-08 11:15:04
616,T2-39.ローソン 練馬大泉町五丁目店,7,1,8,35.758929,139.597548,2024-02-08 11:15:04
617,J1-50.大岡山公園,2,2,4,35.609958,139.684087,2024-02-08 11:15:04
618,J1-51.池尻大橋駅東口駐輪場,0,5,5,35.650627,139.687228,2024-02-08 11:15:04
619,K1-99.東原くすのき公園,7,1,8,35.584086,139.67898,2024-02-08 11:15:04
620,N3-12.桃園区民活動センター,3,0,3,35.702414,139.667327,2024-02-08 11:15:04
621,H1-191.三井リンクラボ新木場2,14,0,14,35.644863,139.831107,2024-02-08 11:15:04
622,M5-09.代々木上原駅前,5,0,5,35.66865,139.679251,2024-02-08 11:15:04
623,O3-09.NTT井草ビル第3ポート,4,3,7,35.714151,139.61693,2024-02-08 11:15:04
624,T1-07.土支田一丁目（笹目通り）,2,8,10,35.765913,139.619285,2024-02-08 11:15:04
625,K1-22.矢口特別出張所,2,3,5,35.562324,139.690486,2024-02-08 11:15:04
626,T3-08.中新井川児童遊園,2,5,7,35.728268,139.649188,2024-02-08 11:15:04
627,H1-78.ローソン新木場一丁目店,14,0,14,35.645604,139.834941,2024-02-08 11:15:04
628,A6-13.番町会館,5,1,6,35.689131,139.733071,2024-02-08 11:15:04
629,H1-71.セブン-イレブン 江東東陽4丁目,0,4,4,35.670906,139.819386,2024-02-08 11:15:04
630,D2-09.セブン-イレブン 新宿岩戸町店,3,0,3,35.700993,139.736355,2024-02-08 11:15:04
631,I1-08.天王洲アイル第一水辺広場,27,4,31,35.622294,139.751644,2024-02-08 11:15:04
632,I1-07.しながわ水族館,0,16,16,35.590641,139.736354,2024-02-08 11:15:04
633,D3-09.西早稲田3丁目,2,2,4,35.712545,139.713319,2024-02-08 11:15:04
634,E1-16.小石川3丁目緑地,0,21,21,35.714338,139.746346,2024-02-08 11:15:04
635,C5-28.芝浦ルネサイトタワー,6,1,7,35.643683,139.7506,2024-02-08 11:15:04
636,I1-59.文庫の森第一,14,8,22,35.612357,139.721484,2024-02-08 11:15:04
637,I1-60.文庫の森第二,0,5,5,35.611368,139.720424,2024-02-08 11:15:04
638,C1-38.KDX西新橋ビル（西側）,2,3,5,35.66495,139.750459,2024-02-08 11:15:04
639,C1-37.KDX西新橋ビル（北側）,3,2,5,35.665218,139.750827,2024-02-08 11:15:04
640,T2-14.NPC24H東大泉第6パーキング,0,6,6,35.747807,139.593599,2024-02-08 11:15:04
641,C3-12.赤坂センタービルディング前（青山通り）,1,7,8,35.676732,139.733905,2024-02-08 11:15:04
642,H1-36.フジゴルフセンター,0,23,23,35.66605,139.806699,2024-02-08 11:15:04
643,C1-27.虎ノ門2丁目タワー,14,0,14,35.668547,139.747175,2024-02-08 11:15:04
644,C5-12.第2東運ビル,5,3,8,35.633742,139.748281,2024-02-08 11:15:04
645,D6-08.新宿イーストサイドスクエア,4,2,6,35.697158,139.707887,2024-02-08 11:15:04
646,A4-08.永代通り（大手町駅B2c出口前）,23,1,24,35.684349,139.766958,2024-02-08 11:15:04
647,H1-37.東雲駅（東京湾岸道路）,33,2,35,35.640618,139.802455,2024-02-08 11:15:04
648,C3-11.赤坂見附南,1,0,1,35.676566,139.737083,2024-02-08 11:15:04
649,M6-04.本町東べんてん橋公園,0,20,20,35.687126,139.680702,2024-02-08 11:15:04
650,I1-79.品川浦第二,11,4,15,35.621904,139.741429,2024-02-08 11:15:04
651,K1-81.コーナン本羽田萩中店,10,3,13,35.549568,139.731093,2024-02-08 11:15:04
652,D6-25.新宿駅東南口自転車駐輪場,29,4,33,35.689755,139.701323,2024-02-08 11:15:04
653,I1-78.セブン-イレブン西大井店,2,9,11,35.601431,139.718659,2024-02-08 11:15:04
654,H1-136.東砂一丁目公園,0,17,17,35.683542,139.839763,2024-02-08 11:15:04
655,A6-23.セブン-イレブン 千代田三番町店,0,14,14,35.689466,139.745316,2024-02-08 11:15:04
656,C5-34.五色橋ビル,0,12,12,35.636644,139.751798,2024-02-08 11:15:04
657,K1-41.郷土博物館,0,11,11,35.588644,139.710413,2024-02-08 11:15:04
658,G2-06.ディアレイシャス押上スカイヴィレッジ,0,5,5,35.71408,139.810588,2024-02-08 11:15:04
659,O3-11.ハイリビング関根,7,1,8,35.707877,139.618926,2024-02-08 11:15:04
660,O7-02.永福中央公園,6,0,6,35.67121,139.64145,2024-02-08 11:15:04
661,K1-29.萩中文化センター,3,6,9,35.55017,139.728146,2024-02-08 11:15:04
662,K1-30.テクノFRONT森ケ崎,3,1,4,35.567922,139.746181,2024-02-08 11:15:04
663,K1-130.COCOONひろば平和島,15,4,19,35.578728,139.735238,2024-02-08 11:15:04
664,H1-81.豊洲IHIビル（北側）,21,0,21,35.659829,139.793243,2024-02-08 11:15:04
665,E4-03.昭和小学校北側（不忍通り）,25,8,33,35.73166,139.748625,2024-02-08 11:15:04
666,C2-12.六本木ファーストビル,15,0,15,35.66249,139.741397,2024-02-08 11:15:04
667,D3-16.セジョリ江戸川橋,4,11,15,35.708734,139.730509,2024-02-08 11:15:04
668,A5-04.日比谷パークフロント前　日比谷公園南面向い歩道上,6,2,8,35.671514,139.753952,2024-02-08 11:15:04
669,C3-22.OMO3東京赤坂 by 星野リゾート,8,0,8,35.674929,139.736053,2024-02-08 11:15:04
670,B1-20.竜閑さくら橋際街角広場,0,21,21,35.688301,139.768958,2024-02-08 11:15:04
671,H1-83.ローソン江東東雲店,0,16,16,35.642165,139.800439,2024-02-08 11:15:04
672,H1-84.NTT東日本辰巳ビル,0,19,19,35.647091,139.817333,2024-02-08 11:15:04
673,C5-26.ピアシティ芝浦ビル,10,4,14,35.644155,139.756216,2024-02-08 11:15:04
674,T3-28.ほしぞら緑地,0,3,3,35.755137,139.661208,2024-02-08 11:15:04
675,I1-88.セブン-イレブン品川南大井3丁目店,1,1,2,35.58768,139.734515,2024-02-08 11:15:04
676,I1-87.セブン-イレブン西大井滝王子通り店,0,7,7,35.599774,139.723467,2024-02-08 11:15:04
677,G4-11.ホテルマイステイズ浅草,19,2,21,35.703972,139.797327,2024-02-08 11:15:04
678,C5-30.フェイム芝浦インターウェーブ,0,11,11,35.647872,139.75391,2024-02-08 11:15:04
679,M6-13.JICA東京,9,3,12,35.673409,139.675203,2024-02-08 11:15:04
680,A4-13.アーバンネット大手町ビル,5,0,5,35.68557,139.766929,2024-02-08 11:15:04
681,B4-27.リバーシティ西ブロック,10,8,18,35.670491,139.784447,2024-02-08 11:15:04
682,K1-143.大森北1丁目,57,2,59,35.584914,139.730504,2024-02-08 11:15:04
683,E5-24.本郷6丁目,1,4,5,35.712445,139.758157,2024-02-08 11:15:04
684,D2-17.genten市ヶ谷店,10,0,10,35.690657,139.73255,2024-02-08 11:15:04
685,A4-14.東京国際フォーラム（有楽町駅ガード側）,8,0,8,35.675739,139.763712,2024-02-08 11:15:04
686,A2-27.丸紅ビル,6,0,6,35.690958,139.759876,2024-02-08 11:15:04
687,K1-135.北千束2丁目,4,2,6,35.608633,139.693653,2024-02-08 11:15:04
688,A1-19.九段会館テラス,4,0,4,35.694065,139.751801,2024-02-08 11:15:04
689,K1-136.BIG FUN 平和島,0,9,9,35.585489,139.740194,2024-02-08 11:15:04
690,K1-137.京浜島つばさ公園,0,14,14,35.571578,139.770532,2024-02-08 11:15:04
691,D1-16.ルネ新宿御苑タワー,6,4,10,35.690155,139.713377,2024-02-08 11:15:04
692,G6-01.オーキッドレジデンス森下,1,6,7,35.692547,139.799231,2024-02-08 11:15:04
693,T2-63.三原台公園,1,6,7,35.751471,139.599835,2024-02-08 11:15:04
694,O4-01.阿佐ヶ谷南公園,1,1,2,35.70328,139.62981,2024-02-08 11:15:04
695,B4-11.ダンスキューブ勝どき,0,19,19,35.656565,139.775073,2024-02-08 11:15:04
696,D1-06.四谷第六小学校北,10,0,10,35.681754,139.715256,2024-02-08 11:15:04
697,T2-64.高野台中央公園,1,2,3,35.746768,139.613885,2024-02-08 11:15:04
698,H1-169.セブンイレブン江東亀戸7丁目東店,0,10,10,35.697157,139.839835,2024-02-08 11:15:04
699,H1-170.セブンイレブン江東亀戸7丁目南店,0,31,31,35.695937,139.838017,2024-02-08 11:15:04
700,B2-16.ホテルサードニクス東京,5,0,5,35.67684,139.77876,2024-02-08 11:15:04
701,I1-93.中央海浜公園前交差点（南側）,4,1,5,35.595498,139.750654,2024-02-08 11:15:04
702,I1-92.中央海浜公園前交差点（北側）,10,0,10,35.595873,139.75134,2024-02-08 11:15:04
703,B1-26.Dash Living Nihonbashi,3,3,6,35.68802,139.78112,2024-02-08 11:15:04
704,H1-158.東京国際交流館,11,0,11,35.621845,139.776833,2024-02-08 11:15:04
705,J1-32.緑が丘駅前高架下,7,0,7,35.606793,139.678372,2024-02-08 11:15:04
706,K1-90.ファミリーマート大田仲池上一丁目店,1,5,6,35.5873,139.701644,2024-02-08 11:15:04
707,K1-91.穴守稲荷神社,3,6,9,35.550027,139.74973,2024-02-08 11:15:04
708,C1-67.京阪神 虎ノ門ビル,14,8,22,35.669228,139.751668,2024-02-08 11:15:04
709,K1-89.ファミリーマート大田千鳥三丁目店,2,3,5,35.572086,139.68708,2024-02-08 11:15:04
710,I1-97.トミンハイム東品川三丁目第二,14,5,19,35.613387,139.749307,2024-02-08 11:15:04
711,T2-51.練馬区役所石神井庁舎,10,0,10,35.743772,139.603317,2024-02-08 11:15:04
712,T2-75.石神井台二丁目緑地,3,0,3,35.734684,139.593628,2024-02-08 11:15:04
713,E5-19.千駄木公園,1,6,7,35.728333,139.757629,2024-02-08 11:15:04
714,E5-18.団子坂上広場,1,10,11,35.724921,139.75903,2024-02-08 11:15:04
715,A5-07.富国生命ビル,3,3,6,35.670452,139.75557,2024-02-08 11:15:04
716,H1-156.つどい橋下,0,9,9,35.630791,139.787396,2024-02-08 11:15:04
717,H1-159.夢の大橋西,16,0,16,35.627599,139.782953,2024-02-08 11:15:04
718,H1-143.ダイバーシティ東京 プラザ,8,2,10,35.624619,139.776006,2024-02-08 11:15:04
719,I1-57.大井水神公園,74,0,74,35.589972,139.729368,2024-02-08 11:15:04
720,B2-15.KABUTO ONE,6,0,6,35.68168,139.77825,2024-02-08 11:15:04
721,K1-64.多摩川グリーンスクエア,0,16,16,35.545459,139.719489,2024-02-08 11:15:04
722,T2-57.大泉公園（第二）,5,1,6,35.771708,139.583551,2024-02-08 11:15:04
723,A4-06.大手町ファーストスクエア,10,0,10,35.686037,139.764472,2024-02-08 11:15:04
724,C1-50.NTT虎ノ門ビル,11,3,14,35.666075,139.748008,2024-02-08 11:15:04
725,C1-23.三田いきいきプラザ,8,1,9,35.648637,139.749834,2024-02-08 11:15:04
726,H1-29.スカイズタワー＆ガーデン,0,76,76,35.647618,139.792152,2024-02-08 11:15:04
727,C1-21.汐留ビルディング,5,5,10,35.657363,139.75918,2024-02-08 11:15:04
728,A3-16.地蔵橋東児童遊園,2,4,6,35.691069,139.775376,2024-02-08 11:15:04
729,A3-18.美倉橋北児童遊園,0,10,10,35.69703,139.779928,2024-02-08 11:15:04
730,A4-01.丸ビル（南側駐輪場）,12,0,12,35.680514,139.764002,2024-02-08 11:15:04
731,A3-11.練成公園,1,7,8,35.703735,139.770629,2024-02-08 11:15:04
732,A3-10.芳林公園（北側）,0,9,9,35.701978,139.7698,2024-02-08 11:15:04
733,A6-02.いきいきプラザ一番町（西側駐輪場）,5,3,8,35.687031,139.739327,2024-02-08 11:15:04
734,A6-01.東郷元帥記念公園（南側）,3,2,5,35.689879,139.740178,2024-02-08 11:15:04
735,A5-03.参議院第二別館（永田町駅2番出口）,9,7,16,35.677763,139.74271,2024-02-08 11:15:04
736,A4-03.東京国際フォーラム（メトロD5出口）,8,0,8,35.675843,139.763329,2024-02-08 11:15:04
737,K1-15.セブン‐イレブン 大田区西蒲田店,3,0,3,35.56694,139.716331,2024-02-08 11:15:04
738,K1-49.ローソン仲池上一丁目店,0,10,10,35.586585,139.698552,2024-02-08 11:15:04
739,A2-06.東光電気工事 別館（屋内駐輪場）,6,1,7,35.69919,139.75701,2024-02-08 11:15:04
740,M4-01.新宿タカシマヤ,5,1,6,35.68714,139.702775,2024-02-08 11:15:04
741,M4-03.NTTドコモ代々木ビル,8,2,10,35.684451,139.702884,2024-02-08 11:15:04
742,M3-03.代官山 T-SITE,4,4,8,35.649823,139.700139,2024-02-08 11:15:04
743,K1-14.大森地域庁舎,5,4,9,35.578239,139.723262,2024-02-08 11:15:04
744,C5-46.ウエリスアーバン品川タワー,0,21,21,35.630961,139.746875,2024-02-08 11:15:04
745,C4-13.コシダコネクトビル,0,15,15,35.637765,139.739128,2024-02-08 11:15:04
746,K1-127.第二石井ビル,5,0,5,35.559286,139.722611,2024-02-08 11:15:04
747,C1-74.札の辻スクエア,6,2,8,35.645155,139.744543,2024-02-08 11:15:04
748,H1-164.森下三丁目第三児童遊園,0,19,19,35.68546,139.80244,2024-02-08 11:15:04
749,C1-78.CIRCLES新橋,7,2,9,35.66646,139.752138,2024-02-08 11:15:04
750,C3-34.3rd MINAMI AOYAMA,5,1,6,35.668622,139.715957,2024-02-08 11:15:04
751,O4-06.杉並区役所本庁舎,3,2,5,35.699328,139.636343,2024-02-08 11:15:04
752,D3-14.コーシャハイム高田馬場,5,1,6,35.712413,139.70168,2024-02-08 11:15:04
753,D7-11.新宿清掃事務所,1,4,5,35.716359,139.704377,2024-02-08 11:15:04
754,D5-08.ウエリス新宿早稲田の森,0,9,9,35.704597,139.708397,2024-02-08 11:15:04
755,E2-12.水道2丁目,0,29,29,35.709147,139.739183,2024-02-08 11:15:04
756,M6-10.京王コインパーク幡ヶ谷,0,11,11,35.6772,139.678117,2024-02-08 11:15:04
757,E3-05.文京スポーツセンター,49,11,60,35.721045,139.735687,2024-02-08 11:15:04
758,J1-36.WJ Haus,0,7,7,35.629067,139.711779,2024-02-08 11:15:04
759,K1-51.テクノポートカマタ 第2,11,0,11,35.555808,139.722791,2024-02-08 11:15:04
760,D1-13.新宿御苑新宿門【西側】,0,27,27,35.688945,139.706536,2024-02-08 11:15:04
761,I1-31.セブン-イレブン 品川戸越5丁目店,4,2,6,35.608193,139.719139,2024-02-08 11:15:04
762,T3-27.貫井川緑地,1,3,4,35.738427,139.632251,2024-02-08 11:15:04
763,H1-147.大島四丁目団地,7,10,17,35.68744,139.827075,2024-02-08 11:15:04
764,O4-02.成宗さくら公園,2,0,2,35.69638,139.63482,2024-02-08 11:15:04
765,O1-01.上瀬戸公園,3,1,4,35.72077,139.6045,2024-02-08 11:15:04
766,T2-15.NPC24H大泉学園南口パーキング,10,0,10,35.748611,139.584251,2024-02-08 11:15:04
767,O3-03.桃井1丁目5番地,5,2,7,35.71013,139.61194,2024-02-08 11:15:04
768,H1-08.東京テレポート駅,17,28,45,35.627087,139.779779,2024-02-08 11:15:04
769,H1-05.相鉄グランドフレッサ 東京ベイ有明,13,1,14,35.632148,139.79017,2024-02-08 11:15:04
770,H1-06.武蔵野大学,2,13,15,35.630185,139.786618,2024-02-08 11:15:04
771,A4-15.TOKIWAブリッジ,9,0,9,35.686389,139.769237,2024-02-08 11:15:04
772,H1-160.花の広場,8,9,17,35.633908,139.793322,2024-02-08 11:15:04
773,H1-01.豊洲ＩＨＩビル前（晴海通り）,9,1,10,35.658911,139.792531,2024-02-08 11:15:04
774,H1-02.豊洲駅,16,0,16,35.654196,139.79626,2024-02-08 11:15:04
775,J1-19.NTT東日本自由が丘ビル,3,1,4,35.615098,139.675954,2024-02-08 11:15:04
776,C2-19.広尾駅,2,2,4,35.650732,139.72256,2024-02-08 11:15:04
777,H1-114.東京夢の島マリーナ,5,10,15,35.651987,139.830691,2024-02-08 11:15:04
778,K1-71.ファミリーマート大田大森南店,0,19,19,35.562769,139.74327,2024-02-08 11:15:04
779,J1-20.すずめのお宿緑地公園,1,8,9,35.617773,139.685351,2024-02-08 11:15:04
780,H1-115.東京夢の島マリーナ 第4駐車場,2,12,14,35.650235,139.835993,2024-02-08 11:15:04
781,M5-10.富ヶ谷2丁目,14,3,17,35.665961,139.686491,2024-02-08 11:15:04
782,J1-21.中央緑地公園,0,9,9,35.630694,139.690482,2024-02-08 11:15:04
783,H1-116.出会い橋高架下,27,22,49,35.625037,139.777646,2024-02-08 11:15:04
784,M3-12.渋谷南東急ビル,6,0,6,35.656228,139.706284,2024-02-08 11:15:04
785,T2-01.大泉学園駅北口,4,1,5,35.749918,139.58618,2024-02-08 11:15:04
786,K1-06.大森駅入新井自転車駐車場,5,1,6,35.585269,139.726279,2024-02-08 11:15:04
787,D6-06.新宿中央公園（エコギャラリー下）,0,16,16,35.691199,139.687966,2024-02-08 11:15:04
788,D6-14.新宿ファーストウエスト,13,1,14,35.689529,139.695995,2024-02-08 11:15:04
789,D6-15.住友不動産西新宿ビル,10,1,11,35.69465,139.695911,2024-02-08 11:15:04
790,H1-56.南砂三丁目緑地公園西,0,30,30,35.672361,139.829825,2024-02-08 11:15:04
791,T2-74.扇橋公園,2,3,5,35.731791,139.588844,2024-02-08 11:15:04
792,B2-20.SHビル,3,1,4,35.675398,139.779962,2024-02-08 11:15:04
793,I1-17.東品川海上公園第2,0,18,18,35.616364,139.749171,2024-02-08 11:15:04
794,I1-16.品川浦,13,1,14,35.6214,139.741958,2024-02-08 11:15:04
795,A4-11.二重橋前駅(メトロ4番出口),5,0,5,35.680753,139.762069,2024-02-08 11:15:04
796,H1-76.有明物流センター,0,19,19,35.638571,139.78829,2024-02-08 11:15:04
797,K1-43.北馬込わくわく公園,0,14,14,35.600707,139.703216,2024-02-08 11:15:04
798,K1-42.馬込西公園,11,3,14,35.58849,139.70376,2024-02-08 11:15:04
799,T1-08.セブン-イレブン 練馬高松6丁目店,4,0,4,35.756506,139.620347,2024-02-08 11:15:04
800,T2-17.ファミリーマート 練馬石神井町八丁目店,0,6,6,35.74755,139.597968,2024-02-08 11:15:04
801,K1-31.テクノWING,0,12,12,35.546252,139.731708,2024-02-08 11:15:04
802,K1-32.石川町文化センター,5,0,5,35.601958,139.682876,2024-02-08 11:15:04
803,I1-20.しおじ公園,9,11,20,35.59632,139.751279,2024-02-08 11:15:04
804,I1-19.品川シーサイド公園第2,7,0,7,35.607571,139.749108,2024-02-08 11:15:04
805,J1-29.カスタリア目黒鷹番,2,3,5,35.626121,139.688576,2024-02-08 11:15:04
806,H1-127.古石場川親水公園,0,38,38,35.669291,139.795364,2024-02-08 11:15:04
807,D4-05.カスタリア新宿7丁目,0,14,14,35.700732,139.711472,2024-02-08 11:15:04
808,I1-71.セブン-イレブン南大井浜川店,0,4,4,35.596483,139.7355,2024-02-08 11:15:04
809,I1-72.セブン-イレブン大井店,0,23,23,35.600081,139.728193,2024-02-08 11:15:04
810,T3-21.くまのやま緑地,4,1,5,35.747038,139.667965,2024-02-08 11:15:04
811,K1-110.萩中集会所裏,9,5,14,35.550479,139.739538,2024-02-08 11:15:04
812,O2-02.シエール荻窪,30,0,30,35.708265,139.612703,2024-02-08 11:15:04
813,H1-128.豊洲市場（5街区）,31,3,34,35.645162,139.785386,2024-02-08 11:15:04
814,N1-09.若宮レジデンス,1,4,5,35.716184,139.643905,2024-02-08 11:15:04
815,M6-12.LIVART SEASON 幡ヶ谷,0,16,16,35.683156,139.67338,2024-02-08 11:15:04
816,H1-142.東京ベイ潮見プリンスホテル,0,18,18,35.660632,139.817294,2024-02-08 11:15:04
817,G1-01.鐘ヶ淵駅南自転車駐車場,1,8,9,35.732291,139.82012,2024-02-08 11:15:04
818,M1-01.渋谷区役所,8,0,8,35.66362,139.69801,2024-02-08 11:15:04
819,I1-83.かもめ歩道橋,0,25,25,35.600161,139.749902,2024-02-08 11:15:04
820,N4-05.セブン-イレブン中野鍋横店,3,2,5,35.693815,139.668571,2024-02-08 11:15:04
821,D4-02.JICA市ヶ谷ビル（地球ひろば／研究所）,5,1,6,35.694927,139.731328,2024-02-08 11:15:04
822,T3-19.なかみや児童遊園,1,4,5,35.749388,139.651824,2024-02-08 11:15:04
823,N1-08.上鷺自転車保管場所,2,5,7,35.729056,139.627864,2024-02-08 11:15:04
824,O7-06.松木1丁目,2,11,13,35.686015,139.642784,2024-02-08 11:15:04
825,E4-16.ビレッジワン,1,6,7,35.723723,139.740143,2024-02-08 11:15:04
826,D1-15.フロンティア四谷,3,6,9,35.68768,139.71937,2024-02-08 11:15:04
827,K1-128.大森西3丁目,1,14,15,35.571975,139.732137,2024-02-08 11:15:04
828,N1-06.大和区民活動センター,0,5,5,35.713562,139.649075,2024-02-08 11:15:04
829,G4-01.両国ビューホテル1,1,6,7,35.69566,139.79214,2024-02-08 11:15:04
830,G4-02.両国ビューホテル2,0,8,8,35.69562,139.79206,2024-02-08 11:15:04
831,G4-05.両国駅西口臨時自転車駐車場,19,1,20,35.698588,139.792946,2024-02-08 11:15:04
832,G4-03.本所1-6-5,11,3,14,35.702525,139.796632,2024-02-08 11:15:04
833,G5-01.牡丹橋自転車駐車場,15,1,16,35.693059,139.813417,2024-02-08 11:15:04
834,G5-02.横川3-7-10,16,21,37,35.70378,139.814298,2024-02-08 11:15:04
835,G4-04.NTTドコモ墨田ビル,13,7,20,35.697898,139.795345,2024-02-08 11:15:04
836,G2-02.押上1-23-8,1,6,7,35.710111,139.81488,2024-02-08 11:15:04
837,C5-13.区立芝浦西運河沿緑地,8,31,39,35.638245,139.749754,2024-02-08 11:15:04
838,D6-12.東京ビジネスホテル,0,3,3,35.69342,139.710568,2024-02-08 11:15:04
839,D6-11.ホテルリステル新宿,0,6,6,35.693029,139.711327,2024-02-08 11:15:04
840,D6-10.ホテルサンライト新宿,3,0,3,35.694201,139.707047,2024-02-08 11:15:04
841,H1-39.辰巳駅東口自転車駐車場,22,3,25,35.645823,139.812178,2024-02-08 11:15:04
842,H1-38.辰巳駅西口自転車駐車場,89,0,89,35.646857,139.808912,2024-02-08 11:15:04
843,C2-10.元麻布三丁目,0,7,7,35.655865,139.730566,2024-02-08 11:15:04
844,C2-09.麻布地区総合支所,2,0,2,35.660614,139.734771,2024-02-08 11:15:04
845,M3-20.東急ステイ渋谷新南口,7,1,8,35.65494,139.70534,2024-02-08 11:15:04
846,I1-86.ファミリーマート二葉三丁目店,2,0,2,35.601694,139.719778,2024-02-08 11:15:04
847,A2-23.axle御茶ノ水,7,0,7,35.696126,139.763297,2024-02-08 11:15:04
848,C4-02.白金台いきいきプラザ,5,0,5,35.63756,139.724981,2024-02-08 11:15:04
849,N3-04.東中野駅地下駐輪場,0,13,13,35.707883,139.683284,2024-02-08 11:15:04
850,N3-05.中野坂上駅地下駐輪場,0,5,5,35.698068,139.682781,2024-02-08 11:15:04
851,N3-03.青桐公園,0,16,16,35.697024,139.677846,2024-02-08 11:15:04
852,N3-01.中野四季の森公園,5,5,10,35.708487,139.662135,2024-02-08 11:15:04
853,N4-01.本四公園,1,9,10,35.69693,139.672721,2024-02-08 11:15:04
854,N4-02.栄町公園,0,12,12,35.686474,139.671383,2024-02-08 11:15:04
855,K1-57.池上本門寺,5,1,6,35.579585,139.705377,2024-02-08 11:15:04
856,C1-49.汐留シティセンター,15,0,15,35.666213,139.760907,2024-02-08 11:15:04
857,C4-15.クロスレジデンス白金高輪,2,11,13,35.642771,139.733046,2024-02-08 11:15:04
858,K1-56.NTT馬込ビル,0,9,9,35.588106,139.718852,2024-02-08 11:15:04
859,J1-41.CASSIA目黒,1,8,9,35.631319,139.70237,2024-02-08 11:15:04
860,A2-22.専修大学,5,1,6,35.696147,139.753709,2024-02-08 11:15:04
861,T3-20.はやいち公園,2,2,4,35.75312,139.65661,2024-02-08 11:15:04
862,B3-19.本の森ちゅうおう,9,0,9,35.67363,139.77623,2024-02-08 11:15:04
863,K1-86.IMPREST STAY TOKYO 蒲田,22,0,22,35.556267,139.727246,2024-02-08 11:15:04
864,T3-23.氷川台二丁目緑地,3,1,4,35.756575,139.669689,2024-02-08 11:15:04
865,T3-22.氷川台三丁目ちびっこ公園,1,2,3,35.750547,139.66707,2024-02-08 11:15:04
866,B1-23.NANAEI日本橋,3,4,7,35.679616,139.784341,2024-02-08 11:15:04
867,B2-11.京橋エドグラン,12,0,12,35.677576,139.769822,2024-02-08 11:15:04
868,N1-05.大野ハイツ,2,3,5,35.7266,139.62948,2024-02-08 11:15:04
869,B2-09.茅場町一丁目平和ビル,10,0,10,35.680203,139.778679,2024-02-08 11:15:04
870,B2-08.共同ビル（茅場町交差点前）,9,0,9,35.681012,139.778569,2024-02-08 11:15:04
871,B2-07.東京証券会館（北側）,1,0,1,35.680864,139.779331,2024-02-08 11:15:04
872,O3-12.大宮前体育館,0,3,3,35.696567,139.610517,2024-02-08 11:15:04
873,B1-08.明治座,0,19,19,35.688038,139.786561,2024-02-08 11:15:04
874,B4-05.ドコモ・バイクシェア晴海ポート,0,28,28,35.654165,139.781568,2024-02-08 11:15:04
875,B4-04.ＫＤＸ晴海ビル,0,1,1,35.65443,139.77843,2024-02-08 11:15:04
876,B4-03.桜の散歩道（晴海トリトンスクエア前）,3,12,15,35.658665,139.782553,2024-02-08 11:15:04
877,E5-08.セブン-イレブン 文京動坂上店,2,3,5,35.727778,139.756296,2024-02-08 11:15:04
878,H1-65.ローソン南砂日曹橋店,5,10,15,35.669507,139.825553,2024-02-08 11:15:04
879,H1-66.中川船番所資料館,0,8,8,35.687732,139.846383,2024-02-08 11:15:04
880,K1-113.ファミリーマート大田上池台四丁目店,1,6,7,35.594658,139.700133,2024-02-08 11:15:04
881,H1-64.ローソン東雲駅前店,9,1,10,35.640228,139.804267,2024-02-08 11:15:04
882,E1-11.小石川運動場前,12,3,15,35.703914,139.747061,2024-02-08 11:15:04
883,T2-70.三ツ塚けやき緑地,2,2,4,35.720318,139.570762,2024-02-08 11:15:04
884,H1-137.住友不動産ショッピングシティ有明ガーデン,21,0,21,35.638985,139.793653,2024-02-08 11:15:04
885,C5-40.芝浦ふ頭駅前暫定自転車駐車場,3,1,4,35.64096,139.75754,2024-02-08 11:15:04
886,M3-21.渋谷ソラスタ,12,0,12,35.65618,139.69612,2024-02-08 11:15:04
887,D7-03.中井駅北,18,13,31,35.715645,139.687486,2024-02-08 11:15:04
888,K1-119.シーンズ大森パークサイド,4,0,4,35.58223,139.72763,2024-02-08 11:15:04
889,M6-15.cova Hatagaya,0,2,2,35.67741,139.67383,2024-02-08 11:15:04
890,C2-25.アパホテル＆リゾート＜六本木駅東＞,31,11,42,35.661783,139.737242,2024-02-08 11:15:04
891,D4-10.東新宿ポート(余丁町6番),0,6,6,35.696585,139.713081,2024-02-08 11:15:04
892,O1-02.井荻南地下自転車駐車場,7,7,14,35.72424,139.61431,2024-02-08 11:15:04
893,O1-03.LUCKY HOUSE,0,4,4,35.72489,139.62383,2024-02-08 11:15:04
894,D6-30.京王プラザホテル,6,1,7,35.6897,139.694823,2024-02-08 11:15:04
895,D6-29.都庁第二本庁舎前,13,0,13,35.688735,139.692249,2024-02-08 11:15:04
896,O3-02.アートメゾン荻窪,6,2,8,35.71355,139.6199,2024-02-08 11:15:04
897,J1-57.トレインチ自由が丘,5,0,5,35.606667,139.667324,2024-02-08 11:15:04
898,O2-01.サカエフラット荻窪,10,1,11,35.70535,139.61497,2024-02-08 11:15:04
899,O3-01.西田公園,1,6,7,35.69575,139.62065,2024-02-08 11:15:04
900,K1-47.NTT雪ヶ谷ビル,7,4,11,35.598601,139.684747,2024-02-08 11:15:04
901,O7-04.永福町西幸モータープール西,7,1,8,35.67161,139.64527,2024-02-08 11:15:04
902,K1-48.ファミリーマート大田上池台三丁目店,0,25,25,35.590934,139.696915,2024-02-08 11:15:04
903,K1-111.本羽田公園,4,3,7,35.546499,139.736761,2024-02-08 11:15:04
904,C1-58.ウォーターズ竹芝,3,7,10,35.655937,139.763251,2024-02-08 11:15:04
905,K1-109.萩中公園プール駐輪場,8,0,8,35.549323,139.737091,2024-02-08 11:15:04
906,K1-108.仲江名公園,2,2,4,35.557999,139.732564,2024-02-08 11:15:04
907,E1-17.小石川パークスクエア,1,9,10,35.713913,139.745416,2024-02-08 11:15:04
908,D6-23.アパホテル 東新宿 歌舞伎町西,0,2,2,35.697535,139.703633,2024-02-08 11:15:04
909,H1-98.洲崎川緑道公園,0,35,35,35.668705,139.810549,2024-02-08 11:15:04
910,H1-99.南砂三丁目公園,18,6,24,35.669695,139.831874,2024-02-08 11:15:04
911,H1-96.越中島公園,0,19,19,35.668757,139.790156,2024-02-08 11:15:04
912,H1-97.浜園公園,0,17,17,35.661852,139.802224,2024-02-08 11:15:04
913,H1-94.新木場一丁目緑地公園,8,1,9,35.64423,139.835823,2024-02-08 11:15:04
914,H1-95.若洲公園,7,17,24,35.619451,139.834429,2024-02-08 11:15:04
915,J1-09.ファミリーマート佐野久下目黒店,2,3,5,35.629252,139.712716,2024-02-08 11:15:04
916,H1-93.新木場一丁目公園,7,0,7,35.64143,139.835455,2024-02-08 11:15:04
917,I1-55.鈴ヶ森公園,0,21,21,35.593559,139.734704,2024-02-08 11:15:04
918,O6-04.柏の宮公園,0,5,5,35.67834,139.62711,2024-02-08 11:15:04
919,B4-14.Brillia ist Tower 勝どき,0,22,22,35.660526,139.776816,2024-02-08 11:15:04
920,D7-08.上落合3丁目,3,10,13,35.71115,139.68232,2024-02-08 11:15:04
921,H1-21.UR東雲キャナルコート,0,91,91,35.646041,139.804495,2024-02-08 11:15:04
922,H1-20.日本科学未来館,23,7,30,35.619377,139.777582,2024-02-08 11:15:04
923,H1-19.UR豊洲四丁目団地,11,10,21,35.653603,139.80144,2024-02-08 11:15:04
924,T2-45.風致地区バス停第三自転車駐車場,0,7,7,35.771068,139.586798,2024-02-08 11:15:04
925,H1-33.深川ギャザリア（ウエストスクエア）,0,29,29,35.66789,139.803,2024-02-08 11:15:04
926,H1-32.区営塩浜住宅前,0,24,24,35.664591,139.813954,2024-02-08 11:15:04
927,H1-23.KDX豊洲グランスクエア,11,3,14,35.648085,139.798986,2024-02-08 11:15:04
928,C2-22.飯倉公園,9,1,10,35.655649,139.74427,2024-02-08 11:15:04
929,I1-89.下神明駅自転車駐車場,5,0,5,35.608402,139.726118,2024-02-08 11:15:04
930,C5-39.お台場海浜公園東,11,2,13,35.631021,139.778109,2024-02-08 11:15:04
931,C5-38.お台場海浜公園乗船場,0,15,15,35.628743,139.773915,2024-02-08 11:15:04
932,O4-08.ローソン阿佐ヶ谷青梅街道店,0,5,5,35.703203,139.62804,2024-02-08 11:15:04
933,T2-72.高塚南緑地,5,1,6,35.733132,139.570311,2024-02-08 11:15:04
934,O6-03.みなみ荘,6,4,10,35.68073,139.62803,2024-02-08 11:15:04
935,K1-129.ローソン東糀谷一丁目店,0,8,8,35.557427,139.739126,2024-02-08 11:15:04
936,E1-03.東京ドーム（黄色いビル横）,8,0,8,35.70319,139.751888,2024-02-08 11:15:04
937,K1-23.大田区役所本庁舎前,6,1,7,35.561183,139.716339,2024-02-08 11:15:04
938,T2-78.北大泉くれはし公園,1,2,3,35.761474,139.592735,2024-02-08 11:15:04
939,J1-53.ボヌールAllamanda,3,2,5,35.612833,139.675047,2024-02-08 11:15:04
940,A3-39.トーシン東神田ビル,0,5,5,35.694834,139.780333,2024-02-08 11:15:04
941,O6-01.高井戸みどり公園,4,5,9,35.67912,139.61074,2024-02-08 11:15:04
942,T2-79.大泉学園町八丁目緑地,4,2,6,35.774457,139.596182,2024-02-08 11:15:04
943,O5-04.リヴィエール,17,3,20,35.70104,139.65839,2024-02-08 11:15:04
944,N3-08.中野区役所(西側),6,0,6,35.707968,139.663519,2024-02-08 11:15:04
945,I1-99.北品川２丁目,3,3,6,35.61663,139.74192,2024-02-08 11:15:04
946,P1-01.サンシャインシティ,7,0,7,35.728846,139.718577,2024-02-08 11:15:04
947,N3-14.ヴィラソンサ落合,0,6,6,35.713227,139.680966,2024-02-08 11:15:04
948,H1-49.セブン-イレブン 江東新砂３丁目店,0,20,20,35.667892,139.8311,2024-02-08 11:15:04
949,I1-06.大森貝塚遺跡庭園,9,0,9,35.593489,139.72967,2024-02-08 11:15:04
950,M2-12.恵比寿プライムスクエアタワー北,7,2,9,35.650541,139.713361,2024-02-08 11:15:04
951,H1-69.ファミリーマート 江東石島店,0,32,32,35.680474,139.812316,2024-02-08 11:15:04
952,B3-09.築地永谷コーポラス,0,12,12,35.66523,139.776313,2024-02-08 11:15:04
953,E4-10.白山四丁目第二児童遊園横,2,9,11,35.720349,139.746924,2024-02-08 11:15:04
954,I1-03.大井町駅中央口（西側）,7,0,7,35.605617,139.73472,2024-02-08 11:15:04
955,I1-04.大井町歩道橋,5,0,5,35.605146,139.734694,2024-02-08 11:15:04
956,I1-01.品川区役所 本庁舎前,10,0,10,35.609052,139.729825,2024-02-08 11:15:04
957,I1-02.品川区役所 第三庁舎前,9,0,9,35.608161,139.730048,2024-02-08 11:15:04
958,G4-08.ブオンサンヴァレンティーノ,0,6,6,35.691677,139.793857,2024-02-08 11:15:04
959,J1-13.洗足二丁目駐輪場,13,4,17,35.61061,139.693443,2024-02-08 11:15:04
960,J1-16.八雲橋自転車置場,3,3,6,35.617353,139.672256,2024-02-08 11:15:04
961,H1-189.MFLP新木場2,0,35,35,35.634453,139.824,2024-02-08 11:15:04
962,M6-09.ファミリーマート渋谷本町店,0,9,9,35.683756,139.684965,2024-02-08 11:15:04
963,H1-113.123+N東雲店,0,36,36,35.646366,139.801492,2024-02-08 11:15:04
964,J1-17.ファミリーマート原町二丁目店,0,6,6,35.613902,139.691476,2024-02-08 11:15:04
965,E5-21.動坂公園,1,10,11,35.73176,139.756669,2024-02-08 11:15:04
966,E5-20.本郷2丁目,0,8,8,35.704391,139.758575,2024-02-08 11:15:04
967,T2-48.武蔵関駅南第二自転車駐車場,1,3,4,35.726064,139.578015,2024-02-08 11:15:04
968,A6-26.相互半蔵門ビル,6,3,9,35.683378,139.743189,2024-02-08 11:15:04
969,J1-31.守屋図書館,13,7,20,35.634194,139.688833,2024-02-08 11:15:04
970,M3-19.渋谷キャスト,21,0,21,35.662146,139.702793,2024-02-08 11:15:04
971,N1-04.都立家政南駐輪場,0,10,10,35.721679,139.645265,2024-02-08 11:15:04
972,N2-02.江古田1丁目A,0,3,3,35.724988,139.672511,2024-02-08 11:15:04
973,C1-56.鈴与竹芝ビル,3,2,5,35.654873,139.762103,2024-02-08 11:15:04
974,D3-07.戸塚特別出張所,6,1,7,35.71429,139.70507,2024-02-08 11:15:04
975,G4-12.プレミアムキューブ両国,0,7,7,35.70103,139.803341,2024-02-08 11:15:04
976,A2-21.神田神保町3丁目,7,0,7,35.694578,139.754434,2024-02-08 11:15:04
977,B4-19.コーシャタワー佃,0,26,26,35.668044,139.785801,2024-02-08 11:15:04
978,I1-81.戸越6丁目,16,4,20,35.608127,139.717865,2024-02-08 11:15:04
979,A6-24.国立劇場,0,15,15,35.682218,139.743292,2024-02-08 11:15:04
980,E5-23.ビレッジ千駄木,0,6,6,35.722353,139.760966,2024-02-08 11:15:04
981,H1-119.榎戸材木店,0,6,6,35.638319,139.834741,2024-02-08 11:15:04
982,C5-29.Hi-NODE(ハイノード),7,1,8,35.651672,139.760549,2024-02-08 11:15:04
983,J1-22.NTTコミュニケーションズ唐ヶ崎ビル,0,4,4,35.627373,139.692044,2024-02-08 11:15:04
984,A2-18.猿楽町SSビル東,5,1,6,35.698654,139.759762,2024-02-08 11:15:04
985,A2-19.猿楽町SSビル西,2,0,2,35.698641,139.759306,2024-02-08 11:15:04
986,C1-55.アーバンネット内幸町ビル,19,1,20,35.669267,139.756018,2024-02-08 11:15:04
987,D4-06.グリーンフォート河田,0,12,12,35.697143,139.718739,2024-02-08 11:15:04
988,K1-134.東調布公園,3,7,10,35.588363,139.69042,2024-02-08 11:15:04
989,M5-18.Luxe初台,0,5,5,35.679182,139.68596,2024-02-08 11:15:04
990,D7-06.エムアイセミナーハウス,3,2,5,35.721064,139.677128,2024-02-08 11:15:04
991,A3-37.ポータル秋葉原,0,24,24,35.695737,139.78162,2024-02-08 11:15:04
992,M5-11.あおい通り,9,0,9,35.688154,139.698975,2024-02-08 11:15:04
993,E5-04.保健サービスセンター本郷支所,0,5,5,35.727046,139.760439,2024-02-08 11:15:04
994,E5-03.汐見地域活動センター（本郷図書館）,0,5,5,35.725538,139.76116,2024-02-08 11:15:04
995,E5-01.文京総合体育館,31,0,31,35.708121,139.763583,2024-02-08 11:15:04
996,E4-01.千石南自転車駐車場,5,20,25,35.72707,139.746112,2024-02-08 11:15:04
997,E3-03.大塚公園,4,17,21,35.724286,139.730954,2024-02-08 11:15:04
998,E3-02.教育の森公園,6,11,17,35.719345,139.736198,2024-02-08 11:15:04
999,I1-25.セブン-イレブン 品川旗の台2丁目店,0,3,3,35.607084,139.705007,2024-02-08 11:15:04
1000,B1-21.日本橋二丁目街角広場,10,0,10,35.680861,139.774493,2024-02-08 11:15:04
1001,C3-30.東京赤坂NKビル (ヴィアインプライム赤坂),9,0,9,35.672652,139.738908,2024-02-08 11:15:04
1002,A3-36.クロックカフェ東神田,0,5,5,35.694943,139.782718,2024-02-08 11:15:04
1003,E1-14.いきいき礫川,0,9,9,35.711147,139.747386,2024-02-08 11:15:04
1004,D4-09.トミンハイム仲之町,0,17,17,35.69617,139.722021,2024-02-08 11:15:04
1005,L1-08.NTT砧ビル,0,6,6,35.63534,139.601602,2024-02-08 11:15:04
1006,L1-09.コージーK・駒沢,1,2,3,35.632689,139.654804,2024-02-08 11:15:04
1007,L1-10.宮坂2-4-10,0,6,6,35.652913,139.644825,2024-02-08 11:15:04
1008,I1-22.ウィラ大井 (ショッピングモール),2,3,5,35.596579,139.745009,2024-02-08 11:15:04
1009,K1-76.グリーンベルト,9,0,9,35.585178,139.726339,2024-02-08 11:15:04
1010,H1-121.南砂5丁目,0,42,42,35.676603,139.829736,2024-02-08 11:15:04
1011,M3-02.文化総合センター大和田,5,0,5,35.65558,139.69966,2024-02-08 11:15:04
1012,D4-04.ジェノヴィア新宿早稲田グリーンヴェール,0,6,6,35.700033,139.71983,2024-02-08 11:15:04
1013,A3-20.神田ふれあい通り第２,2,0,2,35.695005,139.772747,2024-02-08 11:15:04
1014,H1-120.豊洲5丁目,18,0,18,35.650948,139.799711,2024-02-08 11:15:04
1015,C5-42.DHC芝浦2丁目ビル,2,6,8,35.644241,139.753834,2024-02-08 11:15:04
1016,I1-65.セブン-イレブン品川東大井1丁目店,7,0,7,35.605996,139.743037,2024-02-08 11:15:04
1017,M2-04.広尾東公園,5,1,6,35.653382,139.721059,2024-02-08 11:15:04
1018,M3-13.渋谷駅東口地下駐輪場,18,1,19,35.657682,139.703307,2024-02-08 11:15:04
1019,A3-19.神田ふれあい通り第１,0,7,7,35.694904,139.772712,2024-02-08 11:15:04
1020,O6-07.ローソン杉並宮前一丁目店,1,4,5,35.689639,139.613516,2024-02-08 11:15:04
1021,T3-10.貫井一丁目緑地,0,3,3,35.736378,139.632485,2024-02-08 11:15:04
1022,M2-05.日本赤十字医療センター,0,10,10,35.65519,139.718559,2024-02-08 11:15:04
1023,T2-20.パークサイド石神井,0,13,13,35.741769,139.591103,2024-02-08 11:15:04
1024,N4-06.ローソン中野本町新橋通り店,0,7,7,35.695819,139.674326,2024-02-08 11:15:04
1025,T3-07.徳殿公園,3,1,4,35.726728,139.65874,2024-02-08 11:15:04
1026,K1-35.セブン-イレブン 大田区西六郷2丁目店,0,13,13,35.549778,139.707362,2024-02-08 11:15:04
1027,A3-27.秋葉原駅中央口（ヨドバシカメラ前）,7,3,10,35.698986,139.774099,2024-02-08 11:15:04
1028,A3-28.秋葉原駅電気街口(西側交通広場),5,0,5,35.699173,139.772629,2024-02-08 11:15:04
1029,H1-57.新木場駅,8,57,65,35.64508,139.826456,2024-02-08 11:15:04
1030,H1-58.潮見駅,13,3,16,35.658703,139.817251,2024-02-08 11:15:04
1031,D7-02.セブン-イレブン 新宿中落合3丁目店,0,14,14,35.722202,139.691712,2024-02-08 11:15:04
1032,D2-06.飯田濠,14,0,14,35.70057,139.74301,2024-02-08 11:15:04
1033,C5-17.鈴与浜松町ビル,6,3,9,35.651103,139.759092,2024-02-08 11:15:04
1034,H1-59.LYURO 東京清澄,0,24,24,35.681316,139.792176,2024-02-08 11:15:04
1035,H1-60.荒川・砂町庭球場西,0,29,29,35.679678,139.844892,2024-02-08 11:15:04
1036,K1-44.中馬込貝塚公園,1,6,7,35.594795,139.704951,2024-02-08 11:15:04
1037,M6-11.京王サイクルパーク笹塚,0,5,5,35.674337,139.668801,2024-02-08 11:15:04
1038,J1-49.伊勢脇公園,1,3,4,35.638864,139.696568,2024-02-08 11:15:04
1039,K1-45.たぬき山公園,0,8,8,35.592801,139.715472,2024-02-08 11:15:04
1040,D2-01.あずさセンタービル,12,6,18,35.702286,139.741093,2024-02-08 11:15:04
1041,C1-02.西新橋1丁目（外堀通り）,3,2,5,35.668791,139.753582,2024-02-08 11:15:04
1042,O3-07.NTT井草ビル第1ポート,2,1,3,35.714044,139.61688,2024-02-08 11:15:04
1043,T2-41.ローソン 練馬東大泉五丁目店,1,3,4,35.74248,139.58715,2024-02-08 11:15:04
1044,H1-144.南砂住宅,0,16,16,35.674199,139.822018,2024-02-08 11:15:04
1045,C3-28.ヒューリックＪＰ赤坂ビル,11,0,11,35.672477,139.739743,2024-02-08 11:15:04
1046,H1-145.東雲都橋住宅,0,15,15,35.643131,139.797784,2024-02-08 11:15:04
1047,I1-58.品川区役所　第二庁舎前,18,0,18,35.609664,139.730006,2024-02-08 11:15:04
1048,K1-92.蒲田駅西口自転車駐車場,25,0,25,35.561101,139.715173,2024-02-08 11:15:04
1049,A2-24.水道橋駅西口前,6,0,6,35.702271,139.752619,2024-02-08 11:15:04
1050,K1-94.昭和島駅前,0,25,25,35.572188,139.749613,2024-02-08 11:15:04
1051,M5-15.新宿マインズタワー,18,2,20,35.686567,139.699355,2024-02-08 11:15:04
1052,D7-13.日本光電本社南側,11,4,15,35.71936,139.679083,2024-02-08 11:15:04
1053,N3-09.中野区役所(北側),5,0,5,35.708259,139.663829,2024-02-08 11:15:04
1054,H1-163.森下公園,3,2,5,35.68663,139.799529,2024-02-08 11:15:04
1055,B4-23.交通広場（豊海町）,0,16,16,35.653771,139.769295,2024-02-08 11:15:04
1056,D6-18.ヨドバシカメラ 新宿西口本店前,5,1,6,35.689689,139.698231,2024-02-08 11:15:04
1057,I1-47.NTT 東日本 関東病院(南側),7,0,7,35.630151,139.725215,2024-02-08 11:15:04
1058,H1-112.ファミリーマート江東塩浜二丁目店,0,43,43,35.66305,139.8087,2024-02-08 11:15:04
1059,K1-103.雪谷特別出張所,0,7,7,35.594515,139.691219,2024-02-08 11:15:04
1060,E5-17.Village藍染,0,5,5,35.720896,139.76422,2024-02-08 11:15:04
1061,I1-49.京急鮫洲バイク駐輪場,6,0,6,35.603815,139.741362,2024-02-08 11:15:04
1062,I1-50.京急立会川第2バイク駐輪場,0,12,12,35.599196,139.739158,2024-02-08 11:15:04
1063,E4-14.NTT東日本大塚ビル,0,17,17,35.726188,139.741375,2024-02-08 11:15:04
1064,M2-07.ファミリーマート恵比寿駅東店,7,0,7,35.6471,139.712818,2024-02-08 11:15:04
1065,M4-07.千駄ヶ谷駅前,2,2,4,35.68082,139.71188,2024-02-08 11:15:04
1066,O5-07.バーンホーフ キクチ,12,8,20,35.698169,139.655665,2024-02-08 11:15:04
1067,J1-11.コンフォリア目黒青葉台,0,6,6,35.649023,139.696086,2024-02-08 11:15:04
1068,L1-14.給田3丁目,1,12,13,35.664335,139.590114,2024-02-08 11:15:04
1069,B4-06.月島駅地下駐輪場,1,17,18,35.66291,139.782564,2024-02-08 11:15:04
1070,C5-09.グランパーク,20,1,21,35.643202,139.746244,2024-02-08 11:15:04
1071,C5-08.AQUACITY芝浦,5,6,11,35.637366,139.74844,2024-02-08 11:15:04
1072,C3-08.赤坂パークビルヂング,5,0,5,35.671792,139.733668,2024-02-08 11:15:04
1073,C3-07.新青山ビル,17,1,18,35.672659,139.725644,2024-02-08 11:15:04
1074,C3-06.ホテルアジア会館,0,12,12,35.67064,139.728166,2024-02-08 11:15:04
1075,C1-24.三田国際ビル,2,8,10,35.653159,139.744673,2024-02-08 11:15:04
1076,C5-07.港区立港南図書館,0,37,37,35.632842,139.7495,2024-02-08 11:15:04
1077,A3-04.秋葉原公園,2,15,17,35.697642,139.774867,2024-02-08 11:15:04
1078,A3-05.和泉公園（西側入口）,4,2,6,35.698817,139.778898,2024-02-08 11:15:04
1079,A3-02.絶滅メディア博物館（楓ビル）,8,0,8,35.689575,139.767848,2024-02-08 11:15:04
1080,O3-10.メゾンパークス,3,5,8,35.716265,139.618954,2024-02-08 11:15:04
1081,A2-05.神田橋公園,1,0,1,35.689665,139.764091,2024-02-08 11:15:04
1082,A3-01.神田児童公園（西側交番横）,4,2,6,35.692983,139.76773,2024-02-08 11:15:04
1083,A2-03.西神田公園（西側）,5,0,5,35.698338,139.754876,2024-02-08 11:15:04
1084,M6-03.十三号通り公園,0,7,7,35.675198,139.663587,2024-02-08 11:15:04
1085,M6-02.サイカパーク笹塚,0,11,11,35.673444,139.666553,2024-02-08 11:15:04
1086,H1-165.亀戸梅屋敷,0,10,10,35.701318,139.825916,2024-02-08 11:15:04
1087,H1-166.亀戸クロック,18,1,19,35.696574,139.82972,2024-02-08 11:15:04
1088,M5-02.あいおいニッセイ同和損保新宿ビル,1,3,4,35.684423,139.692262,2024-02-08 11:15:04
1089,M6-01.幡ヶ谷駅高架下第一,24,11,35,35.677175,139.676769,2024-02-08 11:15:04
1090,A5-02.山王パークタワー,4,1,5,35.673555,139.741293,2024-02-08 11:15:04
1091,K1-116.旧呑川緑地（大森東五丁目）,4,8,12,35.567176,139.742345,2024-02-08 11:15:04
1092,K1-115.旧呑川緑地（大森中三丁目）,0,7,7,35.565685,139.736195,2024-02-08 11:15:04
1093,K1-114.下丸子公園,6,2,8,35.568722,139.680736,2024-02-08 11:15:04
1094,T3-05.東武練馬駅南,0,10,10,35.767129,139.664365,2024-02-08 11:15:04
1095,T1-14.ファミリーマート 練馬高松五丁目北店,4,0,4,35.761038,139.623148,2024-02-08 11:15:04
1096,C3-29.高橋是清翁記念公園,5,2,7,35.674094,139.728895,2024-02-08 11:15:04
1097,K1-141.蒲田駅西口歩道,5,0,5,35.561291,139.715076,2024-02-08 11:15:04
1098,C3-35.ワールド北青山ビル,17,0,17,35.667069,139.713423,2024-02-08 11:15:04
1099,M5-03.代々木大山公園,9,7,16,35.671282,139.675307,2024-02-08 11:15:04
1100,E5-13.弥生二丁目,4,2,6,35.715592,139.76192,2024-02-08 11:15:04
1101,E5-12.NK本郷ビル,1,5,6,35.704475,139.763041,2024-02-08 11:15:04
1102,B3-18.銀座松竹スクエア,10,0,10,35.668395,139.769849,2024-02-08 11:15:04
1103,C1-44.三田Avanti,5,1,6,35.64115,139.741471,2024-02-08 11:15:04
1104,T2-31.ファミリーマート 石神井台二丁目店,0,10,10,35.739488,139.590273,2024-02-08 11:15:04
1105,H1-150.ホテルヴィラフォンテーヌ南側,8,1,9,35.636978,139.791858,2024-02-08 11:15:04
1106,H1-149.有明ガーデン 公園口,7,1,8,35.639132,139.793047,2024-02-08 11:15:04
1107,H1-148.大島七丁目団地,0,17,17,35.694104,139.840278,2024-02-08 11:15:04
1108,B4-26.東武ストア晴海三丁目店,0,14,14,35.654371,139.779545,2024-02-08 11:15:04
1109,J1-26.田向公園,3,4,7,35.623459,139.687128,2024-02-08 11:15:04
1110,J1-25.碑文谷公園,5,3,8,35.625081,139.682632,2024-02-08 11:15:04
1111,H1-195.東京アクアティクスセンター,6,13,19,35.65238,139.815613,2024-02-08 11:15:04
1112,T1-13.ファミリーマート 練馬土支田二丁目店,0,14,14,35.761613,139.61349,2024-02-08 11:15:04
1113,T2-34.ファミリーマート 練馬富士見台店,0,5,5,35.73969,139.62125,2024-02-08 11:15:04
1114,T2-35.ファミリーマート 石神井台六丁目店,0,6,6,35.738607,139.585331,2024-02-08 11:15:04
1115,C1-81.田町タワー,20,0,20,35.646534,139.748913,2024-02-08 11:15:04
1116,J1-07.目黒川船入場,14,1,15,35.641992,139.701588,2024-02-08 11:15:04
1117,J1-08.目黒区民センター公園,15,3,18,35.634533,139.708868,2024-02-08 11:15:04
1118,D4-01.市谷仲之町,2,4,6,35.695102,139.723345,2024-02-08 11:15:04
1119,M2-11.鉢山町,14,2,16,35.652151,139.698426,2024-02-08 11:15:04
1120,E4-08.ドコモ・バイクシェア向丘ポート,1,8,9,35.720546,139.756685,2024-02-08 11:15:04
1121,D4-03.市谷加賀町2丁目,0,10,10,35.695636,139.727882,2024-02-08 11:15:04
1122,N1-01.BeGood野方,0,9,9,35.719717,139.64785,2024-02-08 11:15:04
1123,C2-03.アークヒルズサウスタワー,10,1,11,35.666357,139.73923,2024-02-08 11:15:04
1124,C2-01.アークヒルズ（アーク森ビル）,6,4,10,35.667107,139.739565,2024-02-08 11:15:04
1125,C2-02.六本木ヒルズ,26,0,26,35.661158,139.728533,2024-02-08 11:15:04
1126,C5-03.港南公園C,8,18,26,35.624966,139.746657,2024-02-08 11:15:04
1127,C5-04.みなとパーク芝浦,10,1,11,35.646801,139.751208,2024-02-08 11:15:04
1128,C1-16.機械振興会館,6,0,6,35.659442,139.745549,2024-02-08 11:15:04
1129,C1-14.新橋プラザビル,0,9,9,35.664461,139.756082,2024-02-08 11:15:04
1130,H1-73.イシマビル,0,9,9,35.67386,139.79976,2024-02-08 11:15:04
1131,O7-01.西永福公園,4,1,5,35.67753,139.63667,2024-02-08 11:15:04
1132,O6-02.富士見ヶ丘南自転車駐車場,6,2,8,35.68296,139.60861,2024-02-08 11:15:04
1133,K1-50.テクノポートカマタ 第1,6,0,6,35.556199,139.721476,2024-02-08 11:15:04
1134,J1-14.二の橋自転車置場1,39,0,39,35.614856,139.678208,2024-02-08 11:15:04
1135,O3-08.NTT井草ビル第２ポート,0,3,3,35.714077,139.61694,2024-02-08 11:15:04
1136,H1-124.セブン-イレブン 江東海辺店,1,12,13,35.680636,139.817977,2024-02-08 11:15:04
1137,D1-11.三井ガーデンホテル神宮外苑の杜プレミア,5,0,5,35.679807,139.715931,2024-02-08 11:15:04
1138,O7-07.ハレ永福,1,7,8,35.678913,139.639944,2024-02-08 11:15:04
1139,C5-32.トレードピアお台場,4,1,5,35.627891,139.776896,2024-02-08 11:15:04
1140,B4-18.豊海センタービル,0,10,10,35.653531,139.769431,2024-02-08 11:15:04
1141,D5-04.西戸山公園野球場,2,5,7,35.707388,139.700204,2024-02-08 11:15:04
1142,D5-03.北新宿公園,0,14,14,35.702288,139.68862,2024-02-08 11:15:04
1143,D3-04.鶴巻南公園,0,23,23,35.706182,139.723394,2024-02-08 11:15:04
1144,D3-03.甘泉園公園,0,15,15,35.712431,139.715418,2024-02-08 11:15:04
1145,K1-03.池上会館,0,7,7,35.576593,139.706597,2024-02-08 11:15:04
1146,K1-02.平和の森公園,11,4,15,35.579049,139.739878,2024-02-08 11:15:04
1147,K1-01.大森海苔のふるさと館,0,13,13,35.57685,139.742496,2024-02-08 11:15:04
1148,D6-13.新宿中央公園（ジャブジャブ池下）,7,2,9,35.687652,139.689254,2024-02-08 11:15:04
1149,T2-28.ファミリーマート 南大泉六丁目店,3,2,5,35.752217,139.571095,2024-02-08 11:15:04
1150,K1-05.平和島公園プール,14,3,17,35.581832,139.741581,2024-02-08 11:15:04
1151,K1-04.京急蒲田駅東口,21,0,21,35.559483,139.724273,2024-02-08 11:15:04
1152,E2-10.音羽パークロード（北入口）,13,2,15,35.716586,139.727705,2024-02-08 11:15:04
1153,E2-11.音羽パークロード（キャッチボール場横）,13,7,20,35.715382,139.728533,2024-02-08 11:15:04
1154,I1-21.大井競馬場(正門前),10,0,10,35.593887,139.741204,2024-02-08 11:15:04
1155,J1-27.衾町公園,1,0,1,35.623215,139.668472,2024-02-08 11:15:04
1156,T2-44.中島橋自転車駐車場,5,2,7,35.75372,139.584332,2024-02-08 11:15:04
1157,B3-15.ACホテル・バイ・マリオット東京銀座,8,0,8,35.668845,139.765144,2024-02-08 11:15:04
1158,D5-07.百人町1丁目,2,4,6,35.699252,139.697606,2024-02-08 11:15:04
1159,C4-04.ショパン高輪,0,11,11,35.632128,139.732097,2024-02-08 11:15:04
1160,B1-18.セブン-イレブン 日本橋小網町店,2,1,3,35.681352,139.781436,2024-02-08 11:15:04
1161,T2-71.わかば児童公園,4,3,7,35.7211,139.574669,2024-02-08 11:15:04
1162,M3-15.co-ba ebisu,6,0,6,35.647076,139.703964,2024-02-08 11:15:04
1163,C2-20.三井ガーデンホテル六本木プレミア,4,0,4,35.66206,139.735501,2024-02-08 11:15:04
1164,I1-70.五反田リバーステーション,5,3,8,35.624566,139.72448,2024-02-08 11:15:04
1165,E5-25.ジェノヴィア東大前グリーンヴェール,7,4,11,35.711875,139.759306,2024-02-08 11:15:04
1166,D1-12.ジェノヴィア新宿御苑グリーンヴェール,1,6,7,35.689017,139.714755,2024-02-08 11:15:04
1167,C5-33.msb Tamachi,38,0,38,35.645682,139.748768,2024-02-08 11:15:04
1168,G4-09.SYFORME MORISHITA Ⅱ 1,1,0,1,35.690348,139.796133,2024-02-08 11:15:04
1169,G4-10.SYFORME MORISHITA Ⅱ 2,0,5,5,35.690307,139.796128,2024-02-08 11:15:04
1170,N3-19.上高田パーキング,0,16,16,35.715878,139.673669,2024-02-08 11:15:04
1171,F6-01.松坂屋上野店,4,0,4,35.707305,139.773657,2024-02-08 11:15:04
1172,F4-01.SYFORME ASAKUSA,0,4,4,35.718832,139.791133,2024-02-08 11:15:04
1173,F2-02.アップルパーク浅草6丁目第3,0,3,3,35.716062,139.799552,2024-02-08 11:15:04
1174,F2-01.松が谷2丁目2,0,20,20,35.71283,139.787754,2024-02-08 11:15:04
1175,F1-02.台東デザイナーズビレッジ,2,5,7,35.706023,139.783751,2024-02-08 11:15:04
1176,F2-03.台東区生涯学習センター,0,6,6,35.717497,139.790055,2024-02-08 11:15:04
1177,K1-146.南馬込6丁目25-11,0,3,3,35.582743,139.710561,2024-02-08 11:15:04
1178,F3-01.清川1丁目18-11,0,17,17,35.724944,139.801684,2024-02-08 11:15:04
1179,F1-03.新御徒町駅自転車駐車場,4,12,16,35.706793,139.782985,2024-02-08 11:15:04
1180,F3-02.台東区リバーサイドスポーツセンター,0,7,7,35.717571,139.804216,2024-02-08 11:15:04
1181,I1-45.セブン-イレブン品川西五反田3丁目店,4,1,5,35.62541,139.718135,2024-02-08 11:15:04
1182,H1-135.北砂5丁目団地,0,34,34,35.684218,139.832843,2024-02-08 11:15:04
1183,C3-16.赤坂ガーデンシティ,0,11,11,35.6738,139.731525,2024-02-08 11:15:04
1184,J1-34.田道広場公園,8,2,10,35.636269,139.709073,2024-02-08 11:15:04
1185,O5-08.セシオン杉並,1,2,3,35.69714,139.65432,2024-02-08 11:15:04
1186,A2-04.ちよだプラットフォームスクウェア,10,0,10,35.691456,139.762228,2024-02-08 11:15:04
1187,I1-102.J.GRAN Court 品川西大井 EAST,2,5,7,35.598244,139.722447,2024-02-08 11:15:04
1188,H1-196.フットサルクラブ東京東陽町,6,0,6,35.665288,139.824294,2024-02-08 11:15:04
1189,F2-04.コンフォラス浅草マンション,0,3,3,35.717241,139.801674,2024-02-08 11:15:04
1190,G5-03.京成リッチモンドホテル東京錦糸町,5,0,5,35.693492,139.81506,2024-02-08 11:15:04
1191,K1-27.六郷文化センター,1,3,4,35.544715,139.707623,2024-02-08 11:15:04
1192,K1-147.トヨタモビリティ東京GRGarage東京蒲田店,2,0,2,35.552741,139.718404,2024-02-08 11:15:04
1193,K1-148.トヨタモビリティ東京 蒲田仲六郷店,6,0,6,35.552068,139.71747,2024-02-08 11:15:04
1194,K1-150.トヨタモビリティ東京 池上第二京浜店,1,4,5,35.568019,139.696379,2024-02-08 11:15:04
1195,K1-149.トヨタモビリティ東京 大田店,1,5,6,35.59336,139.715879,2024-02-08 11:15:04
1196,C1-82.トヨタモビリティ東京 港三田店,0,5,5,35.647831,139.739048,2024-02-08 11:15:04
1197,D4-11.トヨタモビリティ東京 新宿明治通り南店,1,1,2,35.699835,139.70808,2024-02-08 11:15:04
1198,C3-31.赤坂一丁目,12,5,17,35.670239,139.744285,2024-02-08 11:15:04
1199,E1-04.礫川公園,35,6,41,35.707853,139.751518,2024-02-08 11:15:04
1200,M3-23.円山町7-1,1,8,9,35.658229,139.694885,2024-02-08 11:15:04
1201,M3-24.渋谷道玄坂２丁目駐輪場,3,15,18,35.66026,139.69684,2024-02-08 11:15:04
1202,T3-32.練馬北町1丁目,1,4,5,35.764452,139.666299,2024-02-08 11:15:04
1203,H1-197.セブン-イレブン江東南砂葛西橋通り店,0,4,4,35.675361,139.825034,2024-02-08 11:15:04
1204,T2-84.石神井町二丁目緑地,0,3,3,35.748395,139.605958,2024-02-08 11:15:04
1205,T2-82.梅の木児童遊園,1,4,5,35.737899,139.576584,2024-02-08 11:15:04
1206,T2-83.西大泉さくら緑地,4,4,8,35.760442,139.573145,2024-02-08 11:15:04
1207,D7-05.西落合図書館,7,1,8,35.725818,139.678976,2024-02-08 11:15:04
1208,D6-28.東急ステイ新宿,3,0,3,35.690899,139.706348,2024-02-08 11:15:04
1209,T2-85.泉新公園,3,1,4,35.7547,139.601497,2024-02-08 11:15:04
1210,T2-86.石神井町八丁目緑地,2,1,3,35.746956,139.600798,2024-02-08 11:15:04
1211,T2-87.南大泉四丁目児童遊園,0,4,4,35.745607,139.573947,2024-02-08 11:15:04
1212,T2-88.南大泉かたまち緑地,0,4,4,35.739633,139.570457,2024-02-08 11:15:04
1213,T2-89.南大泉三丁目児童遊園,0,3,3,35.742755,139.568335,2024-02-08 11:15:04
1214,E2-05.護国寺駅西自転車駐車場,20,1,21,35.719421,139.725584,2024-02-08 11:15:04
1215,J1-59.第44興和ビル,4,0,4,35.647704,139.693671,2024-02-08 11:15:04
1216,C1-15.東京タワー,11,5,16,35.65928,139.744767,2024-02-08 11:15:04
1217,C5-20.ローソン芝浦二丁目店,2,2,4,35.645254,139.754765,2024-02-08 11:15:04
1218,C2-27.有栖川宮記念公園第一,17,0,17,35.651382,139.724392,2024-02-08 11:15:04
1219,C2-28.有栖川宮記念公園第二,4,4,8,35.651129,139.726003,2024-02-08 11:15:04
1220,C2-29.狸穴公園,4,1,5,35.658204,139.738935,2024-02-08 11:15:04
1221,T2-90.南田中四丁目緑地,2,2,4,35.733195,139.612327,2024-02-08 11:15:04
1222,T2-91.石神井町四丁目緑地,5,0,5,35.745272,139.604579,2024-02-08 11:15:04
1223,A3-41.秋葉原ダイビル,5,0,5,35.698917,139.771856,2024-02-08 11:15:04
1224,J1-54.田道住区センター三田分室,5,0,5,35.638904,139.712518,2024-02-08 11:15:04
1225,H1-140.キャナルパレス住吉,12,4,16,35.689896,139.815116,2024-02-08 11:15:04
1226,C1-57.虎ノ門ツインビルディング,7,0,7,35.667259,139.745643,2024-02-08 11:15:04
1227,K1-54.ファミリーマート大田久が原五丁目店,0,16,16,35.579435,139.698552,2024-02-08 11:15:04
1228,B1-29.ASTILE日本橋浜町,1,7,8,35.685504,139.790817,2024-02-08 11:15:04
1229,N3-20.SYFORME NAKANO-SAKAUE,2,3,5,35.701157,139.679617,2024-02-08 11:15:04
1230,D6-31.東急歌舞伎町タワー駐輪場,3,7,10,35.696207,139.700521,2024-02-08 11:15:04
1231,I1-30.ローソン 大井三丁目店,6,1,7,35.603327,139.729006,2024-02-08 11:15:04
1232,K1-151.PATH仲六郷,10,0,10,35.549465,139.711157,2024-02-08 11:15:04
1233,H1-198.Br Tower 有明 MID CROSS,2,5,7,35.63464,139.783445,2024-02-08 11:15:04
1234,H1-04.石と光の広場（国際展示場駅）,41,21,62,35.63363,139.79082,2024-02-08 11:15:04
1235,B4-24.ミュプレ月島,5,2,7,35.66288,139.78329,2024-02-08 11:15:04
1236,H1-199.ラ・ヴェール東陽町,1,9,10,35.664244,139.814506,2024-02-08 11:15:04
1237,H1-200.ヴェッセル木場南,0,12,12,35.662414,139.813333,2024-02-08 11:15:04
1238,F1-04.台東2丁目21,0,5,5,35.703465,139.780325,2024-02-08 11:15:04
1239,F3-03.ヴェルステージ南千住,0,5,5,35.728704,139.801867,2024-02-08 11:15:04
1240,J1-46.五本木西みどり街かど公園,0,6,6,35.632735,139.683899,2024-02-08 11:15:04
1241,K1-131.東急武蔵新田駅駐輪場,11,4,15,35.567146,139.693344,2024-02-08 11:15:04
1242,K1-152.アットホームスクエア前,0,8,8,35.543327,139.703223,2024-02-08 11:15:04
1243,B2-04.清水建設本社（都営地下鉄宝町駅 Ａ８出口）,12,3,15,35.676119,139.772895,2024-02-08 11:15:04
1244,H1-202.辰巳の森海浜公園,7,5,12,35.648107,139.813572,2024-02-08 11:15:04
1245,H1-201.ウエリスアーバン水天宮前2,1,5,6,35.678099,139.791831,2024-02-08 11:15:04
1246,I1-103.五反田ＪＰビルディング,3,0,3,35.622389,139.721552,2024-02-08 11:15:04
1247,L1-16.上祖師谷7丁目,13,1,14,35.65838,139.59231,2024-02-08 11:15:04
1248,O5-09.AppCruise中野,1,1,2,35.700772,139.66063,2024-02-08 11:15:04
1249,H1-203.セブン-イレブン江東木場３丁目店,0,11,11,35.67517,139.804087,2024-02-08 11:15:04
1250,H1-44.テプコ豊洲ビル,25,0,25,35.648726,139.790877,2024-02-08 11:15:04
1251,L1-17.赤堤3丁目,3,4,7,35.659787,139.636696,2024-02-08 11:15:04
1252,L1-18.上北沢1丁目,20,10,30,35.662796,139.626795,2024-02-08 11:15:04
1253,B3-16.明石町区民館,0,1,1,35.666001,139.778102,2024-02-08 11:15:04
1254,I1-104.源氏前ビル,4,1,5,35.603521,139.712345,2024-02-08 11:15:04
1255,J1-28.宮前公園,0,8,8,35.617699,139.664826,2024-02-08 11:15:04
1256,M6-18.セブン-イレブン渋谷本町3丁目店,0,3,3,35.686521,139.685017,2024-02-08 11:15:04
1257,O7-08.杉並区和泉2-3-17,0,4,4,35.67187,139.65474,2024-02-08 11:15:04
1258,T1-17.セブン-イレブン練馬田柄通店,6,1,7,35.75987,139.640474,2024-02-08 11:15:04
1259,H1-18.東京ビッグサイト,7,9,16,35.631192,139.79401,2024-02-08 11:15:04
1260,M3-01.渋谷マークシティ,11,2,13,35.657726,139.697802,2024-02-08 11:15:04
1261,H1-70.有明スポーツセンター,13,4,17,35.63403,139.784319,2024-02-08 11:15:04
1262,H1-41.深川北スポーツセンター,2,11,13,35.676475,139.804741,2024-02-08 11:15:04
1263,H1-55.深川江戸資料館,3,6,9,35.681089,139.800777,2024-02-08 11:15:04
1264,I1-61.五反田文化センター,3,4,7,35.622588,139.716159,2024-02-08 11:15:04
1265,N3-13.中部すこやか福祉センター,3,2,5,35.700052,139.673715,2024-02-08 11:15:04
1266,A4-02.東京サンケイビル,10,0,10,35.686847,139.765151,2024-02-08 11:15:04
1267,M3-09.ティップ.クロス TOKYO 渋谷,10,9,19,35.661475,139.699296,2024-02-08 11:15:04
1268,B3-02.サンクンガーデン,2,4,6,35.670336,139.771911,2024-02-08 11:15:04
1269,T2-10.勤労福祉会館,5,0,5,35.748153,139.58765,2024-02-08 11:15:04
1270,K1-133.東京港野鳥公園,13,0,13,35.584217,139.759232,2024-02-08 11:15:04
1271,K1-21.六郷特別出張所,0,8,8,35.55079,139.716517,2024-02-08 11:15:04
1272,H1-54.砂町文化センター,3,17,20,35.680052,139.831874,2024-02-08 11:15:04
1273,D1-08.新宿歴史博物館,3,1,4,35.689984,139.725261,2024-02-08 11:15:04
1274,E1-05.春日地下自転車駐車場,23,3,26,35.708291,139.753335,2024-02-08 11:15:04
1275,E1-15.播磨坂事業所,0,5,5,35.71724,139.74289,2024-02-08 11:15:04
1276,E5-02.不忍通りふれあい館,0,12,12,35.719356,139.764308,2024-02-08 11:15:04
1277,E4-02.向丘地域活動センター,8,5,13,35.717357,139.757817,2024-02-08 11:15:04
1278,C3-18.明治記念館,4,1,5,35.678509,139.721207,2024-02-08 11:15:04
1279,D5-05.中央図書館,13,2,15,35.705018,139.706841,2024-02-08 11:15:04
1280,E2-07.肥後細川庭園,10,3,13,35.713223,139.721699,2024-02-08 11:15:04
1281,A1-05.富士見出張所,0,4,4,35.699187,139.746348,2024-02-08 11:15:04
1282,E5-07.湯島三丁目児童遊園,4,4,8,35.707296,139.769393,2024-02-08 11:15:04
1283,D5-10.桜美林大学 新宿キャンパス,1,6,7,35.705154,139.697562,2024-02-08 11:15:04
1284,A3-08.神田明神（神田神社）,11,2,13,35.702029,139.768245,2024-02-08 11:15:04
1285,E2-14.永青文庫 ミュージアム,5,0,5,35.713145,139.723342,2024-02-08 11:15:04
1286,M5-17.小田急サザンタワー,8,1,9,35.6866,139.70014,2024-02-08 11:15:04
1287,K1-16.ファミリーマート 矢口二丁目店,3,3,6,35.563092,139.693548,2024-02-08 11:15:04
1288,H1-206.北砂5丁目団地2,0,9,9,35.683866,139.831809,2024-02-08 11:15:04
1289,G1-02.八広駅高架下,4,10,14,35.727495,139.828499,2024-02-08 11:15:04
1290,F4-02.Risingplace浅草四番館,0,4,4,35.717963,139.791025,2024-02-08 11:15:04
1291,H1-204.大島四丁目団地2,4,4,8,35.68832,139.828829,2024-02-08 11:15:04
1292,H1-205.大島四丁目団地3,5,5,10,35.688236,139.827711,2024-02-08 11:15:04
1293,H1-106.亀戸中央公園,12,7,19,35.699874,139.834263,2024-02-08 11:15:04
1294,E5-30.湯島3丁目15,0,12,12,35.705148,139.769314,2024-02-08 11:15:04
1295,B4-38.HARUMI FLAG SUN VILLAGE,0,24,24,35.650347,139.771785,2024-02-08 11:15:04
1296,B4-32.HARUMI FLAG SEA VILLAGE,0,10,10,35.648731,139.774995,2024-02-08 11:15:04
1297,B4-31.HARUMI FLAG PORT VILLAGE,0,19,19,35.650604,139.77724,2024-02-08 11:15:04
1298,B4-33.HARUMI FLAG SEA VILLAGE,0,15,15,35.649552,139.776369,2024-02-08 11:15:04
1299,B4-36.HARUMI FLAG SEA VILLAGE,2,10,12,35.650742,139.778097,2024-02-08 11:15:04
1300,B4-35.HARUMI FLAG SEA VILLAGE,1,11,12,35.650573,139.777908,2024-02-08 11:15:04
1301,B4-37.HARUMI FLAG SUN VILLAGE,0,17,17,35.649419,139.771447,2024-02-08 11:15:04
1302,B4-34.HARUMI FLAG SEA VILLAGE,2,10,12,35.649932,139.776958,2024-02-08 11:15:04
1303,B4-39.HARUMI FLAG SUN VILLAGE,0,18,18,35.650863,139.772549,2024-02-08 11:15:04
1304,B4-40.HARUMI FLAG SUN VILLAGE,0,15,15,35.651305,139.773379,2024-02-08 11:15:04
1305,B4-41.HARUMI FLAG SUN VILLAGE,0,16,16,35.649854,139.77334,2024-02-08 11:15:04
1306,B4-42.HARUMI FLAG SUN VILLAGE,0,13,13,35.649329,139.772656,2024-02-08 11:15:04
1307,B4-28.HARUMI FLAG PORT VILLAGE,4,7,11,35.651183,139.776119,2024-02-08 11:15:04
1308,B4-50.HARUMI FLAG PARK VILLAGE,1,8,9,35.648295,139.773973,2024-02-08 11:15:04
1309,B4-49.HARUMI FLAG PARK VILLAGE,4,12,16,35.648636,139.774251,2024-02-08 11:15:04
1310,B4-48.HARUMI FLAG PARK VILLAGE,0,5,5,35.649513,139.775287,2024-02-08 11:15:04
1311,B4-47.HARUMI FLAG PARK VILLAGE,2,4,6,35.649119,139.775138,2024-02-08 11:15:04
1312,B4-46.HARUMI FLAG PARK VILLAGE,0,26,26,35.649642,139.773859,2024-02-08 11:15:04
1313,B4-45.HARUMI FLAG PARK VILLAGE,0,26,26,35.649002,139.772764,2024-02-08 11:15:04
1314,B4-44.HARUMI FLAG PARK VILLAGE,3,10,13,35.648221,139.772666,2024-02-08 11:15:04
1315,B4-30.HARUMI FLAG PORT VILLAGE,1,10,11,35.651136,139.778218,2024-02-08 11:15:04
1316,B4-29.HARUMI FLAG PORT VILLAGE,0,18,18,35.651907,139.777391,2024-02-08 11:15:04
1317,L1-19.三軒茶屋1丁目駐輪場,1,3,4,35.639302,139.674744,2024-02-08 11:15:04
1318,O7-09.方南月極パーキング,8,10,18,35.678921,139.658289,2024-02-08 11:15:04
1319,O5-10.ローソン ツルハドラッグ杉並和田店,0,4,4,35.68942,139.662118,2024-02-08 11:15:04
1320,O2-04.西荻北1丁目,2,3,5,35.708082,139.607543,2024-02-08 11:15:04
1321,K1-75.三井不動産インダストリアルパーク羽田,6,4,10,35.556231,139.751408,2024-02-08 11:15:04
1322,F1-05.ホウエイコート秋葉原,0,2,2,35.703024,139.78052,2024-02-08 11:15:04
1323,C3-36.第35興和ビル,2,2,4,35.666349,139.741781,2024-02-08 11:15:04
1324,B4-53.晴海五丁目ターミナル,24,82,106,35.651627,139.773103,2024-02-08 11:15:04
1325,C5-44.ブランズタワー芝浦,9,0,9,35.643105,139.753039,2024-02-08 11:15:04
1326,A3-47.ホテルヴィラフォンテーヌ東京大手町,13,0,13,35.690602,139.766916,2024-02-08 11:15:04
1327,A1-20.菱和パレス九段,4,1,5,35.693021,139.740317,2024-02-08 11:15:04
0,E5-26.本郷4丁目,3,0,3,35.708596,139.758269,2024-02-08 18:17:04
1,A3-42.内神田3丁目,20,15,35,35.692599,139.770109,2024-02-08 18:17:04
2,T2-76.東中前の森緑地,3,2,5,35.748736,139.574839,2024-02-08 18:17:04
3,A2-20.神田スクエア,2,16,18,35.693408,139.762809,2024-02-08 18:17:04
4,K1-79.Tマークシティホテル東京大森,7,0,7,35.586993,139.736491,2024-02-08 18:17:04
5,K1-80.大森北6丁目,3,1,4,35.579849,139.731241,2024-02-08 18:17:04
6,H1-130.トヨタモビリティ東京 深川店,8,2,10,35.676643,139.816054,2024-02-08 18:17:04
7,H1-131.セブン-イレブン 江東佐賀2丁目店,3,2,5,35.679029,139.793535,2024-02-08 18:17:04
8,H1-132.セブン-イレブン 江東三好4丁目店,0,6,6,35.681418,139.809287,2024-02-08 18:17:04
9,A6-22.半蔵門PREX South,12,2,14,35.683433,139.740756,2024-02-08 18:17:04
10,I1-74.セブン-イレブン西五反田6丁目店,2,3,5,35.622403,139.71771,2024-02-08 18:17:04
11,G2-01.東京ソラマチ,5,2,7,35.709777,139.810189,2024-02-08 18:17:04
12,T2-59.平成公園,2,1,3,35.722917,139.587864,2024-02-08 18:17:04
13,Z15.ファミリーマート藤崎一丁目店,4,2,6,35.52928,139.722762,2024-02-08 18:17:04
14,I1-26.大崎西口公園,0,24,24,35.617475,139.729221,2024-02-08 18:17:04
15,I1-96.西五反田２丁目,6,4,10,35.627599,139.720463,2024-02-08 18:17:04
16,H1-172.サンヨーパシフィックマンション,0,4,4,35.668856,139.794069,2024-02-08 18:17:04
17,J1-56.青葉台四丁目街かど公園,2,2,4,35.654009,139.692727,2024-02-08 18:17:04
18,H1-173.森下駅前,39,0,39,35.687837,139.79654,2024-02-08 18:17:04
19,E3-01.大塚地域活動センター跡地,6,4,10,35.718656,139.734556,2024-02-08 18:17:04
20,E2-03.目白台運動公園,39,0,39,35.715556,139.721988,2024-02-08 18:17:04
21,T2-77.大泉なかよし緑地,4,0,4,35.759861,139.581682,2024-02-08 18:17:04
22,E2-01.江戸川橋Ｂ自転車駐車場,52,29,81,35.710381,139.732137,2024-02-08 18:17:04
23,E2-02.江戸川公園,16,4,20,35.710958,139.731165,2024-02-08 18:17:04
24,D7-14.大栄パーク西落合１丁目,6,0,6,35.720028,139.678936,2024-02-08 18:17:04
25,E1-07.礫川地域活動センター,9,1,10,35.712015,139.750284,2024-02-08 18:17:04
26,M6-05.七号通り公園,4,2,6,35.67917,139.67493,2024-02-08 18:17:04
27,H1-138.HW.HILLS新大橋,11,0,11,35.687416,139.795588,2024-02-08 18:17:04
28,B4-21.月島駅前第一駐輪場,12,16,28,35.663681,139.785651,2024-02-08 18:17:04
29,N2-03.野方1丁目,6,1,7,35.712179,139.65603,2024-02-08 18:17:04
30,C5-52.港南四丁目第3アパート駐車場,11,0,11,35.630109,139.747094,2024-02-08 18:17:04
31,E5-27.真正館駐車場,1,2,3,35.714875,139.76394,2024-02-08 18:17:04
32,C5-35.品川駅港南口,5,1,6,35.62822,139.741135,2024-02-08 18:17:04
33,N2-01.NTT野方ビル,3,2,5,35.710285,139.66173,2024-02-08 18:17:04
34,D6-27.新宿三井ビルディング二号館,1,8,9,35.686334,139.692881,2024-02-08 18:17:04
35,D1-10.曙橋駐輪場,14,2,16,35.691888,139.724365,2024-02-08 18:17:04
36,I1-39.MID POINT 目黒不動前,2,2,4,35.628116,139.713149,2024-02-08 18:17:04
37,E3-07.小日向1丁目,6,0,6,35.713388,139.737009,2024-02-08 18:17:04
38,C1-47.パークプレイス三田,9,0,9,35.641791,139.740734,2024-02-08 18:17:04
39,I1-38.ローソン 八潮三丁目店,6,39,45,35.594544,139.760423,2024-02-08 18:17:04
40,C2-24.Dash Living HigashiAzabu,6,0,6,35.655135,139.744449,2024-02-08 18:17:04
41,J1-04.菅刈公園,4,4,8,35.650351,139.692853,2024-02-08 18:17:04
42,O4-09.ローソン杉並本天沼一丁目店,1,2,3,35.712496,139.632778,2024-02-08 18:17:04
43,T3-29.平和台もものき緑地,1,2,3,35.755773,139.661913,2024-02-08 18:17:04
44,D2-10.市谷砂土原町3丁目,12,0,12,35.696242,139.735776,2024-02-08 18:17:04
45,C1-48.竹芝客船ターミナル,0,18,18,35.655139,139.762812,2024-02-08 18:17:04
46,B1-06.伊場仙ビル,3,2,5,35.687624,139.777125,2024-02-08 18:17:04
47,B2-01.鉄砲洲児童公園（西側）,4,2,6,35.67224,139.779348,2024-02-08 18:17:04
48,B1-04.産業会館,3,0,3,35.694164,139.787057,2024-02-08 18:17:04
49,B1-05.日本橋保健センター,0,12,12,35.687419,139.779053,2024-02-08 18:17:04
50,B2-05.ＮＴＴ東日本築地ビル,0,4,4,35.670674,139.775993,2024-02-08 18:17:04
51,B2-02.柳通り（東京スクエアガーデン前）,0,18,18,35.676393,139.768319,2024-02-08 18:17:04
52,B2-03.男女平等センター（ブーケ21）,8,3,11,35.673923,139.778671,2024-02-08 18:17:04
53,C2-13.麻布運動場,6,1,7,35.651718,139.728165,2024-02-08 18:17:04
54,D2-08.旧市ヶ谷商業高校,2,4,6,35.70074,139.731363,2024-02-08 18:17:04
55,C1-35.セブン-イレブン 三田駅北店,3,2,5,35.649032,139.750147,2024-02-08 18:17:04
56,B4-12.THE TOKYO TOWERS,3,1,4,35.655497,139.774556,2024-02-08 18:17:04
57,C5-21.セブン-イレブン 芝浦3丁目店,5,1,6,35.642399,139.746992,2024-02-08 18:17:04
58,H1-67.セブン-イレブン 江東亀戸9丁目店,6,7,13,35.69766,139.843408,2024-02-08 18:17:04
59,C2-15.住友不動産六本木グランドタワー,0,47,47,35.664367,139.737185,2024-02-08 18:17:04
60,C2-14.元麻布ヒルズ,7,3,10,35.653608,139.73138,2024-02-08 18:17:04
61,M6-14.ドコモショップ笹塚店,4,0,4,35.67323,139.66393,2024-02-08 18:17:04
62,N4-07.南台2丁目,11,0,11,35.68509,139.671102,2024-02-08 18:17:04
63,K1-68.ART FACTORY 城南島,0,13,13,35.580511,139.775957,2024-02-08 18:17:04
64,H1-178.北砂7丁目団地(第二),2,2,4,35.678031,139.837193,2024-02-08 18:17:04
65,H1-179.北砂7丁目団地(第三),6,5,11,35.678246,139.8366,2024-02-08 18:17:04
66,A1-17.雉子橋集積所,6,0,6,35.692605,139.755761,2024-02-08 18:17:04
67,H1-177.北砂7丁目団地(第一),1,4,5,35.678537,139.837391,2024-02-08 18:17:04
68,K1-95.城南島海浜公園,10,6,16,35.578259,139.783505,2024-02-08 18:17:04
69,B3-17.銀座6丁目-SQUARE,0,28,28,35.66711,139.76643,2024-02-08 18:17:04
70,J1-33.芳窪街かど公園,13,1,14,35.629861,139.666293,2024-02-08 18:17:04
71,N3-07.なかのZERO,4,1,5,35.70442,139.67141,2024-02-08 18:17:04
72,N4-04.弥生町5丁目,8,4,12,35.690897,139.668345,2024-02-08 18:17:04
73,A3-44.THE WAVES AKIHABARA,3,1,4,35.694679,139.779504,2024-02-08 18:17:04
74,K1-138.羽田エアポートガーデン,0,11,11,35.544534,139.763244,2024-02-08 18:17:04
75,C3-26.ホテルリブマックス赤坂,0,5,5,35.67011,139.733375,2024-02-08 18:17:04
76,C1-52.NTT三田ビル,5,1,6,35.652549,139.747789,2024-02-08 18:17:04
77,D1-07.Dash Living Shinjuku,2,1,3,35.689757,139.710091,2024-02-08 18:17:04
78,O4-07.ローソン成田西三丁目店,1,4,5,35.690311,139.62178,2024-02-08 18:17:04
79,H1-152.コンポジット亀戸ウエスト,0,6,6,35.699187,139.82429,2024-02-08 18:17:04
80,E1-13.エルアージュ小石川,6,1,7,35.71399,139.75137,2024-02-08 18:17:04
81,B4-22.リビオレゾン勝どきNEX,7,1,8,35.65554,139.77102,2024-02-08 18:17:04
82,H1-176.JMFビル東陽町02,0,9,9,35.667677,139.823552,2024-02-08 18:17:04
83,H1-102.ファミリーマート東砂七丁目店,6,1,7,35.672714,139.837914,2024-02-08 18:17:04
84,H1-101.ファミリーマート新木場一丁目店,0,13,13,35.642571,139.836766,2024-02-08 18:17:04
85,K1-67.京浜島防災広場,0,36,36,35.570508,139.764013,2024-02-08 18:17:04
86,K1-66.昭和島二丁目公園,0,17,17,35.575097,139.751446,2024-02-08 18:17:04
87,Z11.ファミリーマートＭＧ川崎昭和店,1,3,4,35.528868,139.737762,2024-02-08 18:17:04
88,I1-80.リバーサイド品川港南ビル,8,2,10,35.622714,139.74471,2024-02-08 18:17:04
89,J1-10.NTTデータ駒場研修センター,10,0,10,35.655779,139.680948,2024-02-08 18:17:04
90,A2-17.竹橋ビル,0,10,10,35.692396,139.75639,2024-02-08 18:17:04
91,H1-91.亀戸駅北口第三自転車駐車場,16,2,18,35.696913,139.823911,2024-02-08 18:17:04
92,H1-92.亀戸駅東口第二自転車駐車場,5,9,14,35.69788,139.830559,2024-02-08 18:17:04
93,K1-59.京急梅屋敷第1駐車場,7,0,7,35.565768,139.727396,2024-02-08 18:17:04
94,K1-60.京急平和島第1駐車場,9,0,9,35.576336,139.733691,2024-02-08 18:17:04
95,I1-42.京急青横駐車場,3,0,3,35.611582,139.742528,2024-02-08 18:17:04
96,I1-43.京急南大井駐車場,9,0,9,35.594722,139.737101,2024-02-08 18:17:04
97,Z01.NTTドコモ川崎ビル,0,9,9,35.528801,139.694661,2024-02-08 18:17:04
98,O7-05.ジーベック方南町,1,1,2,35.680849,139.65626,2024-02-08 18:17:04
99,H1-100.URアーバンライフ亀戸,26,3,29,35.697935,139.821855,2024-02-08 18:17:04
100,A6-10.紀尾井町ビル（西側）,5,6,11,35.682516,139.736494,2024-02-08 18:17:04
101,C3-02.赤坂地区総合支所,0,7,7,35.674788,139.731423,2024-02-08 18:17:04
102,C2-08.ファミリーマート西麻布霞町店,0,5,5,35.661673,139.721118,2024-02-08 18:17:04
103,A6-09.紀尾井町ビル（北側）,1,5,6,35.682902,139.736494,2024-02-08 18:17:04
104,H1-28.有明客船ターミナル,5,6,11,35.630063,139.792209,2024-02-08 18:17:04
105,B1-12.ファミリーマート堀留町二丁目店,0,15,15,35.687786,139.78205,2024-02-08 18:17:04
106,H1-26.青海客船ターミナル,0,27,27,35.619234,139.774485,2024-02-08 18:17:04
107,H1-27.パレットタウン乗船場,10,0,10,35.624467,139.781305,2024-02-08 18:17:04
108,K1-121.東京広域ポート（川崎LiSE）,3,7,10,35.540579,139.754506,2024-02-08 18:17:04
109,K1-122.東急新丸子駅駐輪場,8,5,13,35.581347,139.662265,2024-02-08 18:17:04
110,K1-123.東急新丸子駅（東）駐輪場,9,3,12,35.577794,139.660751,2024-02-08 18:17:04
111,O1-04.井草1-34,9,6,15,35.72758,139.62432,2024-02-08 18:17:04
112,C1-76.浜松町駅北口交通広場(ハマサイト前),8,6,14,35.656647,139.758301,2024-02-08 18:17:04
113,J1-52.駒沢一丁目公園前,9,0,9,35.629807,139.662398,2024-02-08 18:17:04
114,C1-75.虎ノ門PFビル,0,17,17,35.665466,139.748014,2024-02-08 18:17:04
115,B2-18.旭ビルディング,7,4,11,35.678291,139.78157,2024-02-08 18:17:04
116,N2-09.松山駐車場No.1,2,4,6,35.722991,139.673048,2024-02-08 18:17:04
117,I1-82.トミンハイム西五反田四丁目,4,2,6,35.627386,139.711182,2024-02-08 18:17:04
118,O4-03.ザ・ハウス,0,12,12,35.707035,139.633066,2024-02-08 18:17:04
119,O4-04.阿佐谷南3-43,13,3,16,35.704147,139.631955,2024-02-08 18:17:04
120,K1-83.北千束北児童公園,5,1,6,35.611085,139.68599,2024-02-08 18:17:04
121,I1-95.東京レールゲート EAST,0,17,17,35.584998,139.761055,2024-02-08 18:17:04
122,M5-19.グランリヴィエール代々木,0,6,6,35.68285,139.698528,2024-02-08 18:17:04
123,Z14.ファミリーマート川崎中瀬店,7,2,9,35.537163,139.729625,2024-02-08 18:17:04
124,H1-192.ウエリスアーバン水天宮前,4,0,4,35.678296,139.791949,2024-02-08 18:17:04
125,N2-08.江古田区民活動センター,3,1,4,35.728893,139.670119,2024-02-08 18:17:04
126,D7-04.セブン-イレブン 新宿下落合3丁目店,3,0,3,35.722645,139.701982,2024-02-08 18:17:04
127,Z16.ファミリーマート川崎浜町四丁目店,4,2,6,35.515344,139.722229,2024-02-08 18:17:04
128,K1-82.西蒲田公園,4,3,7,35.561499,139.71123,2024-02-08 18:17:04
129,H1-68.芝浦工業大学附属中学高等学校,8,1,9,35.649274,139.792213,2024-02-08 18:17:04
130,K1-24.東糀谷防災公園,0,30,30,35.557074,139.74575,2024-02-08 18:17:04
131,H1-03.東雲駅,0,29,29,35.640736,139.804331,2024-02-08 18:17:04
132,K1-26.大森諏訪公園,0,2,2,35.574785,139.730762,2024-02-08 18:17:04
133,K1-25.鶴渡公園,2,2,4,35.56892,139.725082,2024-02-08 18:17:04
134,N3-10.エーエスホームズⅡ駐車場,2,4,6,35.702659,139.662563,2024-02-08 18:17:04
135,J1-37.中目黒公園,14,4,18,35.640398,139.704069,2024-02-08 18:17:04
136,A1-10.ヒューリック九段ビル,0,9,9,35.696449,139.750784,2024-02-08 18:17:04
137,K1-93.六間堀仲羽公園,0,4,4,35.548864,139.74484,2024-02-08 18:17:04
138,T2-53.上練馬公園,2,2,4,35.772863,139.626969,2024-02-08 18:17:04
139,M5-01.初台駅南口,7,5,12,35.680154,139.685937,2024-02-08 18:17:04
140,C1-60.専売ビル,8,5,13,35.647659,139.745055,2024-02-08 18:17:04
141,K1-85.大田区青少年交流センター ゆいっつ,0,11,11,35.583555,139.743381,2024-02-08 18:17:04
142,I1-64.株式会社ユアス ゆうパック取扱所：ポストのうしろ,2,6,8,35.622965,139.731014,2024-02-08 18:17:04
143,C4-09.ケーヨーデイツー三田店,5,0,5,35.646375,139.740061,2024-02-08 18:17:04
144,C1-61.環三浜松町駅南,16,21,37,35.653096,139.75739,2024-02-08 18:17:04
145,K1-84.佐伯山緑地,7,3,10,35.581698,139.71491,2024-02-08 18:17:04
146,C1-59.セレスティン芝三井ビルディング,8,5,13,35.650845,139.748346,2024-02-08 18:17:04
147,G2-07.レオーネ押上cube,4,0,4,35.706167,139.815955,2024-02-08 18:17:04
148,E1-06.文京シビックセンター,10,9,19,35.708265,139.751983,2024-02-08 18:17:04
149,D2-13.THE CENTER TOKYO,7,0,7,35.695646,139.725722,2024-02-08 18:17:04
150,E5-22.千駄木2丁目,2,3,5,35.724828,139.762583,2024-02-08 18:17:04
151,C4-07.品川プリンスホテル,9,1,10,35.628266,139.734171,2024-02-08 18:17:04
152,A3-43.unito CHIYODA,1,2,3,35.69474,139.77929,2024-02-08 18:17:04
153,C4-06.白金プラチナレジデンス,0,7,7,35.644134,139.723432,2024-02-08 18:17:04
154,I1-63.セブン-イレブン西五反田店,0,2,2,35.62765,139.719212,2024-02-08 18:17:04
155,H1-53.豊洲シビックセンター,9,8,17,35.653991,139.795513,2024-02-08 18:17:04
156,T3-16.練馬区役所東庁舎(第一),8,2,10,35.735428,139.652379,2024-02-08 18:17:04
157,T2-68.さくら原っぱ緑地,3,2,5,35.731372,139.619164,2024-02-08 18:17:04
158,T2-69.久保新田さくら公園,1,3,4,35.76525,139.575978,2024-02-08 18:17:04
159,H1-187.森下文化センター,5,0,5,35.685344,139.80234,2024-02-08 18:17:04
160,E4-04.セブン-イレブン 文京本駒込１丁目店,5,0,5,35.724707,139.750469,2024-02-08 18:17:04
161,M2-13.恵比寿プライムスクエアタワー南,7,1,8,35.649257,139.713272,2024-02-08 18:17:04
162,H1-48.セブン-イレブン 江東潮見２丁目店,0,13,13,35.658249,139.815775,2024-02-08 18:17:04
163,H1-51.豊洲交通広場　東,0,36,36,35.654958,139.795718,2024-02-08 18:17:04
164,H1-52.辰巳駅,0,71,71,35.646756,139.809295,2024-02-08 18:17:04
165,D7-01.下落合図書館,10,5,15,35.715894,139.698578,2024-02-08 18:17:04
166,H1-50.豊洲交通広場　北,0,59,59,35.655457,139.795161,2024-02-08 18:17:04
167,A6-14.MG市ヶ谷ビルディング,0,5,5,35.690861,139.736393,2024-02-08 18:17:04
168,T2-21.ファミリーマート 練馬大泉町一丁目店,2,2,4,35.768448,139.601679,2024-02-08 18:17:04
169,A6-15.東急番町ビル,3,1,4,35.688929,139.7358,2024-02-08 18:17:04
170,A1-18.東京区政会館別館(特別区研修所),4,1,5,35.696202,139.752351,2024-02-08 18:17:04
171,T3-18.練馬駅北,7,12,19,35.738585,139.653396,2024-02-08 18:17:04
172,C1-43.KDX浜松町プレイス,0,8,8,35.658169,139.752509,2024-02-08 18:17:04
173,C5-27.プレミア海岸ビル,15,6,21,35.648948,139.757895,2024-02-08 18:17:04
174,I1-29.ローソン 勝島一丁目店,0,10,10,35.599987,139.745195,2024-02-08 18:17:04
175,H1-72.ネクストサイト深川ビル,19,0,19,35.674578,139.797396,2024-02-08 18:17:04
176,T1-11.むつみ台,0,6,6,35.768528,139.639807,2024-02-08 18:17:04
177,T1-10.月見大橋下,3,2,5,35.758366,139.628982,2024-02-08 18:17:04
178,H1-167.大島八丁目公園,10,0,10,35.688074,139.838932,2024-02-08 18:17:04
179,K1-36.セブン-イレブン 大田区南雪谷5丁目店,4,0,4,35.587815,139.691748,2024-02-08 18:17:04
180,L1-01.羽根木公園,6,6,12,35.66088,139.654546,2024-02-08 18:17:04
181,P1-02.雑司ヶ谷一丁目,8,0,8,35.721738,139.723103,2024-02-08 18:17:04
182,I1-66.南大井文化センター駐車場,6,0,6,35.596733,139.73804,2024-02-08 18:17:04
183,L1-05.NTT烏山ビル,0,4,4,35.669285,139.597931,2024-02-08 18:17:04
184,L1-04.下馬中央公園,4,1,5,35.63367,139.678139,2024-02-08 18:17:04
185,L1-03.世田谷城阯公園,2,4,6,35.645838,139.647799,2024-02-08 18:17:04
186,L1-02.若林公園,5,2,7,35.647075,139.654472,2024-02-08 18:17:04
187,T2-30.ファミリーマート 練馬東大泉四丁目店,2,1,3,35.750804,139.58243,2024-02-08 18:17:04
188,L1-07.NTT成城ビル,2,1,3,35.648021,139.606529,2024-02-08 18:17:04
189,L1-06.NTT瀬田ビル,0,11,11,35.618357,139.626191,2024-02-08 18:17:04
190,T3-12.春日町西公園,4,0,4,35.748092,139.636587,2024-02-08 18:17:04
191,T3-13.平和台児童公園,2,2,4,35.757298,139.664139,2024-02-08 18:17:04
192,T2-38.ファミリーマート 練馬上石神井四丁目店,5,4,9,35.727195,139.590179,2024-02-08 18:17:04
193,B1-28.アイルイムーブル日本橋,7,1,8,35.684502,139.77906,2024-02-08 18:17:04
194,A2-28.NTTコミュニケーションズ一ツ橋ビル駐車場,3,5,8,35.6915,139.75685,2024-02-08 18:17:04
195,C3-32.乃木公園,2,3,5,35.667936,139.72745,2024-02-08 18:17:04
196,T3-14.わらべ児童遊園,2,2,4,35.759774,139.654529,2024-02-08 18:17:04
197,T2-52.田柄中央児童公園,4,1,5,35.762395,139.641522,2024-02-08 18:17:04
198,M4-06.THE SHARE 原宿,3,7,10,35.671823,139.708158,2024-02-08 18:17:04
199,K1-10.セブン‐イレブン 大田区西糀谷１丁目店,3,1,4,35.559647,139.730098,2024-02-08 18:17:04
200,K1-09.セブン‐イレブン 大田区西蒲田２丁目店,0,16,16,35.570763,139.705895,2024-02-08 18:17:04
201,H1-63.東京スイソミル,9,0,9,35.65637,139.811765,2024-02-08 18:17:04
202,B1-16.小網町児童遊園,2,4,6,35.683695,139.780043,2024-02-08 18:17:04
203,H1-61.Brilliaランニングスタジアムマギーズ東京前,0,11,11,35.648281,139.786112,2024-02-08 18:17:04
204,K1-08.セブン‐イレブン 大田区東蒲田キネマ通り店,5,0,5,35.562368,139.730143,2024-02-08 18:17:04
205,C1-34.城山ガーデン,0,10,10,35.664479,139.743731,2024-02-08 18:17:04
206,H1-62.扇橋一丁目公園南,17,2,19,35.683343,139.812161,2024-02-08 18:17:04
207,J1-23.清水池公園,23,0,23,35.623756,139.692517,2024-02-08 18:17:04
208,C5-18.パークタワー品川ベイワード,19,0,19,35.634529,139.748378,2024-02-08 18:17:04
209,E4-07.ファミリーマート 本駒込二丁目店,2,2,4,35.727279,139.74627,2024-02-08 18:17:04
210,C5-45.パークアクシス芝浦キャナル,9,0,9,35.644794,139.755688,2024-02-08 18:17:04
211,A2-02.西神田公園（北側）,5,3,8,35.698591,139.755113,2024-02-08 18:17:04
212,T2-49.善福寺公園テニスクラブ,5,4,9,35.719674,139.593696,2024-02-08 18:17:04
213,H1-193.ライフ豊洲店,27,0,27,35.651833,139.79962,2024-02-08 18:17:04
214,A2-01.神田駿河台下,20,32,52,35.695762,139.761585,2024-02-08 18:17:04
215,I1-51.京急鈴ヶ森駐車場,9,0,9,35.589573,139.735585,2024-02-08 18:17:04
216,T2-36.サントピア テニスパーク,7,3,10,35.75195,139.616028,2024-02-08 18:17:04
217,G4-13. Parking in 両国駅前第2,0,3,3,35.696492,139.791591,2024-02-08 18:17:04
218,K1-120.蒲田駅消費者生活センター横自転車駐車場 屋上部,6,0,6,35.560125,139.71569,2024-02-08 18:17:04
219,N3-18.藤和シティコープ新中野3,6,0,6,35.69942,139.673964,2024-02-08 18:17:04
220,K1-145.トヨタモビリティ東京馬込テクニカル研修センター,11,2,13,35.58209,139.701362,2024-02-08 18:17:04
221,K1-100.多摩川台公園,5,0,5,35.589794,139.666955,2024-02-08 18:17:04
222,C1-54.ニッセイ虎ノ門ビル,0,12,12,35.664344,139.746662,2024-02-08 18:17:04
223,I1-52.カスタリアタワー品川シーサイド,2,8,10,35.607557,139.746866,2024-02-08 18:17:04
224,I1-53.天王洲公園,0,8,8,35.620355,139.749339,2024-02-08 18:17:04
225,C2-18.ブランシェ東麻布,3,0,3,35.656769,139.743224,2024-02-08 18:17:04
226,A3-45.鍛冶町2丁目,4,14,18,35.691578,139.77138,2024-02-08 18:17:04
227,H1-87.パークアクシス木場キャナルウエスト,7,0,7,35.662514,139.803694,2024-02-08 18:17:04
228,D6-20.淀橋けやき橋公園,1,14,15,35.693544,139.685806,2024-02-08 18:17:04
229,A3-46.神田須田町2丁目,0,0,0,35.695457,139.772972,2024-02-08 18:17:04
230,B3-13.国立がん研究センター,7,3,10,35.664871,139.767188,2024-02-08 18:17:04
231,I1-35.シーフォートスクエア,0,16,16,35.622954,139.750593,2024-02-08 18:17:04
232,K1-55.カバヤビル,17,1,18,35.576275,139.713704,2024-02-08 18:17:04
233,C3-24.SHARE GREEN 南青山 西エントランス,0,8,8,35.668419,139.724676,2024-02-08 18:17:04
234,A5-06.APA HOTEL PRIDE〈国会議事堂前〉,9,1,10,35.674468,139.741328,2024-02-08 18:17:04
235,A6-17.東京ガーデンテラス紀尾井町（プリンス通り側）,6,5,11,35.680431,139.738203,2024-02-08 18:17:04
236,B4-07.勝どき駅地下駐輪場,50,10,60,35.658135,139.776131,2024-02-08 18:17:04
237,B4-08.東京ミッドベイ勝どき（西仲通り）,17,0,17,35.656449,139.771302,2024-02-08 18:17:04
238,B3-04.築地市場駅地下駐輪場,17,0,17,35.664265,139.767426,2024-02-08 18:17:04
239,C5-10.シーバンス,3,11,14,35.649959,139.756068,2024-02-08 18:17:04
240,H1-34.門前仲町駅,47,3,50,35.67391,139.796165,2024-02-08 18:17:04
241,C3-10.ファミリーマート特許庁前店,0,19,19,35.670364,139.744684,2024-02-08 18:17:04
242,A1-01.千代田区役所,6,2,8,35.693799,139.753281,2024-02-08 18:17:04
243,A1-03.東京区政会館（メトロA5出口）,4,3,7,35.701073,139.747525,2024-02-08 18:17:04
244,B3-06.朝日新聞東京本社,0,21,21,35.664457,139.767214,2024-02-08 18:17:04
245,A1-04.東京区政会館（西側駐輪場）,3,4,7,35.701347,139.746951,2024-02-08 18:17:04
246,T1-03.四季の香公園,5,0,5,35.760585,139.626284,2024-02-08 18:17:04
247,T1-04.春の風公園,3,0,3,35.75731,139.624922,2024-02-08 18:17:04
248,T1-05.夏の雲公園,4,1,5,35.753964,139.629116,2024-02-08 18:17:04
249,H1-194.セブン-イレブン江東北砂5丁目店,4,0,4,35.68268,139.8353,2024-02-08 18:17:04
250,O5-03.新高円寺地下自転車駐輪場,5,8,13,35.697265,139.649397,2024-02-08 18:17:04
251,O3-06.アミーズ荻窪,3,1,4,35.714616,139.625116,2024-02-08 18:17:04
252,T2-03.リヴィンオズ大泉店,7,1,8,35.752383,139.594855,2024-02-08 18:17:04
253,O6-06.上高井戸1丁目,1,6,7,35.673055,139.611293,2024-02-08 18:17:04
254,T2-05.石神井図書館,4,0,4,35.736076,139.599676,2024-02-08 18:17:04
255,T2-06.総合体育館,3,0,3,35.748957,139.621385,2024-02-08 18:17:04
256,O5-02.馬橋ハイツ,5,1,6,35.705686,139.642587,2024-02-08 18:17:04
257,N1-07.プランドール上鷺宮,2,5,7,35.733292,139.630369,2024-02-08 18:17:04
258,E1-18.アーバネックス小石川春日,8,0,8,35.709261,139.746374,2024-02-08 18:17:04
259,T3-03.新桜台駅自転車駐車場,5,2,7,35.740378,139.667502,2024-02-08 18:17:04
260,O3-05.Nちゃりパーク,7,16,23,35.70389,139.6185,2024-02-08 18:17:04
261,O5-01.朝霞ハイツ,10,1,11,35.71038,139.64519,2024-02-08 18:17:04
262,L1-11.アイムタウン上祖師谷,2,1,3,35.656849,139.594422,2024-02-08 18:17:04
263,L1-12.鈴木リースホーム駐車場,13,1,14,35.646648,139.633038,2024-02-08 18:17:04
264,L1-13.わびさびホステル,4,0,4,35.647393,139.667085,2024-02-08 18:17:04
265,G2-05.リアナスカイパーク押上,6,0,6,35.715733,139.815451,2024-02-08 18:17:04
266,T3-02.早宮第二自転車駐車場,7,4,11,35.756846,139.652154,2024-02-08 18:17:04
267,I1-37.ガーデンシティ品川御殿山,3,5,8,35.623466,139.734359,2024-02-08 18:17:04
268,T2-47.上石神井駅北第二自転車駐車場,5,5,10,35.726523,139.5905,2024-02-08 18:17:04
269,C1-51.環二新橋四丁目,12,0,12,35.663843,139.757697,2024-02-08 18:17:04
270,M6-07.笹塚東,20,0,20,35.675436,139.670594,2024-02-08 18:17:04
271,M3-10.ウノサワ東急ビル,5,3,8,35.647757,139.712981,2024-02-08 18:17:04
272,C2-26.一の橋公園,5,1,6,35.655367,139.738075,2024-02-08 18:17:04
273,H1-14.ホテルリブマックス東京潮見駅前,3,2,5,35.658351,139.818229,2024-02-08 18:17:04
274,D2-12.ヴィアイン飯田橋後楽園,5,0,5,35.705774,139.743366,2024-02-08 18:17:04
275,D3-08.ホテルリブマックス高田馬場駅前,5,2,7,35.712952,139.701356,2024-02-08 18:17:04
276,H1-103.清澄庭園,10,0,10,35.680948,139.796917,2024-02-08 18:17:04
277,H1-104.木場公園,15,0,15,35.676488,139.809616,2024-02-08 18:17:04
278,H1-105.猿江恩賜公園,6,2,8,35.692277,139.817491,2024-02-08 18:17:04
279,G4-07.ディアレイシャス両国,2,1,3,35.69955,139.803204,2024-02-08 18:17:04
280,T2-46.大泉郵便局バス停自転車駐車場,1,8,9,35.766491,139.587232,2024-02-08 18:17:04
281,I1-18.東品川公園,3,1,4,35.61379,139.746617,2024-02-08 18:17:04
282,J1-03.西郷山公園,5,1,6,35.650688,139.696696,2024-02-08 18:17:04
283,J1-02.駒場野公園,12,2,14,35.657718,139.681043,2024-02-08 18:17:04
284,D2-14.ローソン 神楽坂駅北店,0,5,5,35.704201,139.735815,2024-02-08 18:17:04
285,K1-65.下丸子3丁目,5,7,12,35.571711,139.685337,2024-02-08 18:17:04
286,T2-43.学園通り自転車駐車場,8,0,8,35.7547,139.5871,2024-02-08 18:17:04
287,I1-46.セブン-イレブン 品川東中延2丁目店,2,0,2,35.608721,139.714158,2024-02-08 18:17:04
288,T2-04.石神井公園駅南口,0,11,11,35.743354,139.606592,2024-02-08 18:17:04
289,J1-06.観音橋自転車置場,11,35,46,35.642251,139.69692,2024-02-08 18:17:04
290,J1-05.東山公園　北,0,9,9,35.64853,139.686309,2024-02-08 18:17:04
291,J1-45.プラウド中目黒,2,0,2,35.63767,139.7045,2024-02-08 18:17:04
292,H1-168.大島五丁目公園,13,0,13,35.68642,139.836151,2024-02-08 18:17:04
293,J1-47.本町みなみ街かど公園,12,4,16,35.61847,139.70019,2024-02-08 18:17:04
294,J1-48.グランドエクセル祐天寺,0,8,8,35.64372,139.68777,2024-02-08 18:17:04
295,K1-101.小池公園,1,4,5,35.599541,139.697962,2024-02-08 18:17:04
296,H1-171.LOGI’Q南砂町,8,1,9,35.672877,139.842339,2024-02-08 18:17:04
297,H1-153.三井リンクラボ新木場1,3,6,9,35.63851,139.823534,2024-02-08 18:17:04
298,H1-154.やぐら橋下,0,20,20,35.631132,139.792726,2024-02-08 18:17:04
299,Z21.コーナン川崎小田栄店,3,2,5,35.514643,139.706285,2024-02-08 18:17:04
300,D5-11.NTTコミュニケーションズ新宿ビル,0,11,11,35.699312,139.696468,2024-02-08 18:17:04
301,C5-31.ヒルトン東京お台場,0,10,10,35.626267,139.771438,2024-02-08 18:17:04
302,K1-78.城南鋳物団地協同組合,0,16,16,35.567562,139.766854,2024-02-08 18:17:04
303,Z05.ローソン川崎小田二丁目店,6,0,6,35.513548,139.697176,2024-02-08 18:17:04
304,I1-68.八潮公園第二,4,0,4,35.600003,139.754288,2024-02-08 18:17:04
305,I1-67.八潮公園第一,4,0,4,35.601149,139.754284,2024-02-08 18:17:04
306,H1-123.ダイワロイネットホテル東京有明,0,21,21,35.634316,139.793199,2024-02-08 18:17:04
307,J1-24.ボヌールREIWA,4,1,5,35.612389,139.676238,2024-02-08 18:17:04
308,B2-12.東京ダイヤビルディング（東側）,0,26,26,35.674835,139.785656,2024-02-08 18:17:04
309,J1-15.二の橋自転車置場2,15,1,16,35.614391,139.678396,2024-02-08 18:17:04
310,H1-77.ライフ東砂店,4,5,9,35.684641,139.844243,2024-02-08 18:17:04
311,D1-09.NTT四谷ビル,2,1,3,35.691188,139.712079,2024-02-08 18:17:04
312,E4-11.プライマル千石,0,3,3,35.727519,139.742815,2024-02-08 18:17:04
313,I1-23.東海橋防災船着場,11,1,12,35.616114,139.74033,2024-02-08 18:17:04
314,A4-12.東京ミッドタウン日比谷,0,35,35,35.674274,139.759111,2024-02-08 18:17:04
315,K1-46.池上駅前自転車駐車場,7,5,12,35.571478,139.702779,2024-02-08 18:17:04
316,I1-24.しながわ区民公園(中央口),11,1,12,35.593611,139.738056,2024-02-08 18:17:04
317,T2-13.セブン-イレブン 練馬石神井町8丁目店,3,1,4,35.750414,139.600011,2024-02-08 18:17:04
318,O3-04.アヴァンセ阿佐ヶ谷,1,1,2,35.712,139.62816,2024-02-08 18:17:04
319,B4-01.黎明橋公園（駐輪場）,5,6,11,35.656071,139.780068,2024-02-08 18:17:04
320,T2-32.セブン-イレブン 練馬東大泉NTTビル店,8,0,8,35.750761,139.594457,2024-02-08 18:17:04
321,K1-142.コーラル洗足池,10,0,10,35.604567,139.689096,2024-02-08 18:17:04
322,K1-28.鵜の木特別出張所,3,1,4,35.574886,139.685122,2024-02-08 18:17:04
323,T1-02.ホテルカデンツァ東京,5,7,12,35.755106,139.621675,2024-02-08 18:17:04
324,C2-16.ザ・ベルグレイヴィア麻布,4,0,4,35.657264,139.743821,2024-02-08 18:17:04
325,N3-11.上高田区民活動センター,4,1,5,35.711501,139.672761,2024-02-08 18:17:04
326,T3-30.北西大松公園,2,2,4,35.765979,139.64931,2024-02-08 18:17:04
327,D6-05.新宿中央公園（水の広場）,4,2,6,35.690474,139.690219,2024-02-08 18:17:04
328,D6-07.新宿フロントタワー,0,13,13,35.696387,139.689924,2024-02-08 18:17:04
329,T2-73.早実グラウンド記念公園,2,2,4,35.734615,139.576214,2024-02-08 18:17:04
330,O7-03.永福町西幸モータープール東,3,8,11,35.67156,139.64609,2024-02-08 18:17:04
331,D1-03.新左門児童遊園,4,0,4,35.684523,139.720519,2024-02-08 18:17:04
332,D1-04.四谷見附公園,9,4,13,35.683448,139.728425,2024-02-08 18:17:04
333,I1-54.天王洲オーシャンスクエア,0,52,52,35.622356,139.749468,2024-02-08 18:17:04
334,D6-01.新宿区役所本庁舎,27,22,49,35.693602,139.703229,2024-02-08 18:17:04
335,D6-02.新宿区役所第二分庁舎,31,4,35,35.693976,139.706134,2024-02-08 18:17:04
336,D6-03.新宿中央公園（ポケットパーク）,0,17,17,35.691559,139.690029,2024-02-08 18:17:04
337,D6-04.新宿中央公園（ちびっこ広場）,7,3,10,35.686649,139.689821,2024-02-08 18:17:04
338,A6-21.日本工営ビル,2,3,5,35.684584,139.734442,2024-02-08 18:17:04
339,I1-77.セブン-イレブン品川西中延1丁目店,3,0,3,35.612217,139.708164,2024-02-08 18:17:04
340,T1-01.光が丘駅前広場,1,12,13,35.759164,139.629466,2024-02-08 18:17:04
341,T2-37.上石神井2丁目,5,2,7,35.729615,139.59532,2024-02-08 18:17:04
342,I1-75.セブン-イレブン品川二葉4丁目店,3,1,4,35.603275,139.713428,2024-02-08 18:17:04
343,M5-13.セブン-イレブン初台店,3,0,3,35.675049,139.68444,2024-02-08 18:17:04
344,D6-24.ＮＴＴ東日本 本社ビル,7,3,10,35.683102,139.688852,2024-02-08 18:17:04
345,H1-134.豊洲ぐるり公園,4,18,22,35.643141,139.777821,2024-02-08 18:17:04
346,H1-133.北砂2丁目公園,14,4,18,35.679001,139.825809,2024-02-08 18:17:04
347,E3-08.サガラマンション,2,3,5,35.722833,139.734662,2024-02-08 18:17:04
348,O4-05.阿佐ヶ谷南1-30,1,1,2,35.700703,139.639985,2024-02-08 18:17:04
349,O5-06.EXAM高円寺南,5,0,5,35.70273,139.65864,2024-02-08 18:17:04
350,G2-03.押上１丁目２６-４,3,2,5,35.710323,139.815215,2024-02-08 18:17:04
351,K1-132.多摩川駅前自転車等駐車場,9,6,15,35.587232,139.669519,2024-02-08 18:17:04
352,C5-47.oak港南品川,19,6,25,35.62413,139.744831,2024-02-08 18:17:04
353,D3-15.カースルいずみ,8,6,14,35.711324,139.711976,2024-02-08 18:17:04
354,C5-15.セブン-イレブン 港区芝浦ふ頭店,1,1,2,35.640215,139.755971,2024-02-08 18:17:04
355,C5-14.セブン-イレブン 港区汐彩橋店,4,0,4,35.640481,139.753659,2024-02-08 18:17:04
356,D5-01.新宿コズミックセンター,0,7,7,35.705244,139.70841,2024-02-08 18:17:04
357,H1-45.夢の島競技場,19,1,20,35.648596,139.824936,2024-02-08 18:17:04
358,E1-01.後楽橋横,21,4,25,35.702746,139.752009,2024-02-08 18:17:04
359,B1-15.ロイヤルパークホテル,4,1,5,35.682332,139.78722,2024-02-08 18:17:04
360,C4-05.白金台駅自転車駐車場,13,2,15,35.638927,139.727083,2024-02-08 18:17:04
361,E1-02.東京ドーム（ミーツポート）,0,13,13,35.70311,139.754951,2024-02-08 18:17:04
362,M2-06.あいおいニッセイ同和損保恵比寿ビル,3,3,6,35.647237,139.71512,2024-02-08 18:17:04
363,J1-12.工大橋下流自転車置場,4,0,4,35.605828,139.680265,2024-02-08 18:17:04
364,C5-25.NEX-TEC芝浦,36,2,38,35.639571,139.755551,2024-02-08 18:17:04
365,H1-175.ダイアパレス大島駅前,0,2,2,35.689543,139.836394,2024-02-08 18:17:04
366,C1-65.東京ポートシティ竹芝,0,19,19,35.654757,139.761516,2024-02-08 18:17:04
367,O2-03.西荻北5-8-17,3,2,5,35.709712,139.601846,2024-02-08 18:17:04
368,B2-21.八重洲二丁目北地区広場,0,34,34,35.67942,139.77004,2024-02-08 18:17:04
369,I1-101.下神明駅前,25,0,25,35.60838,139.726587,2024-02-08 18:17:04
370,N2-04.野方2丁目,6,0,6,35.713018,139.656768,2024-02-08 18:17:04
371,N2-05.野方3丁目,10,3,13,35.717877,139.654732,2024-02-08 18:17:04
372,K1-88.大田久が原西郵便局,4,0,4,35.582756,139.6925,2024-02-08 18:17:04
373,C5-51.トミンタワー台場一番街,11,0,11,35.634627,139.77663,2024-02-08 18:17:04
374,C4-10.亀塚公園,7,2,9,35.642764,139.741174,2024-02-08 18:17:04
375,H1-190.福山通運 東京支店,12,7,19,35.664845,139.796643,2024-02-08 18:17:04
376,C1-80.浜松町262ビル,5,6,11,35.654289,139.75557,2024-02-08 18:17:04
377,B2-19.リエトコートアルクスタワー,4,6,10,35.670506,139.77854,2024-02-08 18:17:04
378,C1-79.髙松コンストラクショングループ 東京本社ビル,3,0,3,35.648765,139.753363,2024-02-08 18:17:04
379,C5-43.オアーゼ芝浦MJビル,9,0,9,35.644798,139.752697,2024-02-08 18:17:04
380,J1-44.五本木2丁目,2,5,7,35.634441,139.687186,2024-02-08 18:17:04
381,B2-17.アーバネックス八丁堀,1,2,3,35.67518,139.77364,2024-02-08 18:17:04
382,M6-16.パールマンション,2,0,2,35.67464,139.67876,2024-02-08 18:17:04
383,G4-06.ドムス・スタイル両国,7,1,8,35.700453,139.798978,2024-02-08 18:17:04
384,G2-04.ラ　ステュディオ押上,4,1,5,35.712157,139.815298,2024-02-08 18:17:04
385,T3-15.セブン-イレブン練馬北町8丁目店,2,4,6,35.768105,139.646049,2024-02-08 18:17:04
386,C1-77.芝公園,16,1,17,35.65513,139.749645,2024-02-08 18:17:04
387,I1-27.小関橋公園,0,26,26,35.620699,139.730904,2024-02-08 18:17:04
388,B3-01.中央区役所,0,14,14,35.670855,139.772052,2024-02-08 18:17:04
389,A6-08.二番町ガーデン,3,2,5,35.685489,139.734562,2024-02-08 18:17:04
390,B1-01.十思公園,0,7,7,35.691058,139.777915,2024-02-08 18:17:04
391,B4-02.月島特別出張所,20,7,27,35.662197,139.782719,2024-02-08 18:17:04
392,A4-05.大手町タワー,0,36,36,35.685938,139.764886,2024-02-08 18:17:04
393,H1-22.豊洲市場（7街区）,23,47,70,35.6447,139.784512,2024-02-08 18:17:04
394,A6-07.二番町センタービル,0,7,7,35.685966,139.736328,2024-02-08 18:17:04
395,A2-12.神保町三井ビルディング,0,14,14,35.694532,139.760695,2024-02-08 18:17:04
396,E2-06.oto no ha Cafe,0,3,3,35.713991,139.725665,2024-02-08 18:17:04
397,B4-10.リバーシティ,8,0,8,35.668795,139.784784,2024-02-08 18:17:04
398,B1-03.常盤公園（北側）,6,3,9,35.688405,139.770068,2024-02-08 18:17:04
399,C5-19.グランドメゾン田町,7,0,7,35.645537,139.754899,2024-02-08 18:17:04
400,K1-11.ファミリーマート かわだ多摩川２丁目店,1,1,2,35.558289,139.697403,2024-02-08 18:17:04
401,J1-43.アルコタワー・ホテル雅叙園東京,0,14,14,35.63237,139.712681,2024-02-08 18:17:04
402,N1-03.鷺宮南駐輪場,6,3,9,35.721827,139.635949,2024-02-08 18:17:04
403,N2-06.江古田1丁目B,6,0,6,35.72515,139.672614,2024-02-08 18:17:04
404,D7-12.プラウド高田馬場,3,2,5,35.715538,139.701683,2024-02-08 18:17:04
405,K1-118.久が原3丁目,2,7,9,35.580741,139.687152,2024-02-08 18:17:04
406,K1-125.池上駅南口第1,1,1,2,35.571866,139.703214,2024-02-08 18:17:04
407,K1-117.安詳寺,15,4,19,35.581798,139.695222,2024-02-08 18:17:04
408,I1-91.アクロス目黒タワー,8,1,9,35.634019,139.719749,2024-02-08 18:17:04
409,K1-126.池上駅南口第2,0,3,3,35.571815,139.702387,2024-02-08 18:17:04
410,C5-50.お台場レインボー公園,12,0,12,35.633133,139.777315,2024-02-08 18:17:04
411,T3-26.富士見ランド公園,0,8,8,35.73701,139.627244,2024-02-08 18:17:04
412,T1-15.つのの山緑地,3,1,4,35.765144,139.636606,2024-02-08 18:17:04
413,T1-16.ゆりの木通り南公園,3,1,4,35.767582,139.636304,2024-02-08 18:17:04
414,H1-185.UR大島六丁目団地(第二),4,0,4,35.690038,139.833252,2024-02-08 18:17:04
415,H1-186.セブン-イレブン亀戸昭和橋通り店,0,6,6,35.694804,139.831357,2024-02-08 18:17:04
416,K1-96.西馬込駅前自転車駐車場,2,12,14,35.586408,139.705425,2024-02-08 18:17:04
417,H1-184.UR大島六丁目団地(第一),3,1,4,35.689913,139.833279,2024-02-08 18:17:04
418,A6-25.麹町仮住宅,0,4,4,35.679192,139.74019,2024-02-08 18:17:04
419,C1-69.塩釜公園,1,3,4,35.662908,139.755014,2024-02-08 18:17:04
420,C1-68.桜田公園,27,1,28,35.665214,139.757008,2024-02-08 18:17:04
421,A2-14.興和一橋ビル,0,16,16,35.6927,139.759311,2024-02-08 18:17:04
422,C5-41.トヨタモビリティ東京 芝浦店,5,0,5,35.639644,139.745532,2024-02-08 18:17:04
423,T2-22.ファミリーマート 石神井台7丁目店,5,0,5,35.731909,139.579685,2024-02-08 18:17:04
424,A6-20.紀尾井町PREX,0,11,11,35.68369,139.736936,2024-02-08 18:17:04
425,C5-24.GLOBAL FRONT TOWER,15,0,15,35.647713,139.755534,2024-02-08 18:17:04
426,E5-09.文京区 男女平等センター,13,1,14,35.70861,139.75768,2024-02-08 18:17:04
427,K1-37.東京サーハウス前,4,17,21,35.563874,139.685011,2024-02-08 18:17:04
428,B4-15.リバーシティ　イーストタワーズ,6,1,7,35.669188,139.785301,2024-02-08 18:17:04
429,M6-08.Be Good 幡ヶ谷,11,1,12,35.682453,139.677687,2024-02-08 18:17:04
430,D5-09.ハウジングステージ新宿,14,1,15,35.702277,139.701214,2024-02-08 18:17:04
431,D6-21.新宿5丁目,5,1,6,35.691613,139.711233,2024-02-08 18:17:04
432,K1-39.東京モノレール 流通センター駅前,0,28,28,35.581752,139.748705,2024-02-08 18:17:04
433,K1-38.ネクストサイト蒲田ビル,9,0,9,35.558916,139.717253,2024-02-08 18:17:04
434,T3-17.練馬区役所東庁舎(第二),4,1,5,35.735585,139.652544,2024-02-08 18:17:04
435,H1-107.大島小松川公園,7,20,27,35.692641,139.846346,2024-02-08 18:17:04
436,B1-11.浜町川緑道,37,10,47,35.684158,139.787649,2024-02-08 18:17:04
437,A6-19.番町麹町ビルディング,10,2,12,35.685578,139.732078,2024-02-08 18:17:04
438,B3-12.築地場外市場,8,9,17,35.665254,139.769301,2024-02-08 18:17:04
439,I1-40.御殿山トラストタワー,20,6,26,35.622371,139.737457,2024-02-08 18:17:04
440,M5-08.古賀政男音楽博物館,2,0,2,35.668091,139.680243,2024-02-08 18:17:04
441,H1-90.富士倉庫運輸(株) FACE-1前,1,4,5,35.655102,139.805205,2024-02-08 18:17:04
442,A3-38.パークホームズ千代田淡路町,0,5,5,35.695163,139.769566,2024-02-08 18:17:04
443,D2-11.神楽坂アインスタワー,4,2,6,35.702833,139.739,2024-02-08 18:17:04
444,C2-04.飯倉いきいきプラザ,3,1,4,35.656991,139.740739,2024-02-08 18:17:04
445,B1-09.スマイルホテル日本橋三越前,12,4,16,35.686101,139.776089,2024-02-08 18:17:04
446,E5-15.文京千駄木の郷,10,1,11,35.726499,139.759884,2024-02-08 18:17:04
447,C2-05.ありすいきいきプラザ,13,0,13,35.651046,139.727745,2024-02-08 18:17:04
448,C5-06.品川シーズンテラス,5,15,20,35.632303,139.742393,2024-02-08 18:17:04
449,B1-10.箱崎川第二公園,9,0,9,35.680833,139.784267,2024-02-08 18:17:04
450,L1-15.ソフィア,0,3,3,35.663222,139.587803,2024-02-08 18:17:04
451,A3-12.秋葉原UDX北側駐輪場前,0,14,14,35.70111,139.772855,2024-02-08 18:17:04
452,A2-08.KDX御茶ノ水ビル,2,8,10,35.700568,139.76013,2024-02-08 18:17:04
453,A3-07.淡路公園,0,14,14,35.696942,139.767302,2024-02-08 18:17:04
454,A1-08.飯田橋サクラテラス（早稲田通り）,4,5,9,35.699132,139.74462,2024-02-08 18:17:04
455,A3-13.富士ソフトビル（駐車場入口横）,1,18,19,35.700486,139.774254,2024-02-08 18:17:04
456,A2-09.テラススクエア,0,8,8,35.6931,139.7599,2024-02-08 18:17:04
457,A6-11.東京ガーデンテラス紀尾井町,0,23,23,35.67962,139.7364,2024-02-08 18:17:04
458,K1-124.矢口2丁目,5,1,6,35.564161,139.695187,2024-02-08 18:17:04
459,N3-15.ライオンズマンション中野東,0,3,3,35.71046,139.6855,2024-02-08 18:17:04
460,M3-11.渋谷道玄坂東急ビル,9,0,9,35.65718,139.698687,2024-02-08 18:17:04
461,H1-180.シティコート大島,6,2,8,35.691954,139.836462,2024-02-08 18:17:04
462,B1-27.日本橋本町4丁目,23,4,27,35.68973,139.77598,2024-02-08 18:17:04
463,M3-22.森谷ビル,14,0,14,35.64514,139.71686,2024-02-08 18:17:04
464,N3-17.東中野3丁目,10,0,10,35.70862,139.680679,2024-02-08 18:17:04
465,N2-10.関根ビル,0,5,5,35.733432,139.671241,2024-02-08 18:17:04
466,T1-06.秋の陽公園,3,2,5,35.762326,139.635226,2024-02-08 18:17:04
467,N1-02.鷺宮東駐輪場,0,12,12,35.721556,139.640397,2024-02-08 18:17:04
468,K1-140.西馬込駅前自転車駐車場(奥),2,12,14,35.586382,139.705116,2024-02-08 18:17:04
469,H1-182.錦糸町プライムタワー,10,4,14,35.695695,139.820507,2024-02-08 18:17:04
470,E5-05.駒込地域活動センター,9,0,9,35.728644,139.752183,2024-02-08 18:17:04
471,M3-06.渋谷第一生命ビル,0,10,10,35.657556,139.704129,2024-02-08 18:17:04
472,T2-42.石神井公園駅北第二自転車駐車場,1,4,5,35.74553,139.608939,2024-02-08 18:17:04
473,K1-144.蒲田五丁目44番自転車駐車場,8,1,9,35.559809,139.716993,2024-02-08 18:17:04
474,M3-07.渋谷ファーストプレイス,5,5,10,35.65506,139.69384,2024-02-08 18:17:04
475,H1-74.タダノ教習センター,3,7,10,35.63848,139.832305,2024-02-08 18:17:04
476,Z22.みんちゅう京急川崎駅前駐輪場内ラックスペース,0,3,3,35.532615,139.700332,2024-02-08 18:17:04
477,H1-151.コスモリード錦糸町,7,2,9,35.701347,139.819973,2024-02-08 18:17:04
478,T2-23.セブン-イレブン 練馬南大泉5丁目店,6,0,6,35.750185,139.579216,2024-02-08 18:17:04
479,M4-13.J-cube,1,2,3,35.66616,139.70458,2024-02-08 18:17:04
480,T2-65.さくらの辻公園,4,1,5,35.734805,139.599906,2024-02-08 18:17:04
481,T2-24.セブン-イレブン 練馬インター店,0,23,23,35.754586,139.606409,2024-02-08 18:17:04
482,O5-05.モンテ・ベルテ,0,2,2,35.701454,139.650518,2024-02-08 18:17:04
483,J1-42.都立大学駅北口バス停前,7,2,9,35.618622,139.67596,2024-02-08 18:17:04
484,K1-97.トミンタワー多摩川二丁目,13,0,13,35.555561,139.704345,2024-02-08 18:17:04
485,D1-14.コモレ四谷,2,2,4,35.68752,139.72818,2024-02-08 18:17:04
486,K1-106.ファミリーマート上池台夫婦坂店,5,4,9,35.599329,139.703343,2024-02-08 18:17:04
487,J1-39.松見坂公園,3,4,7,35.655483,139.687325,2024-02-08 18:17:04
488,J1-40.西小山公園,5,2,7,35.616541,139.697369,2024-02-08 18:17:04
489,J1-38.林試の森公園 北,13,0,13,35.626355,139.700153,2024-02-08 18:17:04
490,I1-84.セブン-イレブン西品川2丁目店,0,4,4,35.613819,139.728418,2024-02-08 18:17:04
491,D6-26.セブン-イレブン新宿６丁目文化センター通り店,7,2,9,35.694951,139.708219,2024-02-08 18:17:04
492,T2-25.ファミリーマート 高野台二丁目店,0,5,5,35.746045,139.620087,2024-02-08 18:17:04
493,I1-85.GOODOFFICE品川,4,1,5,35.621081,139.741178,2024-02-08 18:17:04
494,K1-74.大田スタジアム,0,9,9,35.587423,139.753871,2024-02-08 18:17:04
495,C1-64.東京虎ノ門グローバルスクエア,0,5,5,35.669941,139.749261,2024-02-08 18:17:04
496,K1-72.ファミリーマート大森西四丁目店,4,0,4,35.573358,139.723105,2024-02-08 18:17:04
497,H1-118.ファミリーマート亀戸駅前店,6,5,11,35.69839,139.825484,2024-02-08 18:17:04
498,I1-62.天王洲Rim,4,0,4,35.622277,139.745638,2024-02-08 18:17:04
499,H1-40.深川東京モダン館,1,3,4,35.674076,139.795008,2024-02-08 18:17:04
500,H1-117.東京パークサイドビル,8,3,11,35.671225,139.808561,2024-02-08 18:17:04
501,J1-01.目黒区総合庁舎,7,2,9,35.640675,139.698088,2024-02-08 18:17:04
502,C5-16.品川インターシティ,0,23,23,35.626704,139.742174,2024-02-08 18:17:04
503,A1-12.北の丸スクエア,6,1,7,35.695515,139.750213,2024-02-08 18:17:04
504,H1-46.セブン-イレブン 江東枝川2丁目店,4,0,4,35.659287,139.807358,2024-02-08 18:17:04
505,A2-25.プラウド神田駿河台,4,9,13,35.698991,139.76091,2024-02-08 18:17:04
506,C5-49.プラウドタワー芝浦,9,0,9,35.638912,139.747422,2024-02-08 18:17:04
507,T3-25.北町みのり公園,2,2,4,35.767627,139.65243,2024-02-08 18:17:04
508,H1-75.ジオ深川住吉,10,0,10,35.684247,139.815638,2024-02-08 18:17:04
509,T1-09.ローソン練馬旭町一丁目店,4,1,5,35.765704,139.625178,2024-02-08 18:17:04
510,T2-26.ファミリーマート 大泉学園町四丁目店,0,5,5,35.767388,139.587625,2024-02-08 18:17:04
511,T2-27.ファミリーマート 大泉長久保通り店,4,1,5,35.773841,139.591456,2024-02-08 18:17:04
512,C3-19.明治記念館西,0,9,9,35.678179,139.720809,2024-02-08 18:17:04
513,I1-11.鮫洲入江広場,13,1,14,35.603984,139.744504,2024-02-08 18:17:04
514,I1-10.品川シーサイド公園第1,9,9,18,35.607717,139.749478,2024-02-08 18:17:04
515,I1-09.東品川海上公園第1,7,0,7,35.616633,139.748945,2024-02-08 18:17:04
516,D3-06.セブン-イレブン高田馬場3丁目中央店,2,3,5,35.713872,139.698301,2024-02-08 18:17:04
517,K1-40.大田文化の森,4,1,5,35.579649,139.720263,2024-02-08 18:17:04
518,C1-41.港区立エコプラザ,3,4,7,35.658709,139.757036,2024-02-08 18:17:04
519,I1-13.八潮北公園,0,13,13,35.613421,139.75375,2024-02-08 18:17:04
520,I1-12.しながわ区民公園（北側）,5,0,5,35.596091,139.740884,2024-02-08 18:17:04
521,T2-09.こぐれの森緑地,6,4,10,35.763741,139.588847,2024-02-08 18:17:04
522,T3-31.パークサイド関口,7,1,8,35.74097,139.63836,2024-02-08 18:17:04
523,H1-183.MFLP新木場1,0,7,7,35.643958,139.838358,2024-02-08 18:17:04
524,T2-33.ウインドヒルズ189,2,4,6,35.74642,139.581204,2024-02-08 18:17:04
525,T2-67.陽和病院,1,4,5,35.761211,139.603316,2024-02-08 18:17:04
526,H1-82.セブンｰイレブン 北砂3丁目明治通り店,0,6,6,35.683514,139.827081,2024-02-08 18:17:04
527,T2-60.武蔵関公園（第一）,9,0,9,35.724747,139.565817,2024-02-08 18:17:04
528,I1-48.NTT 東日本 関東病院(北側),6,2,8,35.632191,139.725002,2024-02-08 18:17:04
529,T2-58.立野公園,3,2,5,35.716776,139.577975,2024-02-08 18:17:04
530,I1-100.東急荏原中延駅駐輪場,7,0,7,35.610444,139.712333,2024-02-08 18:17:04
531,T2-56.大泉公園（第一）,3,1,4,35.77228,139.58325,2024-02-08 18:17:04
532,T2-55.大泉町もみじやま公園,1,2,3,35.767296,139.602321,2024-02-08 18:17:04
533,T2-54.土支田農業公園,4,5,9,35.760939,139.609264,2024-02-08 18:17:04
534,I1-44.大井三ツ又商店街入口,6,1,7,35.604606,139.734483,2024-02-08 18:17:04
535,T2-62.大泉井頭公園,6,4,10,35.746681,139.57754,2024-02-08 18:17:04
536,T2-61.武蔵関公園（第二）,4,0,4,35.727826,139.570056,2024-02-08 18:17:04
537,T3-09.学田公園,5,0,5,35.730428,139.648704,2024-02-08 18:17:04
538,K1-105.東糀谷二丁目児童公園,0,9,9,35.555702,139.740802,2024-02-08 18:17:04
539,Z02.NTT渡田ビル,4,2,6,35.513644,139.712594,2024-02-08 18:17:04
540,T3-04.サンパレス平和台,8,4,12,35.759827,139.659121,2024-02-08 18:17:04
541,K1-104.六郷BASE,4,2,6,35.543573,139.714393,2024-02-08 18:17:04
542,M4-16.神宮前6丁目,2,0,2,35.668673,139.702816,2024-02-08 18:17:04
543,K1-69.京急平和島第2Bバイク駐輪場,4,0,4,35.585747,139.735242,2024-02-08 18:17:04
544,H1-155.メブクス豊洲,0,54,54,35.645726,139.784496,2024-02-08 18:17:04
545,C2-11.一の橋,27,26,53,35.654726,139.737491,2024-02-08 18:17:04
546,C4-11.ザ・パークハウス 三田ガーデン,13,0,13,35.64816,139.737991,2024-02-08 18:17:04
547,H1-161.昭文社制作本部ビル,6,0,6,35.684003,139.794983,2024-02-08 18:17:04
548,N2-07.新井区民活動センター,3,2,5,35.714292,139.663327,2024-02-08 18:17:04
549,K1-87.羽田イノベーションシティ,0,12,12,35.547061,139.756277,2024-02-08 18:17:04
550,N3-16.COURT 5,5,0,5,35.699743,139.664608,2024-02-08 18:17:04
551,C4-01.高輪地区総合支所(5F),4,7,11,35.641833,139.734519,2024-02-08 18:17:04
552,C5-48.セブンイレブン港区海岸三丁目店,5,3,8,35.636808,139.752517,2024-02-08 18:17:04
553,H1-42.江東区スポーツ会館,20,1,21,35.683961,139.821559,2024-02-08 18:17:04
554,B2-10.東京ダイヤビルディング（北側）,0,12,12,35.675702,139.785229,2024-02-08 18:17:04
555,H1-43.東京イースト21,1,9,10,35.675639,139.815255,2024-02-08 18:17:04
556,B3-20.歌舞伎座タワー駐輪場2F,0,7,7,35.670106,139.768041,2024-02-08 18:17:04
557,B3-21.歌舞伎座タワー駐輪場3F,3,7,10,35.6701,139.76801,2024-02-08 18:17:04
558,Z06.ローソン川崎殿町店,5,8,13,35.537434,139.744509,2024-02-08 18:17:04
559,K1-139.プラットホステル京急 羽田ホーム,8,2,10,35.548104,139.748889,2024-02-08 18:17:04
560,J1-58.目黒女子会館前,3,0,3,35.629011,139.69716,2024-02-08 18:17:04
561,T2-18.ファミリーマート練馬西税務署前店,4,0,4,35.745505,139.580878,2024-02-08 18:17:04
562,C3-23.LIFORK 南青山 北エントランス,11,17,28,35.669916,139.725701,2024-02-08 18:17:04
563,C1-46.新虎通りCORE,6,11,17,35.665124,139.754054,2024-02-08 18:17:04
564,C1-45.浜松町クレアタワー,16,0,16,35.656324,139.755927,2024-02-08 18:17:04
565,K1-53.セブン-イレブン 田園調布郵便局前店,20,0,20,35.589309,139.678587,2024-02-08 18:17:04
566,K1-52.大田区総合体育館,7,0,7,35.564152,139.727422,2024-02-08 18:17:04
567,T1-12.ファミリーマート 高松六丁目店,1,3,4,35.756873,139.616612,2024-02-08 18:17:04
568,D7-07.ローソン 新宿西落合三丁目店,5,0,5,35.725171,139.675897,2024-02-08 18:17:04
569,A6-16.一番町第二TGビル,4,1,5,35.688351,139.744321,2024-02-08 18:17:04
570,C3-33.PASONA SQUARE,13,0,13,35.667462,139.716058,2024-02-08 18:17:04
571,A3-24.岩本町ほほえみプラザ,2,0,2,35.69441,139.777715,2024-02-08 18:17:04
572,H1-35.ヒューリック豊洲プライムスクエア,1,4,5,35.652376,139.797724,2024-02-08 18:17:04
573,C5-11.フェイバリッチタワー品川,10,0,10,35.631729,139.749767,2024-02-08 18:17:04
574,E2-13.デルックス文京神楽坂,5,0,5,35.70781,139.732227,2024-02-08 18:17:04
575,C5-01.こうなん星の公園,0,46,46,35.629697,139.742167,2024-02-08 18:17:04
576,C5-02.港南緑水公園,42,0,42,35.628955,139.750731,2024-02-08 18:17:04
577,A3-22.龍閑児童公園,7,0,7,35.693234,139.779702,2024-02-08 18:17:04
578,A3-21.神田ふれあい通り第３,12,1,13,35.695176,139.772832,2024-02-08 18:17:04
579,H1-30.江東区役所（北側）,0,12,12,35.67338,139.8164,2024-02-08 18:17:04
580,C1-17.港区役所,1,3,4,35.657866,139.751068,2024-02-08 18:17:04
581,H1-31.江東区役所（南側）,3,13,16,35.67214,139.8166,2024-02-08 18:17:04
582,C1-09.愛宕グリーンヒルズ,0,26,26,35.662051,139.748132,2024-02-08 18:17:04
583,D1-02.四谷特別出張所（新宿御苑大木戸門前）,8,9,17,35.687435,139.714169,2024-02-08 18:17:04
584,D1-01.花園西公園,2,3,5,35.690612,139.711631,2024-02-08 18:17:04
585,C1-04.虎ノ門ヒルズ,0,41,41,35.666527,139.748804,2024-02-08 18:17:04
586,C1-05.西新橋2丁目（新虎通り）,6,7,13,35.665593,139.752617,2024-02-08 18:17:04
587,C1-73.日比谷フォートタワー,1,13,14,35.669871,139.753147,2024-02-08 18:17:04
588,K1-102.上池台四丁目公園,5,1,6,35.595119,139.6996,2024-02-08 18:17:04
589,M2-01.恵比寿保健相談所（恵比寿社会教育館）,6,3,9,35.64524,139.71946,2024-02-08 18:17:04
590,I1-98.コーポ荏原,4,2,6,35.60411,139.709784,2024-02-08 18:17:04
591,C3-17.セブン-イレブン 港区溜池山王店,0,41,41,35.670308,139.743242,2024-02-08 18:17:04
592,T2-11.石神井松の風文化公園,3,0,3,35.739471,139.595578,2024-02-08 18:17:04
593,M2-03.サイカパーク恵比寿,5,10,15,35.646581,139.710613,2024-02-08 18:17:04
594,M2-02.アメリカ橋公園,0,8,8,35.643606,139.713099,2024-02-08 18:17:04
595,T2-50.North Ridge 吉祥寺,7,2,9,35.72305,139.579555,2024-02-08 18:17:04
596,J1-35.目黒川田道街かど公園,3,3,6,35.634574,139.710332,2024-02-08 18:17:04
597,H1-174.ジュネス(エントランス側),1,1,2,35.682712,139.823961,2024-02-08 18:17:04
598,M6-17.笹塚一丁目駐輪場,7,0,7,35.672922,139.668729,2024-02-08 18:17:04
599,C4-14.神応ほっとプラザ,5,5,10,35.643711,139.724753,2024-02-08 18:17:04
600,K1-107.馬込駅A2出口,5,4,9,35.596854,139.712139,2024-02-08 18:17:04
601,T3-11.ガラクタ公園,1,2,3,35.740321,139.631256,2024-02-08 18:17:04
602,T2-80.みその緑地,3,2,5,35.756825,139.590528,2024-02-08 18:17:04
603,T3-24.AZEST新桜台,5,2,7,35.743962,139.670315,2024-02-08 18:17:04
604,D4-07.新宿余丁町ビル,4,1,5,35.698512,139.716482,2024-02-08 18:17:04
605,Z23.NA川崎南町,0,9,9,35.524976,139.697495,2024-02-08 18:17:04
606,T3-01.練馬春日町駅自転車駐車場,3,4,7,35.751438,139.641265,2024-02-08 18:17:04
607,H1-89.BUDDY スポーツアリーナ,0,24,24,35.637041,139.781088,2024-02-08 18:17:04
608,E5-14.上野広小路駅（湯島側）,0,20,20,35.707313,139.771857,2024-02-08 18:17:04
609,H1-109.Brillia ist 東雲キャナルコート東側,5,0,5,35.648008,139.803487,2024-02-08 18:17:04
610,H1-108.Brillia ist 東雲キャナルコート北側,8,0,8,35.648431,139.803125,2024-02-08 18:17:04
611,C1-53.ホテルリブマックス新橋,2,1,3,35.661149,139.754612,2024-02-08 18:17:04
612,D7-10.染の里 おちあい,6,0,6,35.715211,139.689788,2024-02-08 18:17:04
613,A1-15.富士見みらい館,2,0,2,35.697167,139.745629,2024-02-08 18:17:04
614,E4-15.千石4丁目,4,1,5,35.729153,139.741368,2024-02-08 18:17:04
615,H1-111.ファミリーマート木場六丁目店,1,1,2,35.66688,139.80779,2024-02-08 18:17:04
616,C5-36.お台場海浜公園駅,0,3,3,35.62974,139.778178,2024-02-08 18:17:04
617,H1-10.出会い橋,10,5,15,35.625029,139.777344,2024-02-08 18:17:04
618,H1-11.テレコムセンター駅,0,35,35,35.61813,139.778698,2024-02-08 18:17:04
619,H1-47.トピレックプラザ,0,15,15,35.672481,139.835877,2024-02-08 18:17:04
620,H1-13.アーバンドック ららぽーと豊洲,3,16,19,35.654067,139.792376,2024-02-08 18:17:04
621,T2-66.大泉学園町希望ヶ丘公園,0,4,4,35.778605,139.588883,2024-02-08 18:17:04
622,C5-37.台場駅,0,31,31,35.626388,139.772453,2024-02-08 18:17:04
623,H1-16.豊洲三丁目公園,0,84,84,35.657477,139.796629,2024-02-08 18:17:04
624,H1-17.東雲水辺公園,23,0,23,35.64704,139.80469,2024-02-08 18:17:04
625,C1-72.新田町ビル,9,0,9,35.646307,139.746428,2024-02-08 18:17:04
626,K1-98.鵜の木松山公園,3,4,7,35.577433,139.680752,2024-02-08 18:17:04
627,C1-71.芝商業高校前交差点,0,12,12,35.65583,139.759896,2024-02-08 18:17:04
628,H1-122.東砂スポーツセンター,5,6,11,35.679167,139.839746,2024-02-08 18:17:04
629,O6-05.コージーコート久我山,0,5,5,35.687531,139.60439,2024-02-08 18:17:04
630,T2-39.ローソン 練馬大泉町五丁目店,3,5,8,35.758929,139.597548,2024-02-08 18:17:04
631,J1-50.大岡山公園,4,0,4,35.609958,139.684087,2024-02-08 18:17:04
632,J1-51.池尻大橋駅東口駐輪場,1,4,5,35.650627,139.687228,2024-02-08 18:17:04
633,K1-99.東原くすのき公園,7,0,7,35.584086,139.67898,2024-02-08 18:17:04
634,N3-12.桃園区民活動センター,1,2,3,35.702414,139.667327,2024-02-08 18:17:04
635,H1-191.三井リンクラボ新木場2,12,2,14,35.644863,139.831107,2024-02-08 18:17:04
636,M5-09.代々木上原駅前,0,8,8,35.66865,139.679251,2024-02-08 18:17:04
637,O3-09.NTT井草ビル第3ポート,6,1,7,35.714151,139.61693,2024-02-08 18:17:04
638,T1-07.土支田一丁目（笹目通り）,6,4,10,35.765913,139.619285,2024-02-08 18:17:04
639,K1-22.矢口特別出張所,5,0,5,35.562324,139.690486,2024-02-08 18:17:04
640,T3-08.中新井川児童遊園,6,1,7,35.728268,139.649188,2024-02-08 18:17:04
641,H1-78.ローソン新木場一丁目店,9,5,14,35.645604,139.834941,2024-02-08 18:17:04
642,A6-13.番町会館,3,3,6,35.689131,139.733071,2024-02-08 18:17:04
643,H1-71.セブン-イレブン 江東東陽4丁目,0,12,12,35.670906,139.819386,2024-02-08 18:17:04
644,D2-09.セブン-イレブン 新宿岩戸町店,3,0,3,35.700993,139.736355,2024-02-08 18:17:04
645,I1-08.天王洲アイル第一水辺広場,3,27,30,35.622294,139.751644,2024-02-08 18:17:04
646,I1-07.しながわ水族館,16,0,16,35.590641,139.736354,2024-02-08 18:17:04
647,D3-09.西早稲田3丁目,4,0,4,35.712545,139.713319,2024-02-08 18:17:04
648,E1-16.小石川3丁目緑地,8,13,21,35.714338,139.746346,2024-02-08 18:17:04
649,C5-28.芝浦ルネサイトタワー,6,1,7,35.643683,139.7506,2024-02-08 18:17:04
650,I1-59.文庫の森第一,22,0,22,35.612357,139.721484,2024-02-08 18:17:04
651,I1-60.文庫の森第二,5,0,5,35.611368,139.720424,2024-02-08 18:17:04
652,C1-38.KDX西新橋ビル（西側）,4,1,5,35.66495,139.750459,2024-02-08 18:17:04
653,C1-37.KDX西新橋ビル（北側）,0,6,6,35.665218,139.750827,2024-02-08 18:17:04
654,T2-14.NPC24H東大泉第6パーキング,1,5,6,35.747807,139.593599,2024-02-08 18:17:04
655,C3-12.赤坂センタービルディング前（青山通り）,0,15,15,35.676732,139.733905,2024-02-08 18:17:04
656,H1-36.フジゴルフセンター,13,2,15,35.66605,139.806699,2024-02-08 18:17:04
657,C1-27.虎ノ門2丁目タワー,0,25,25,35.668547,139.747175,2024-02-08 18:17:04
658,C5-12.第2東運ビル,0,9,9,35.633742,139.748281,2024-02-08 18:17:04
659,D6-08.新宿イーストサイドスクエア,0,7,7,35.697158,139.707887,2024-02-08 18:17:04
660,A4-08.永代通り（大手町駅B2c出口前）,5,20,25,35.684349,139.766958,2024-02-08 18:17:04
661,H1-37.東雲駅（東京湾岸道路）,33,1,34,35.640618,139.802455,2024-02-08 18:17:04
662,C3-11.赤坂見附南,2,0,2,35.676566,139.737083,2024-02-08 18:17:04
663,M6-04.本町東べんてん橋公園,0,4,4,35.687126,139.680702,2024-02-08 18:17:04
664,I1-79.品川浦第二,14,0,14,35.621904,139.741429,2024-02-08 18:17:04
665,K1-81.コーナン本羽田萩中店,13,0,13,35.549568,139.731093,2024-02-08 18:17:04
666,D6-25.新宿駅東南口自転車駐輪場,30,0,30,35.689755,139.701323,2024-02-08 18:17:04
667,I1-78.セブン-イレブン西大井店,12,0,12,35.601431,139.718659,2024-02-08 18:17:04
668,H1-136.東砂一丁目公園,11,6,17,35.683542,139.839763,2024-02-08 18:17:04
669,A6-23.セブン-イレブン 千代田三番町店,0,5,5,35.689466,139.745316,2024-02-08 18:17:04
670,C5-34.五色橋ビル,0,1,1,35.636644,139.751798,2024-02-08 18:17:04
671,K1-41.郷土博物館,0,9,9,35.588644,139.710413,2024-02-08 18:17:04
672,G2-06.ディアレイシャス押上スカイヴィレッジ,3,2,5,35.71408,139.810588,2024-02-08 18:17:04
673,O3-11.ハイリビング関根,2,6,8,35.707877,139.618926,2024-02-08 18:17:04
674,O7-02.永福中央公園,6,0,6,35.67121,139.64145,2024-02-08 18:17:04
675,K1-29.萩中文化センター,3,6,9,35.55017,139.728146,2024-02-08 18:17:04
676,K1-30.テクノFRONT森ケ崎,0,8,8,35.567922,139.746181,2024-02-08 18:17:04
677,K1-130.COCOONひろば平和島,16,2,18,35.578728,139.735238,2024-02-08 18:17:04
678,H1-81.豊洲IHIビル（北側）,15,7,22,35.659829,139.793243,2024-02-08 18:17:04
679,E4-03.昭和小学校北側（不忍通り）,32,1,33,35.73166,139.748625,2024-02-08 18:17:04
680,C2-12.六本木ファーストビル,0,26,26,35.66249,139.741397,2024-02-08 18:17:04
681,D3-16.セジョリ江戸川橋,14,1,15,35.708734,139.730509,2024-02-08 18:17:04
682,A5-04.日比谷パークフロント前　日比谷公園南面向い歩道上,0,28,28,35.671514,139.753952,2024-02-08 18:17:04
683,C3-22.OMO3東京赤坂 by 星野リゾート,6,2,8,35.674929,139.736053,2024-02-08 18:17:04
684,B1-20.竜閑さくら橋際街角広場,0,32,32,35.688301,139.768958,2024-02-08 18:17:04
685,H1-83.ローソン江東東雲店,12,0,12,35.642165,139.800439,2024-02-08 18:17:04
686,H1-84.NTT東日本辰巳ビル,0,22,22,35.647091,139.817333,2024-02-08 18:17:04
687,C5-26.ピアシティ芝浦ビル,12,1,13,35.644155,139.756216,2024-02-08 18:17:04
688,T3-28.ほしぞら緑地,1,2,3,35.755137,139.661208,2024-02-08 18:17:04
689,I1-88.セブン-イレブン品川南大井3丁目店,0,3,3,35.58768,139.734515,2024-02-08 18:17:04
690,I1-87.セブン-イレブン西大井滝王子通り店,3,0,3,35.599774,139.723467,2024-02-08 18:17:04
691,Z20.川崎キングスカイフロント 東急 REI ホテル,0,10,10,35.540589,139.752918,2024-02-08 18:17:04
692,G4-11.ホテルマイステイズ浅草,21,1,22,35.703972,139.797327,2024-02-08 18:17:04
693,C5-30.フェイム芝浦インターウェーブ,11,0,11,35.647872,139.75391,2024-02-08 18:17:04
694,M6-13.JICA東京,12,0,12,35.673409,139.675203,2024-02-08 18:17:04
695,A4-13.アーバンネット大手町ビル,0,13,13,35.68557,139.766929,2024-02-08 18:17:04
696,B4-27.リバーシティ西ブロック,16,1,17,35.670491,139.784447,2024-02-08 18:17:04
697,K1-143.大森北1丁目,57,2,59,35.584914,139.730504,2024-02-08 18:17:04
698,E5-24.本郷6丁目,5,0,5,35.712445,139.758157,2024-02-08 18:17:04
699,D2-17.genten市ヶ谷店,9,1,10,35.690657,139.73255,2024-02-08 18:17:04
700,A4-14.東京国際フォーラム（有楽町駅ガード側）,2,5,7,35.675739,139.763712,2024-02-08 18:17:04
701,A2-27.丸紅ビル,0,25,25,35.690958,139.759876,2024-02-08 18:17:04
702,K1-135.北千束2丁目,3,3,6,35.608633,139.693653,2024-02-08 18:17:04
703,A1-19.九段会館テラス,1,4,5,35.694065,139.751801,2024-02-08 18:17:04
704,K1-136.BIG FUN 平和島,0,11,11,35.585489,139.740194,2024-02-08 18:17:04
705,K1-137.京浜島つばさ公園,0,16,16,35.571578,139.770532,2024-02-08 18:17:04
706,D1-16.ルネ新宿御苑タワー,5,5,10,35.690155,139.713377,2024-02-08 18:17:04
707,G6-01.オーキッドレジデンス森下,7,0,7,35.692547,139.799231,2024-02-08 18:17:04
708,T2-63.三原台公園,2,5,7,35.751471,139.599835,2024-02-08 18:17:04
709,O4-01.阿佐ヶ谷南公園,2,0,2,35.70328,139.62981,2024-02-08 18:17:04
710,B4-11.ダンスキューブ勝どき,0,4,4,35.656565,139.775073,2024-02-08 18:17:04
711,D1-06.四谷第六小学校北,9,0,9,35.681754,139.715256,2024-02-08 18:17:04
712,T2-64.高野台中央公園,3,0,3,35.746768,139.613885,2024-02-08 18:17:04
713,H1-169.セブンイレブン江東亀戸7丁目東店,6,4,10,35.697157,139.839835,2024-02-08 18:17:04
714,H1-170.セブンイレブン江東亀戸7丁目南店,0,20,20,35.695937,139.838017,2024-02-08 18:17:04
715,B2-16.ホテルサードニクス東京,0,9,9,35.67684,139.77876,2024-02-08 18:17:04
716,I1-93.中央海浜公園前交差点（南側）,6,0,6,35.595498,139.750654,2024-02-08 18:17:04
717,I1-92.中央海浜公園前交差点（北側）,10,0,10,35.595873,139.75134,2024-02-08 18:17:04
718,B1-26.Dash Living Nihonbashi,3,3,6,35.68802,139.78112,2024-02-08 18:17:04
719,H1-158.東京国際交流館,9,3,12,35.621845,139.776833,2024-02-08 18:17:04
720,J1-32.緑が丘駅前高架下,4,3,7,35.606793,139.678372,2024-02-08 18:17:04
721,K1-90.ファミリーマート大田仲池上一丁目店,4,2,6,35.5873,139.701644,2024-02-08 18:17:04
722,K1-91.穴守稲荷神社,0,11,11,35.550027,139.74973,2024-02-08 18:17:04
723,C1-67.京阪神 虎ノ門ビル,0,34,34,35.669228,139.751668,2024-02-08 18:17:04
724,K1-89.ファミリーマート大田千鳥三丁目店,5,0,5,35.572086,139.68708,2024-02-08 18:17:04
725,I1-97.トミンハイム東品川三丁目第二,19,0,19,35.613387,139.749307,2024-02-08 18:17:04
726,T2-51.練馬区役所石神井庁舎,0,10,10,35.743772,139.603317,2024-02-08 18:17:04
727,T2-75.石神井台二丁目緑地,3,0,3,35.734684,139.593628,2024-02-08 18:17:04
728,E5-19.千駄木公園,7,0,7,35.728333,139.757629,2024-02-08 18:17:04
729,E5-18.団子坂上広場,7,4,11,35.724921,139.75903,2024-02-08 18:17:04
730,A5-07.富国生命ビル,0,15,15,35.670452,139.75557,2024-02-08 18:17:04
731,H1-156.つどい橋下,0,13,13,35.630791,139.787396,2024-02-08 18:17:04
732,H1-159.夢の大橋西,14,2,16,35.627599,139.782953,2024-02-08 18:17:04
733,H1-143.ダイバーシティ東京 プラザ,9,1,10,35.624619,139.776006,2024-02-08 18:17:04
734,I1-57.大井水神公園,28,46,74,35.589972,139.729368,2024-02-08 18:17:04
735,B2-15.KABUTO ONE,0,32,32,35.68168,139.77825,2024-02-08 18:17:04
736,K1-64.多摩川グリーンスクエア,5,5,10,35.545459,139.719489,2024-02-08 18:17:04
737,Z07.ローソン川崎渡田三丁目店,2,2,4,35.519137,139.705791,2024-02-08 18:17:04
738,T2-57.大泉公園（第二）,5,1,6,35.771708,139.583551,2024-02-08 18:17:04
739,A4-06.大手町ファーストスクエア,0,36,36,35.686037,139.764472,2024-02-08 18:17:04
740,C1-50.NTT虎ノ門ビル,0,14,14,35.666075,139.748008,2024-02-08 18:17:04
741,C1-23.三田いきいきプラザ,9,0,9,35.648637,139.749834,2024-02-08 18:17:04
742,H1-29.スカイズタワー＆ガーデン,3,0,3,35.647618,139.792152,2024-02-08 18:17:04
743,C1-21.汐留ビルディング,2,8,10,35.657363,139.75918,2024-02-08 18:17:04
744,A3-16.地蔵橋東児童遊園,5,0,5,35.691069,139.775376,2024-02-08 18:17:04
745,Z08.ファミリーマート観音二丁目店,0,7,7,35.526238,139.72907,2024-02-08 18:17:04
746,A3-18.美倉橋北児童遊園,2,2,4,35.69703,139.779928,2024-02-08 18:17:04
747,A4-01.丸ビル（南側駐輪場）,5,5,10,35.680514,139.764002,2024-02-08 18:17:04
748,A3-11.練成公園,1,7,8,35.703735,139.770629,2024-02-08 18:17:04
749,A3-10.芳林公園（北側）,0,6,6,35.701978,139.7698,2024-02-08 18:17:04
750,A6-02.いきいきプラザ一番町（西側駐輪場）,7,1,8,35.687031,139.739327,2024-02-08 18:17:04
751,A6-01.東郷元帥記念公園（南側）,4,1,5,35.689879,139.740178,2024-02-08 18:17:04
752,A5-03.参議院第二別館（永田町駅2番出口）,7,8,15,35.677763,139.74271,2024-02-08 18:17:04
753,A4-03.東京国際フォーラム（メトロD5出口）,6,3,9,35.675843,139.763329,2024-02-08 18:17:04
754,K1-15.セブン‐イレブン 大田区西蒲田店,0,4,4,35.56694,139.716331,2024-02-08 18:17:04
755,K1-49.ローソン仲池上一丁目店,10,0,10,35.586585,139.698552,2024-02-08 18:17:04
756,A2-06.東光電気工事 別館（屋内駐輪場）,0,7,7,35.69919,139.75701,2024-02-08 18:17:04
757,M4-01.新宿タカシマヤ,5,0,5,35.68714,139.702775,2024-02-08 18:17:04
758,M4-03.NTTドコモ代々木ビル,6,4,10,35.684451,139.702884,2024-02-08 18:17:04
759,M3-03.代官山 T-SITE,0,8,8,35.649823,139.700139,2024-02-08 18:17:04
760,K1-14.大森地域庁舎,4,0,4,35.578239,139.723262,2024-02-08 18:17:04
761,C5-46.ウエリスアーバン品川タワー,11,0,11,35.630961,139.746875,2024-02-08 18:17:04
762,C4-13.コシダコネクトビル,7,7,14,35.637765,139.739128,2024-02-08 18:17:04
763,K1-127.第二石井ビル,0,7,7,35.559286,139.722611,2024-02-08 18:17:04
764,C1-74.札の辻スクエア,1,4,5,35.645155,139.744543,2024-02-08 18:17:04
765,H1-164.森下三丁目第三児童遊園,18,0,18,35.68546,139.80244,2024-02-08 18:17:04
766,C1-78.CIRCLES新橋,2,7,9,35.66646,139.752138,2024-02-08 18:17:04
767,C3-34.3rd MINAMI AOYAMA,0,5,5,35.668622,139.715957,2024-02-08 18:17:04
768,O4-06.杉並区役所本庁舎,1,4,5,35.699328,139.636343,2024-02-08 18:17:04
769,D3-14.コーシャハイム高田馬場,6,0,6,35.712413,139.70168,2024-02-08 18:17:04
770,D7-11.新宿清掃事務所,5,1,6,35.716359,139.704377,2024-02-08 18:17:04
771,D5-08.ウエリス新宿早稲田の森,3,5,8,35.704597,139.708397,2024-02-08 18:17:04
772,E2-12.水道2丁目,8,0,8,35.709147,139.739183,2024-02-08 18:17:04
773,M6-10.京王コインパーク幡ヶ谷,5,0,5,35.6772,139.678117,2024-02-08 18:17:04
774,E3-05.文京スポーツセンター,45,15,60,35.721045,139.735687,2024-02-08 18:17:04
775,J1-36.WJ Haus,2,2,4,35.629067,139.711779,2024-02-08 18:17:04
776,K1-51.テクノポートカマタ 第2,2,9,11,35.555808,139.722791,2024-02-08 18:17:04
777,D1-13.新宿御苑新宿門【西側】,0,23,23,35.688945,139.706536,2024-02-08 18:17:04
778,I1-31.セブン-イレブン 品川戸越5丁目店,6,0,6,35.608193,139.719139,2024-02-08 18:17:04
779,T3-27.貫井川緑地,1,3,4,35.738427,139.632251,2024-02-08 18:17:04
780,H1-147.大島四丁目団地,14,2,16,35.68744,139.827075,2024-02-08 18:17:04
781,O4-02.成宗さくら公園,2,0,2,35.69638,139.63482,2024-02-08 18:17:04
782,O1-01.上瀬戸公園,2,2,4,35.72077,139.6045,2024-02-08 18:17:04
783,T2-15.NPC24H大泉学園南口パーキング,0,9,9,35.748611,139.584251,2024-02-08 18:17:04
784,O3-03.桃井1丁目5番地,7,0,7,35.71013,139.61194,2024-02-08 18:17:04
785,H1-08.東京テレポート駅,35,6,41,35.627087,139.779779,2024-02-08 18:17:04
786,H1-05.相鉄グランドフレッサ 東京ベイ有明,3,11,14,35.632148,139.79017,2024-02-08 18:17:04
787,H1-06.武蔵野大学,0,22,22,35.630185,139.786618,2024-02-08 18:17:04
788,A4-15.TOKIWAブリッジ,0,30,30,35.686389,139.769237,2024-02-08 18:17:04
789,H1-160.花の広場,0,17,17,35.633908,139.793322,2024-02-08 18:17:04
790,H1-01.豊洲ＩＨＩビル前（晴海通り）,0,9,9,35.658911,139.792531,2024-02-08 18:17:04
791,H1-02.豊洲駅,0,59,59,35.654196,139.79626,2024-02-08 18:17:04
792,J1-19.NTT東日本自由が丘ビル,3,0,3,35.615098,139.675954,2024-02-08 18:17:04
793,C2-19.広尾駅,2,3,5,35.650732,139.72256,2024-02-08 18:17:04
794,H1-114.東京夢の島マリーナ,4,10,14,35.651987,139.830691,2024-02-08 18:17:04
795,K1-71.ファミリーマート大田大森南店,5,0,5,35.562769,139.74327,2024-02-08 18:17:04
796,J1-20.すずめのお宿緑地公園,7,1,8,35.617773,139.685351,2024-02-08 18:17:04
797,H1-115.東京夢の島マリーナ 第4駐車場,2,12,14,35.650235,139.835993,2024-02-08 18:17:04
798,M5-10.富ヶ谷2丁目,15,2,17,35.665961,139.686491,2024-02-08 18:17:04
799,J1-21.中央緑地公園,5,0,5,35.630694,139.690482,2024-02-08 18:17:04
800,H1-116.出会い橋高架下,26,23,49,35.625037,139.777646,2024-02-08 18:17:04
801,M3-12.渋谷南東急ビル,3,4,7,35.656228,139.706284,2024-02-08 18:17:04
802,T2-01.大泉学園駅北口,1,4,5,35.749918,139.58618,2024-02-08 18:17:04
803,K1-06.大森駅入新井自転車駐車場,5,1,6,35.585269,139.726279,2024-02-08 18:17:04
804,D6-06.新宿中央公園（エコギャラリー下）,0,17,17,35.691199,139.687966,2024-02-08 18:17:04
805,D6-14.新宿ファーストウエスト,6,8,14,35.689529,139.695995,2024-02-08 18:17:04
806,D6-15.住友不動産西新宿ビル,2,9,11,35.69465,139.695911,2024-02-08 18:17:04
807,H1-56.南砂三丁目緑地公園西,0,19,19,35.672361,139.829825,2024-02-08 18:17:04
808,T2-74.扇橋公園,3,2,5,35.731791,139.588844,2024-02-08 18:17:04
809,B2-20.SHビル,2,1,3,35.675398,139.779962,2024-02-08 18:17:04
810,I1-17.東品川海上公園第2,11,1,12,35.616364,139.749171,2024-02-08 18:17:04
811,I1-16.品川浦,14,0,14,35.6214,139.741958,2024-02-08 18:17:04
812,A4-11.二重橋前駅(メトロ4番出口),0,14,14,35.680753,139.762069,2024-02-08 18:17:04
813,H1-76.有明物流センター,5,13,18,35.638571,139.78829,2024-02-08 18:17:04
814,K1-43.北馬込わくわく公園,0,7,7,35.600707,139.703216,2024-02-08 18:17:04
815,K1-42.馬込西公園,12,2,14,35.58849,139.70376,2024-02-08 18:17:04
816,T1-08.セブン-イレブン 練馬高松6丁目店,0,4,4,35.756506,139.620347,2024-02-08 18:17:04
817,T2-17.ファミリーマート 練馬石神井町八丁目店,0,4,4,35.74755,139.597968,2024-02-08 18:17:04
818,K1-31.テクノWING,0,8,8,35.546252,139.731708,2024-02-08 18:17:04
819,K1-32.石川町文化センター,5,0,5,35.601958,139.682876,2024-02-08 18:17:04
820,I1-20.しおじ公園,19,0,19,35.59632,139.751279,2024-02-08 18:17:04
821,I1-19.品川シーサイド公園第2,0,7,7,35.607571,139.749108,2024-02-08 18:17:04
822,J1-29.カスタリア目黒鷹番,4,1,5,35.626121,139.688576,2024-02-08 18:17:04
823,H1-127.古石場川親水公園,15,8,23,35.669291,139.795364,2024-02-08 18:17:04
824,D4-05.カスタリア新宿7丁目,0,8,8,35.700732,139.711472,2024-02-08 18:17:04
825,I1-71.セブン-イレブン南大井浜川店,4,0,4,35.596483,139.7355,2024-02-08 18:17:04
826,I1-72.セブン-イレブン大井店,6,0,6,35.600081,139.728193,2024-02-08 18:17:04
827,T3-21.くまのやま緑地,4,1,5,35.747038,139.667965,2024-02-08 18:17:04
828,K1-110.萩中集会所裏,12,2,14,35.550479,139.739538,2024-02-08 18:17:04
829,O2-02.シエール荻窪,30,0,30,35.708265,139.612703,2024-02-08 18:17:04
830,H1-128.豊洲市場（5街区）,18,17,35,35.645162,139.785386,2024-02-08 18:17:04
831,N1-09.若宮レジデンス,2,3,5,35.716184,139.643905,2024-02-08 18:17:04
832,M6-12.LIVART SEASON 幡ヶ谷,7,0,7,35.683156,139.67338,2024-02-08 18:17:04
833,H1-142.東京ベイ潮見プリンスホテル,10,1,11,35.660632,139.817294,2024-02-08 18:17:04
834,G1-01.鐘ヶ淵駅南自転車駐車場,2,7,9,35.732291,139.82012,2024-02-08 18:17:04
835,M1-01.渋谷区役所,0,23,23,35.66362,139.69801,2024-02-08 18:17:04
836,I1-83.かもめ歩道橋,2,10,12,35.600161,139.749902,2024-02-08 18:17:04
837,N4-05.セブン-イレブン中野鍋横店,2,3,5,35.693815,139.668571,2024-02-08 18:17:04
838,D4-02.JICA市ヶ谷ビル（地球ひろば／研究所）,7,0,7,35.694927,139.731328,2024-02-08 18:17:04
839,T3-19.なかみや児童遊園,1,4,5,35.749388,139.651824,2024-02-08 18:17:04
840,N1-08.上鷺自転車保管場所,2,5,7,35.729056,139.627864,2024-02-08 18:17:04
841,O7-06.松木1丁目,2,11,13,35.686015,139.642784,2024-02-08 18:17:04
842,E4-16.ビレッジワン,7,0,7,35.723723,139.740143,2024-02-08 18:17:04
843,D1-15.フロンティア四谷,3,5,8,35.68768,139.71937,2024-02-08 18:17:04
844,K1-128.大森西3丁目,12,2,14,35.571975,139.732137,2024-02-08 18:17:04
845,N1-06.大和区民活動センター,4,1,5,35.713562,139.649075,2024-02-08 18:17:04
846,G4-01.両国ビューホテル1,2,5,7,35.69566,139.79214,2024-02-08 18:17:04
847,G4-02.両国ビューホテル2,5,3,8,35.69562,139.79206,2024-02-08 18:17:04
848,G4-05.両国駅西口臨時自転車駐車場,17,3,20,35.698588,139.792946,2024-02-08 18:17:04
849,G4-03.本所1-6-5,11,2,13,35.702525,139.796632,2024-02-08 18:17:04
850,G5-01.牡丹橋自転車駐車場,13,5,18,35.693059,139.813417,2024-02-08 18:17:04
851,G5-02.横川3-7-10,21,16,37,35.70378,139.814298,2024-02-08 18:17:04
852,G4-04.NTTドコモ墨田ビル,18,3,21,35.697898,139.795345,2024-02-08 18:17:04
853,G2-02.押上1-23-8,4,4,8,35.710111,139.81488,2024-02-08 18:17:04
854,C5-13.区立芝浦西運河沿緑地,39,0,39,35.638245,139.749754,2024-02-08 18:17:04
855,D6-12.東京ビジネスホテル,1,1,2,35.69342,139.710568,2024-02-08 18:17:04
856,D6-11.ホテルリステル新宿,0,2,2,35.693029,139.711327,2024-02-08 18:17:04
857,D6-10.ホテルサンライト新宿,0,4,4,35.694201,139.707047,2024-02-08 18:17:04
858,H1-39.辰巳駅東口自転車駐車場,15,10,25,35.645823,139.812178,2024-02-08 18:17:04
859,H1-38.辰巳駅西口自転車駐車場,89,0,89,35.646857,139.808912,2024-02-08 18:17:04
860,C2-10.元麻布三丁目,3,4,7,35.655865,139.730566,2024-02-08 18:17:04
861,C2-09.麻布地区総合支所,0,2,2,35.660614,139.734771,2024-02-08 18:17:04
862,M3-20.東急ステイ渋谷新南口,7,1,8,35.65494,139.70534,2024-02-08 18:17:04
863,I1-86.ファミリーマート二葉三丁目店,1,0,1,35.601694,139.719778,2024-02-08 18:17:04
864,A2-23.axle御茶ノ水,3,4,7,35.696126,139.763297,2024-02-08 18:17:04
865,C4-02.白金台いきいきプラザ,2,3,5,35.63756,139.724981,2024-02-08 18:17:04
866,N3-04.東中野駅地下駐輪場,0,23,23,35.707883,139.683284,2024-02-08 18:17:04
867,N3-05.中野坂上駅地下駐輪場,0,8,8,35.698068,139.682781,2024-02-08 18:17:04
868,N3-03.青桐公園,0,8,8,35.697024,139.677846,2024-02-08 18:17:04
869,N3-01.中野四季の森公園,0,14,14,35.708487,139.662135,2024-02-08 18:17:04
870,N4-01.本四公園,7,2,9,35.69693,139.672721,2024-02-08 18:17:04
871,N4-02.栄町公園,9,0,9,35.686474,139.671383,2024-02-08 18:17:04
872,K1-57.池上本門寺,6,0,6,35.579585,139.705377,2024-02-08 18:17:04
873,C1-49.汐留シティセンター,0,17,17,35.666213,139.760907,2024-02-08 18:17:04
874,C4-15.クロスレジデンス白金高輪,2,11,13,35.642771,139.733046,2024-02-08 18:17:04
875,K1-56.NTT馬込ビル,3,1,4,35.588106,139.718852,2024-02-08 18:17:04
876,J1-41.CASSIA目黒,7,2,9,35.631319,139.70237,2024-02-08 18:17:04
877,A2-22.専修大学,1,5,6,35.696147,139.753709,2024-02-08 18:17:04
878,T3-20.はやいち公園,1,3,4,35.75312,139.65661,2024-02-08 18:17:04
879,B3-19.本の森ちゅうおう,0,9,9,35.67363,139.77623,2024-02-08 18:17:04
880,K1-86.IMPREST STAY TOKYO 蒲田,20,1,21,35.556267,139.727246,2024-02-08 18:17:04
881,T3-23.氷川台二丁目緑地,3,1,4,35.756575,139.669689,2024-02-08 18:17:04
882,T3-22.氷川台三丁目ちびっこ公園,2,1,3,35.750547,139.66707,2024-02-08 18:17:04
883,B1-23.NANAEI日本橋,5,1,6,35.679616,139.784341,2024-02-08 18:17:04
884,B2-11.京橋エドグラン,0,31,31,35.677576,139.769822,2024-02-08 18:17:04
885,N1-05.大野ハイツ,2,3,5,35.7266,139.62948,2024-02-08 18:17:04
886,B2-09.茅場町一丁目平和ビル,0,11,11,35.680203,139.778679,2024-02-08 18:17:04
887,B2-08.共同ビル（茅場町交差点前）,3,6,9,35.681012,139.778569,2024-02-08 18:17:04
888,B2-07.東京証券会館（北側）,0,7,7,35.680864,139.779331,2024-02-08 18:17:04
889,O3-12.大宮前体育館,1,2,3,35.696567,139.610517,2024-02-08 18:17:04
890,B1-08.明治座,0,8,8,35.688038,139.786561,2024-02-08 18:17:04
891,B4-05.ドコモ・バイクシェア晴海ポート,0,53,53,35.654165,139.781568,2024-02-08 18:17:04
892,B4-04.ＫＤＸ晴海ビル,0,0,0,35.65443,139.77843,2024-02-08 18:17:04
893,B4-03.桜の散歩道（晴海トリトンスクエア前）,0,30,30,35.658665,139.782553,2024-02-08 18:17:04
894,E5-08.セブン-イレブン 文京動坂上店,5,0,5,35.727778,139.756296,2024-02-08 18:17:04
895,H1-65.ローソン南砂日曹橋店,15,0,15,35.669507,139.825553,2024-02-08 18:17:04
896,H1-66.中川船番所資料館,6,2,8,35.687732,139.846383,2024-02-08 18:17:04
897,K1-113.ファミリーマート大田上池台四丁目店,5,2,7,35.594658,139.700133,2024-02-08 18:17:04
898,H1-64.ローソン東雲駅前店,4,6,10,35.640228,139.804267,2024-02-08 18:17:04
899,E1-11.小石川運動場前,3,12,15,35.703914,139.747061,2024-02-08 18:17:04
900,T2-70.三ツ塚けやき緑地,2,2,4,35.720318,139.570762,2024-02-08 18:17:04
901,H1-137.住友不動産ショッピングシティ有明ガーデン,16,4,20,35.638985,139.793653,2024-02-08 18:17:04
902,C5-40.芝浦ふ頭駅前暫定自転車駐車場,0,5,5,35.64096,139.75754,2024-02-08 18:17:04
903,M3-21.渋谷ソラスタ,5,7,12,35.65618,139.69612,2024-02-08 18:17:04
904,D7-03.中井駅北,29,2,31,35.715645,139.687486,2024-02-08 18:17:04
905,K1-119.シーンズ大森パークサイド,4,0,4,35.58223,139.72763,2024-02-08 18:17:04
906,M6-15.cova Hatagaya,1,0,1,35.67741,139.67383,2024-02-08 18:17:04
907,C2-25.アパホテル＆リゾート＜六本木駅東＞,16,26,42,35.661783,139.737242,2024-02-08 18:17:04
908,D4-10.東新宿ポート(余丁町6番),6,0,6,35.696585,139.713081,2024-02-08 18:17:04
909,O1-02.井荻南地下自転車駐車場,5,9,14,35.72424,139.61431,2024-02-08 18:17:04
910,O1-03.LUCKY HOUSE,1,3,4,35.72489,139.62383,2024-02-08 18:17:04
911,D6-30.京王プラザホテル,4,3,7,35.6897,139.694823,2024-02-08 18:17:04
912,D6-29.都庁第二本庁舎前,11,3,14,35.688735,139.692249,2024-02-08 18:17:04
913,O3-02.アートメゾン荻窪,6,2,8,35.71355,139.6199,2024-02-08 18:17:04
914,J1-57.トレインチ自由が丘,4,1,5,35.606667,139.667324,2024-02-08 18:17:04
915,O2-01.サカエフラット荻窪,10,1,11,35.70535,139.61497,2024-02-08 18:17:04
916,O3-01.西田公園,7,0,7,35.69575,139.62065,2024-02-08 18:17:04
917,K1-47.NTT雪ヶ谷ビル,11,0,11,35.598601,139.684747,2024-02-08 18:17:04
918,Z17.NTT川崎ビル,9,0,9,35.529519,139.704845,2024-02-08 18:17:04
919,O7-04.永福町西幸モータープール西,7,1,8,35.67161,139.64527,2024-02-08 18:17:04
920,K1-48.ファミリーマート大田上池台三丁目店,1,4,5,35.590934,139.696915,2024-02-08 18:17:04
921,K1-111.本羽田公園,6,1,7,35.546499,139.736761,2024-02-08 18:17:04
922,C1-58.ウォーターズ竹芝,0,9,9,35.655937,139.763251,2024-02-08 18:17:04
923,K1-109.萩中公園プール駐輪場,8,0,8,35.549323,139.737091,2024-02-08 18:17:04
924,K1-108.仲江名公園,3,0,3,35.557999,139.732564,2024-02-08 18:17:04
925,E1-17.小石川パークスクエア,10,0,10,35.713913,139.745416,2024-02-08 18:17:04
926,D6-23.アパホテル 東新宿 歌舞伎町西,0,2,2,35.697535,139.703633,2024-02-08 18:17:04
927,H1-98.洲崎川緑道公園,8,1,9,35.668705,139.810549,2024-02-08 18:17:04
928,H1-99.南砂三丁目公園,15,9,24,35.669695,139.831874,2024-02-08 18:17:04
929,H1-96.越中島公園,0,14,14,35.668757,139.790156,2024-02-08 18:17:04
930,H1-97.浜園公園,7,0,7,35.661852,139.802224,2024-02-08 18:17:04
931,H1-94.新木場一丁目緑地公園,1,8,9,35.64423,139.835823,2024-02-08 18:17:04
932,H1-95.若洲公園,6,18,24,35.619451,139.834429,2024-02-08 18:17:04
933,J1-09.ファミリーマート佐野久下目黒店,4,0,4,35.629252,139.712716,2024-02-08 18:17:04
934,H1-93.新木場一丁目公園,0,22,22,35.64143,139.835455,2024-02-08 18:17:04
935,I1-55.鈴ヶ森公園,6,2,8,35.593559,139.734704,2024-02-08 18:17:04
936,O6-04.柏の宮公園,1,4,5,35.67834,139.62711,2024-02-08 18:17:04
937,B4-14.Brillia ist Tower 勝どき,8,2,10,35.660526,139.776816,2024-02-08 18:17:04
938,D7-08.上落合3丁目,0,15,15,35.71115,139.68232,2024-02-08 18:17:04
939,H1-21.UR東雲キャナルコート,13,0,13,35.646041,139.804495,2024-02-08 18:17:04
940,H1-20.日本科学未来館,10,19,29,35.619377,139.777582,2024-02-08 18:17:04
941,H1-19.UR豊洲四丁目団地,19,2,21,35.653603,139.80144,2024-02-08 18:17:04
942,T2-45.風致地区バス停第三自転車駐車場,3,4,7,35.771068,139.586798,2024-02-08 18:17:04
943,H1-33.深川ギャザリア（ウエストスクエア）,1,7,8,35.66789,139.803,2024-02-08 18:17:04
944,H1-32.区営塩浜住宅前,3,17,20,35.664591,139.813954,2024-02-08 18:17:04
945,H1-23.KDX豊洲グランスクエア,0,15,15,35.648085,139.798986,2024-02-08 18:17:04
946,C2-22.飯倉公園,8,0,8,35.655649,139.74427,2024-02-08 18:17:04
947,I1-89.下神明駅自転車駐車場,5,0,5,35.608402,139.726118,2024-02-08 18:17:04
948,C5-39.お台場海浜公園東,13,0,13,35.631021,139.778109,2024-02-08 18:17:04
949,C5-38.お台場海浜公園乗船場,0,20,20,35.628743,139.773915,2024-02-08 18:17:04
950,O4-08.ローソン阿佐ヶ谷青梅街道店,0,5,5,35.703203,139.62804,2024-02-08 18:17:04
951,T2-72.高塚南緑地,5,1,6,35.733132,139.570311,2024-02-08 18:17:04
952,O6-03.みなみ荘,5,5,10,35.68073,139.62803,2024-02-08 18:17:04
953,K1-129.ローソン東糀谷一丁目店,0,6,6,35.557427,139.739126,2024-02-08 18:17:04
954,E1-03.東京ドーム（黄色いビル横）,6,2,8,35.70319,139.751888,2024-02-08 18:17:04
955,K1-23.大田区役所本庁舎前,8,1,9,35.561183,139.716339,2024-02-08 18:17:04
956,T2-78.北大泉くれはし公園,2,1,3,35.761474,139.592735,2024-02-08 18:17:04
957,J1-53.ボヌールAllamanda,2,3,5,35.612833,139.675047,2024-02-08 18:17:04
958,A3-39.トーシン東神田ビル,2,2,4,35.694834,139.780333,2024-02-08 18:17:04
959,O6-01.高井戸みどり公園,5,4,9,35.67912,139.61074,2024-02-08 18:17:04
960,T2-79.大泉学園町八丁目緑地,5,1,6,35.774457,139.596182,2024-02-08 18:17:04
961,O5-04.リヴィエール,18,2,20,35.70104,139.65839,2024-02-08 18:17:04
962,N3-08.中野区役所(西側),2,3,5,35.707968,139.663519,2024-02-08 18:17:04
963,I1-99.北品川２丁目,6,0,6,35.61663,139.74192,2024-02-08 18:17:04
964,P1-01.サンシャインシティ,3,4,7,35.728846,139.718577,2024-02-08 18:17:04
965,N3-14.ヴィラソンサ落合,0,6,6,35.713227,139.680966,2024-02-08 18:17:04
966,H1-49.セブン-イレブン 江東新砂３丁目店,0,20,20,35.667892,139.8311,2024-02-08 18:17:04
967,I1-06.大森貝塚遺跡庭園,8,1,9,35.593489,139.72967,2024-02-08 18:17:04
968,M2-12.恵比寿プライムスクエアタワー北,8,0,8,35.650541,139.713361,2024-02-08 18:17:04
969,H1-69.ファミリーマート 江東石島店,7,2,9,35.680474,139.812316,2024-02-08 18:17:04
970,B3-09.築地永谷コーポラス,8,5,13,35.66523,139.776313,2024-02-08 18:17:04
971,E4-10.白山四丁目第二児童遊園横,9,0,9,35.720349,139.746924,2024-02-08 18:17:04
972,I1-03.大井町駅中央口（西側）,5,2,7,35.605617,139.73472,2024-02-08 18:17:04
973,I1-04.大井町歩道橋,4,1,5,35.605146,139.734694,2024-02-08 18:17:04
974,I1-01.品川区役所 本庁舎前,9,0,9,35.609052,139.729825,2024-02-08 18:17:04
975,I1-02.品川区役所 第三庁舎前,8,1,9,35.608161,139.730048,2024-02-08 18:17:04
976,G4-08.ブオンサンヴァレンティーノ,6,0,6,35.691677,139.793857,2024-02-08 18:17:04
977,J1-13.洗足二丁目駐輪場,14,3,17,35.61061,139.693443,2024-02-08 18:17:04
978,J1-16.八雲橋自転車置場,5,0,5,35.617353,139.672256,2024-02-08 18:17:04
979,H1-189.MFLP新木場2,4,25,29,35.634453,139.824,2024-02-08 18:17:04
980,M6-09.ファミリーマート渋谷本町店,2,1,3,35.683756,139.684965,2024-02-08 18:17:04
981,H1-113.123+N東雲店,24,1,25,35.646366,139.801492,2024-02-08 18:17:04
982,J1-17.ファミリーマート原町二丁目店,5,1,6,35.613902,139.691476,2024-02-08 18:17:04
983,E5-21.動坂公園,10,1,11,35.73176,139.756669,2024-02-08 18:17:04
984,E5-20.本郷2丁目,0,5,5,35.704391,139.758575,2024-02-08 18:17:04
985,T2-48.武蔵関駅南第二自転車駐車場,2,2,4,35.726064,139.578015,2024-02-08 18:17:04
986,A6-26.相互半蔵門ビル,7,5,12,35.683378,139.743189,2024-02-08 18:17:04
987,J1-31.守屋図書館,18,2,20,35.634194,139.688833,2024-02-08 18:17:04
988,M3-19.渋谷キャスト,10,11,21,35.662146,139.702793,2024-02-08 18:17:04
989,N1-04.都立家政南駐輪場,2,5,7,35.721679,139.645265,2024-02-08 18:17:04
990,Z09.ファミリーマート川崎川中島二丁目店,0,9,9,35.529781,139.727511,2024-02-08 18:17:04
991,N2-02.江古田1丁目A,2,1,3,35.724988,139.672511,2024-02-08 18:17:04
992,C1-56.鈴与竹芝ビル,0,10,10,35.654873,139.762103,2024-02-08 18:17:04
993,D3-07.戸塚特別出張所,0,5,5,35.71429,139.70507,2024-02-08 18:17:04
994,G4-12.プレミアムキューブ両国,7,0,7,35.70103,139.803341,2024-02-08 18:17:04
995,A2-21.神田神保町3丁目,3,4,7,35.694578,139.754434,2024-02-08 18:17:04
996,B4-19.コーシャタワー佃,0,5,5,35.668044,139.785801,2024-02-08 18:17:04
997,I1-81.戸越6丁目,20,0,20,35.608127,139.717865,2024-02-08 18:17:04
998,A6-24.国立劇場,0,15,15,35.682218,139.743292,2024-02-08 18:17:04
999,E5-23.ビレッジ千駄木,3,3,6,35.722353,139.760966,2024-02-08 18:17:04
1000,H1-119.榎戸材木店,0,22,22,35.638319,139.834741,2024-02-08 18:17:04
1001,C5-29.Hi-NODE(ハイノード),7,1,8,35.651672,139.760549,2024-02-08 18:17:04
1002,J1-22.NTTコミュニケーションズ唐ヶ崎ビル,4,0,4,35.627373,139.692044,2024-02-08 18:17:04
1003,A2-18.猿楽町SSビル東,5,1,6,35.698654,139.759762,2024-02-08 18:17:04
1004,A2-19.猿楽町SSビル西,0,4,4,35.698641,139.759306,2024-02-08 18:17:04
1005,C1-55.アーバンネット内幸町ビル,13,7,20,35.669267,139.756018,2024-02-08 18:17:04
1006,D4-06.グリーンフォート河田,4,1,5,35.697143,139.718739,2024-02-08 18:17:04
1007,K1-134.東調布公園,10,0,10,35.588363,139.69042,2024-02-08 18:17:04
1008,Z12.京急川崎西口駐輪場B,21,0,21,35.533627,139.700527,2024-02-08 18:17:04
1009,M5-18.Luxe初台,4,1,5,35.679182,139.68596,2024-02-08 18:17:04
1010,D7-06.エムアイセミナーハウス,5,0,5,35.721064,139.677128,2024-02-08 18:17:04
1011,A3-37.ポータル秋葉原,4,0,4,35.695737,139.78162,2024-02-08 18:17:04
1012,M5-11.あおい通り,5,3,8,35.688154,139.698975,2024-02-08 18:17:04
1013,E5-04.保健サービスセンター本郷支所,5,0,5,35.727046,139.760439,2024-02-08 18:17:04
1014,E5-03.汐見地域活動センター（本郷図書館）,2,3,5,35.725538,139.76116,2024-02-08 18:17:04
1015,E5-01.文京総合体育館,22,9,31,35.708121,139.763583,2024-02-08 18:17:04
1016,E4-01.千石南自転車駐車場,17,8,25,35.72707,139.746112,2024-02-08 18:17:04
1017,E3-03.大塚公園,10,10,20,35.724286,139.730954,2024-02-08 18:17:04
1018,E3-02.教育の森公園,11,6,17,35.719345,139.736198,2024-02-08 18:17:04
1019,I1-25.セブン-イレブン 品川旗の台2丁目店,3,0,3,35.607084,139.705007,2024-02-08 18:17:04
1020,B1-21.日本橋二丁目街角広場,0,9,9,35.680861,139.774493,2024-02-08 18:17:04
1021,C3-30.東京赤坂NKビル (ヴィアインプライム赤坂),4,5,9,35.672652,139.738908,2024-02-08 18:17:04
1022,A3-36.クロックカフェ東神田,0,4,4,35.694943,139.782718,2024-02-08 18:17:04
1023,E1-14.いきいき礫川,9,0,9,35.711147,139.747386,2024-02-08 18:17:04
1024,D4-09.トミンハイム仲之町,2,3,5,35.69617,139.722021,2024-02-08 18:17:04
1025,L1-08.NTT砧ビル,1,5,6,35.63534,139.601602,2024-02-08 18:17:04
1026,L1-09.コージーK・駒沢,1,2,3,35.632689,139.654804,2024-02-08 18:17:04
1027,L1-10.宮坂2-4-10,0,7,7,35.652913,139.644825,2024-02-08 18:17:04
1028,I1-22.ウィラ大井 (ショッピングモール),0,5,5,35.596579,139.745009,2024-02-08 18:17:04
1029,K1-76.グリーンベルト,9,1,10,35.585178,139.726339,2024-02-08 18:17:04
1030,H1-121.南砂5丁目,2,14,16,35.676603,139.829736,2024-02-08 18:17:04
1031,M3-02.文化総合センター大和田,2,2,4,35.65558,139.69966,2024-02-08 18:17:04
1032,D4-04.ジェノヴィア新宿早稲田グリーンヴェール,6,0,6,35.700033,139.71983,2024-02-08 18:17:04
1033,A3-20.神田ふれあい通り第２,0,2,2,35.695005,139.772747,2024-02-08 18:17:04
1034,H1-120.豊洲5丁目,16,2,18,35.650948,139.799711,2024-02-08 18:17:04
1035,C5-42.DHC芝浦2丁目ビル,6,0,6,35.644241,139.753834,2024-02-08 18:17:04
1036,I1-65.セブン-イレブン品川東大井1丁目店,6,0,6,35.605996,139.743037,2024-02-08 18:17:04
1037,M2-04.広尾東公園,6,0,6,35.653382,139.721059,2024-02-08 18:17:04
1038,M3-13.渋谷駅東口地下駐輪場,15,4,19,35.657682,139.703307,2024-02-08 18:17:04
1039,A3-19.神田ふれあい通り第１,3,2,5,35.694904,139.772712,2024-02-08 18:17:04
1040,O6-07.ローソン杉並宮前一丁目店,2,3,5,35.689639,139.613516,2024-02-08 18:17:04
1041,T3-10.貫井一丁目緑地,2,1,3,35.736378,139.632485,2024-02-08 18:17:04
1042,M2-05.日本赤十字医療センター,0,10,10,35.65519,139.718559,2024-02-08 18:17:04
1043,T2-20.パークサイド石神井,0,4,4,35.741769,139.591103,2024-02-08 18:17:04
1044,N4-06.ローソン中野本町新橋通り店,1,3,4,35.695819,139.674326,2024-02-08 18:17:04
1045,T3-07.徳殿公園,3,1,4,35.726728,139.65874,2024-02-08 18:17:04
1046,K1-35.セブン-イレブン 大田区西六郷2丁目店,5,0,5,35.549778,139.707362,2024-02-08 18:17:04
1047,A3-27.秋葉原駅中央口（ヨドバシカメラ前）,8,3,11,35.698986,139.774099,2024-02-08 18:17:04
1048,A3-28.秋葉原駅電気街口(西側交通広場),2,3,5,35.699173,139.772629,2024-02-08 18:17:04
1049,H1-57.新木場駅,39,26,65,35.64508,139.826456,2024-02-08 18:17:04
1050,H1-58.潮見駅,0,22,22,35.658703,139.817251,2024-02-08 18:17:04
1051,D7-02.セブン-イレブン 新宿中落合3丁目店,0,5,5,35.722202,139.691712,2024-02-08 18:17:04
1052,D2-06.飯田濠,5,9,14,35.70057,139.74301,2024-02-08 18:17:04
1053,C5-17.鈴与浜松町ビル,1,9,10,35.651103,139.759092,2024-02-08 18:17:04
1054,H1-59.LYURO 東京清澄,13,1,14,35.681316,139.792176,2024-02-08 18:17:04
1055,H1-60.荒川・砂町庭球場西,0,10,10,35.679678,139.844892,2024-02-08 18:17:04
1056,K1-44.中馬込貝塚公園,7,0,7,35.594795,139.704951,2024-02-08 18:17:04
1057,M6-11.京王サイクルパーク笹塚,5,0,5,35.674337,139.668801,2024-02-08 18:17:04
1058,J1-49.伊勢脇公園,0,2,2,35.638864,139.696568,2024-02-08 18:17:04
1059,K1-45.たぬき山公園,8,0,8,35.592801,139.715472,2024-02-08 18:17:04
1060,D2-01.あずさセンタービル,9,8,17,35.702286,139.741093,2024-02-08 18:17:04
1061,C1-02.西新橋1丁目（外堀通り）,0,5,5,35.668791,139.753582,2024-02-08 18:17:04
1062,O3-07.NTT井草ビル第1ポート,3,0,3,35.714044,139.61688,2024-02-08 18:17:04
1063,T2-41.ローソン 練馬東大泉五丁目店,2,2,4,35.74248,139.58715,2024-02-08 18:17:04
1064,H1-144.南砂住宅,7,0,7,35.674199,139.822018,2024-02-08 18:17:04
1065,C3-28.ヒューリックＪＰ赤坂ビル,0,13,13,35.672477,139.739743,2024-02-08 18:17:04
1066,H1-145.東雲都橋住宅,5,0,5,35.643131,139.797784,2024-02-08 18:17:04
1067,I1-58.品川区役所　第二庁舎前,18,0,18,35.609664,139.730006,2024-02-08 18:17:04
1068,K1-92.蒲田駅西口自転車駐車場,21,3,24,35.561101,139.715173,2024-02-08 18:17:04
1069,A2-24.水道橋駅西口前,2,4,6,35.702271,139.752619,2024-02-08 18:17:04
1070,K1-94.昭和島駅前,1,4,5,35.572188,139.749613,2024-02-08 18:17:04
1071,M5-15.新宿マインズタワー,13,7,20,35.686567,139.699355,2024-02-08 18:17:04
1072,D7-13.日本光電本社南側,15,0,15,35.71936,139.679083,2024-02-08 18:17:04
1073,N3-09.中野区役所(北側),0,5,5,35.708259,139.663829,2024-02-08 18:17:04
1074,H1-163.森下公園,3,1,4,35.68663,139.799529,2024-02-08 18:17:04
1075,B4-23.交通広場（豊海町）,4,7,11,35.653771,139.769295,2024-02-08 18:17:04
1076,D6-18.ヨドバシカメラ 新宿西口本店前,1,6,7,35.689689,139.698231,2024-02-08 18:17:04
1077,I1-47.NTT 東日本 関東病院(南側),0,9,9,35.630151,139.725215,2024-02-08 18:17:04
1078,H1-112.ファミリーマート江東塩浜二丁目店,3,0,3,35.66305,139.8087,2024-02-08 18:17:04
1079,K1-103.雪谷特別出張所,0,4,4,35.594515,139.691219,2024-02-08 18:17:04
1080,E5-17.Village藍染,5,0,5,35.720896,139.76422,2024-02-08 18:17:04
1081,Z04.ローソン川崎四谷上町店,7,1,8,35.527562,139.737102,2024-02-08 18:17:04
1082,Z03.ローソン川崎塩浜三丁目店,0,6,6,35.523754,139.746356,2024-02-08 18:17:04
1083,I1-49.京急鮫洲バイク駐輪場,6,0,6,35.603815,139.741362,2024-02-08 18:17:04
1084,I1-50.京急立会川第2バイク駐輪場,5,2,7,35.599196,139.739158,2024-02-08 18:17:04
1085,E4-14.NTT東日本大塚ビル,0,7,7,35.726188,139.741375,2024-02-08 18:17:04
1086,M2-07.ファミリーマート恵比寿駅東店,3,4,7,35.6471,139.712818,2024-02-08 18:17:04
1087,M4-07.千駄ヶ谷駅前,1,2,3,35.68082,139.71188,2024-02-08 18:17:04
1088,O5-07.バーンホーフ キクチ,8,12,20,35.698169,139.655665,2024-02-08 18:17:04
1089,J1-11.コンフォリア目黒青葉台,0,8,8,35.649023,139.696086,2024-02-08 18:17:04
1090,L1-14.給田3丁目,0,12,12,35.664335,139.590114,2024-02-08 18:17:04
1091,B4-06.月島駅地下駐輪場,1,16,17,35.66291,139.782564,2024-02-08 18:17:04
1092,C5-09.グランパーク,20,1,21,35.643202,139.746244,2024-02-08 18:17:04
1093,C5-08.AQUACITY芝浦,4,5,9,35.637366,139.74844,2024-02-08 18:17:04
1094,C3-08.赤坂パークビルヂング,3,2,5,35.671792,139.733668,2024-02-08 18:17:04
1095,C3-07.新青山ビル,10,8,18,35.672659,139.725644,2024-02-08 18:17:04
1096,C3-06.ホテルアジア会館,2,7,9,35.67064,139.728166,2024-02-08 18:17:04
1097,C1-24.三田国際ビル,0,29,29,35.653159,139.744673,2024-02-08 18:17:04
1098,C5-07.港区立港南図書館,8,1,9,35.632842,139.7495,2024-02-08 18:17:04
1099,A3-04.秋葉原公園,16,4,20,35.697642,139.774867,2024-02-08 18:17:04
1100,A3-05.和泉公園（西側入口）,5,0,5,35.698817,139.778898,2024-02-08 18:17:04
1101,A3-02.絶滅メディア博物館（楓ビル）,4,3,7,35.689575,139.767848,2024-02-08 18:17:04
1102,O3-10.メゾンパークス,6,2,8,35.716265,139.618954,2024-02-08 18:17:04
1103,A2-05.神田橋公園,0,25,25,35.689665,139.764091,2024-02-08 18:17:04
1104,A3-01.神田児童公園（西側交番横）,0,7,7,35.692983,139.76773,2024-02-08 18:17:04
1105,A2-03.西神田公園（西側）,5,0,5,35.698338,139.754876,2024-02-08 18:17:04
1106,M6-03.十三号通り公園,7,0,7,35.675198,139.663587,2024-02-08 18:17:04
1107,M6-02.サイカパーク笹塚,6,0,6,35.673444,139.666553,2024-02-08 18:17:04
1108,H1-165.亀戸梅屋敷,0,8,8,35.701318,139.825916,2024-02-08 18:17:04
1109,H1-166.亀戸クロック,8,9,17,35.696574,139.82972,2024-02-08 18:17:04
1110,M5-02.あいおいニッセイ同和損保新宿ビル,0,6,6,35.684423,139.692262,2024-02-08 18:17:04
1111,M6-01.幡ヶ谷駅高架下第一,32,5,37,35.677175,139.676769,2024-02-08 18:17:04
1112,A5-02.山王パークタワー,0,18,18,35.673555,139.741293,2024-02-08 18:17:04
1113,K1-116.旧呑川緑地（大森東五丁目）,12,0,12,35.567176,139.742345,2024-02-08 18:17:04
1114,K1-115.旧呑川緑地（大森中三丁目）,4,0,4,35.565685,139.736195,2024-02-08 18:17:04
1115,K1-114.下丸子公園,8,0,8,35.568722,139.680736,2024-02-08 18:17:04
1116,T3-05.東武練馬駅南,3,7,10,35.767129,139.664365,2024-02-08 18:17:04
1117,T1-14.ファミリーマート 練馬高松五丁目北店,4,0,4,35.761038,139.623148,2024-02-08 18:17:04
1118,C3-29.高橋是清翁記念公園,3,3,6,35.674094,139.728895,2024-02-08 18:17:04
1119,K1-141.蒲田駅西口歩道,1,4,5,35.561291,139.715076,2024-02-08 18:17:04
1120,C3-35.ワールド北青山ビル,11,6,17,35.667069,139.713423,2024-02-08 18:17:04
1121,M5-03.代々木大山公園,16,0,16,35.671282,139.675307,2024-02-08 18:17:04
1122,E5-13.弥生二丁目,2,4,6,35.715592,139.76192,2024-02-08 18:17:04
1123,E5-12.NK本郷ビル,4,1,5,35.704475,139.763041,2024-02-08 18:17:04
1124,B3-18.銀座松竹スクエア,2,8,10,35.668395,139.769849,2024-02-08 18:17:04
1125,C1-44.三田Avanti,4,2,6,35.64115,139.741471,2024-02-08 18:17:04
1126,T2-31.ファミリーマート 石神井台二丁目店,0,5,5,35.739488,139.590273,2024-02-08 18:17:04
1127,H1-150.ホテルヴィラフォンテーヌ南側,8,1,9,35.636978,139.791858,2024-02-08 18:17:04
1128,H1-149.有明ガーデン 公園口,2,6,8,35.639132,139.793047,2024-02-08 18:17:04
1129,H1-148.大島七丁目団地,0,13,13,35.694104,139.840278,2024-02-08 18:17:04
1130,B4-26.東武ストア晴海三丁目店,12,1,13,35.654371,139.779545,2024-02-08 18:17:04
1131,J1-26.田向公園,5,2,7,35.623459,139.687128,2024-02-08 18:17:04
1132,J1-25.碑文谷公園,6,2,8,35.625081,139.682632,2024-02-08 18:17:04
1133,H1-195.東京アクアティクスセンター,10,9,19,35.65238,139.815613,2024-02-08 18:17:04
1134,T1-13.ファミリーマート 練馬土支田二丁目店,2,4,6,35.761613,139.61349,2024-02-08 18:17:04
1135,T2-34.ファミリーマート 練馬富士見台店,1,4,5,35.73969,139.62125,2024-02-08 18:17:04
1136,T2-35.ファミリーマート 石神井台六丁目店,1,3,4,35.738607,139.585331,2024-02-08 18:17:04
1137,C1-81.田町タワー,16,4,20,35.646534,139.748913,2024-02-08 18:17:04
1138,J1-07.目黒川船入場,13,2,15,35.641992,139.701588,2024-02-08 18:17:04
1139,J1-08.目黒区民センター公園,18,0,18,35.634533,139.708868,2024-02-08 18:17:04
1140,D4-01.市谷仲之町,6,0,6,35.695102,139.723345,2024-02-08 18:17:04
1141,M2-11.鉢山町,14,2,16,35.652151,139.698426,2024-02-08 18:17:04
1142,E4-08.ドコモ・バイクシェア向丘ポート,7,2,9,35.720546,139.756685,2024-02-08 18:17:04
1143,D4-03.市谷加賀町2丁目,4,0,4,35.695636,139.727882,2024-02-08 18:17:04
1144,Z10.ローソン川崎浅田三丁目店,8,2,10,35.506142,139.701005,2024-02-08 18:17:04
1145,N1-01.BeGood野方,1,8,9,35.719717,139.64785,2024-02-08 18:17:04
1146,C2-03.アークヒルズサウスタワー,0,17,17,35.666357,139.73923,2024-02-08 18:17:04
1147,C2-01.アークヒルズ（アーク森ビル）,0,19,19,35.667107,139.739565,2024-02-08 18:17:04
1148,C2-02.六本木ヒルズ,1,24,25,35.661158,139.728533,2024-02-08 18:17:04
1149,C5-03.港南公園C,1,24,25,35.624966,139.746657,2024-02-08 18:17:04
1150,C5-04.みなとパーク芝浦,7,0,7,35.646801,139.751208,2024-02-08 18:17:04
1151,C1-16.機械振興会館,3,3,6,35.659442,139.745549,2024-02-08 18:17:04
1152,C1-14.新橋プラザビル,4,1,5,35.664461,139.756082,2024-02-08 18:17:04
1153,H1-73.イシマビル,4,1,5,35.67386,139.79976,2024-02-08 18:17:04
1154,O7-01.西永福公園,5,0,5,35.67753,139.63667,2024-02-08 18:17:04
1155,O6-02.富士見ヶ丘南自転車駐車場,6,2,8,35.68296,139.60861,2024-02-08 18:17:04
1156,K1-50.テクノポートカマタ 第1,1,4,5,35.556199,139.721476,2024-02-08 18:17:04
1157,J1-14.二の橋自転車置場1,38,1,39,35.614856,139.678208,2024-02-08 18:17:04
1158,O3-08.NTT井草ビル第２ポート,3,0,3,35.714077,139.61694,2024-02-08 18:17:04
1159,H1-124.セブン-イレブン 江東海辺店,13,0,13,35.680636,139.817977,2024-02-08 18:17:04
1160,D1-11.三井ガーデンホテル神宮外苑の杜プレミア,1,4,5,35.679807,139.715931,2024-02-08 18:17:04
1161,O7-07.ハレ永福,3,5,8,35.678913,139.639944,2024-02-08 18:17:04
1162,C5-32.トレードピアお台場,0,18,18,35.627891,139.776896,2024-02-08 18:17:04
1163,B4-18.豊海センタービル,4,0,4,35.653531,139.769431,2024-02-08 18:17:04
1164,D5-04.西戸山公園野球場,6,1,7,35.707388,139.700204,2024-02-08 18:17:04
1165,D5-03.北新宿公園,0,7,7,35.702288,139.68862,2024-02-08 18:17:04
1166,D3-04.鶴巻南公園,3,3,6,35.706182,139.723394,2024-02-08 18:17:04
1167,D3-03.甘泉園公園,3,1,4,35.712431,139.715418,2024-02-08 18:17:04
1168,K1-03.池上会館,0,6,6,35.576593,139.706597,2024-02-08 18:17:04
1169,K1-02.平和の森公園,14,1,15,35.579049,139.739878,2024-02-08 18:17:04
1170,K1-01.大森海苔のふるさと館,0,16,16,35.57685,139.742496,2024-02-08 18:17:04
1171,D6-13.新宿中央公園（ジャブジャブ池下）,3,6,9,35.687652,139.689254,2024-02-08 18:17:04
1172,T2-28.ファミリーマート 南大泉六丁目店,4,1,5,35.752217,139.571095,2024-02-08 18:17:04
1173,K1-05.平和島公園プール,10,7,17,35.581832,139.741581,2024-02-08 18:17:04
1174,K1-04.京急蒲田駅東口,19,1,20,35.559483,139.724273,2024-02-08 18:17:04
1175,E2-10.音羽パークロード（北入口）,15,0,15,35.716586,139.727705,2024-02-08 18:17:04
1176,E2-11.音羽パークロード（キャッチボール場横）,18,1,19,35.715382,139.728533,2024-02-08 18:17:04
1177,I1-21.大井競馬場(正門前),10,0,10,35.593887,139.741204,2024-02-08 18:17:04
1178,J1-27.衾町公園,0,4,4,35.623215,139.668472,2024-02-08 18:17:04
1179,T2-44.中島橋自転車駐車場,4,3,7,35.75372,139.584332,2024-02-08 18:17:04
1180,B3-15.ACホテル・バイ・マリオット東京銀座,0,6,6,35.668845,139.765144,2024-02-08 18:17:04
1181,D5-07.百人町1丁目,3,3,6,35.699252,139.697606,2024-02-08 18:17:04
1182,C4-04.ショパン高輪,4,1,5,35.632128,139.732097,2024-02-08 18:17:04
1183,B1-18.セブン-イレブン 日本橋小網町店,0,3,3,35.681352,139.781436,2024-02-08 18:17:04
1184,T2-71.わかば児童公園,4,3,7,35.7211,139.574669,2024-02-08 18:17:04
1185,M3-15.co-ba ebisu,0,18,18,35.647076,139.703964,2024-02-08 18:17:04
1186,C2-20.三井ガーデンホテル六本木プレミア,0,5,5,35.66206,139.735501,2024-02-08 18:17:04
1187,I1-70.五反田リバーステーション,1,8,9,35.624566,139.72448,2024-02-08 18:17:04
1188,E5-25.ジェノヴィア東大前グリーンヴェール,10,0,10,35.711875,139.759306,2024-02-08 18:17:04
1189,D1-12.ジェノヴィア新宿御苑グリーンヴェール,3,5,8,35.689017,139.714755,2024-02-08 18:17:04
1190,C5-33.msb Tamachi,24,12,36,35.645682,139.748768,2024-02-08 18:17:04
1191,G4-09.SYFORME MORISHITA Ⅱ 1,1,0,1,35.690348,139.796133,2024-02-08 18:17:04
1192,G4-10.SYFORME MORISHITA Ⅱ 2,5,0,5,35.690307,139.796128,2024-02-08 18:17:04
1193,N3-19.上高田パーキング,1,11,12,35.715878,139.673669,2024-02-08 18:17:04
1194,Z13.京急川崎日進町駐輪場,7,4,11,35.528361,139.696499,2024-02-08 18:17:04
1195,F6-01.松坂屋上野店,2,3,5,35.707305,139.773657,2024-02-08 18:17:04
1196,F4-01.SYFORME ASAKUSA,3,1,4,35.718832,139.791133,2024-02-08 18:17:04
1197,F2-02.アップルパーク浅草6丁目第3,1,1,2,35.716062,139.799552,2024-02-08 18:17:04
1198,F2-01.松が谷2丁目2,3,17,20,35.71283,139.787754,2024-02-08 18:17:04
1199,F1-02.台東デザイナーズビレッジ,3,4,7,35.706023,139.783751,2024-02-08 18:17:04
1200,F2-03.台東区生涯学習センター,0,6,6,35.717497,139.790055,2024-02-08 18:17:04
1201,K1-146.南馬込6丁目25-11,3,0,3,35.582743,139.710561,2024-02-08 18:17:04
1202,F3-01.清川1丁目18-11,1,16,17,35.724944,139.801684,2024-02-08 18:17:04
1203,F1-03.新御徒町駅自転車駐車場,2,12,14,35.706793,139.782985,2024-02-08 18:17:04
1204,F3-02.台東区リバーサイドスポーツセンター,0,7,7,35.717571,139.804216,2024-02-08 18:17:04
1205,I1-45.セブン-イレブン品川西五反田3丁目店,0,6,6,35.62541,139.718135,2024-02-08 18:17:04
1206,H1-135.北砂5丁目団地,0,17,17,35.684218,139.832843,2024-02-08 18:17:04
1207,C3-16.赤坂ガーデンシティ,0,11,11,35.6738,139.731525,2024-02-08 18:17:04
1208,J1-34.田道広場公園,10,0,10,35.636269,139.709073,2024-02-08 18:17:04
1209,O5-08.セシオン杉並,0,3,3,35.69714,139.65432,2024-02-08 18:17:04
1210,A2-04.ちよだプラットフォームスクウェア,0,30,30,35.691456,139.762228,2024-02-08 18:17:04
1211,I1-102.J.GRAN Court 品川西大井 EAST,7,0,7,35.598244,139.722447,2024-02-08 18:17:04
1212,H1-196.フットサルクラブ東京東陽町,4,2,6,35.665288,139.824294,2024-02-08 18:17:04
1213,F2-04.コンフォラス浅草マンション,1,2,3,35.717241,139.801674,2024-02-08 18:17:04
1214,G5-03.京成リッチモンドホテル東京錦糸町,2,3,5,35.693492,139.81506,2024-02-08 18:17:04
1215,K1-27.六郷文化センター,4,0,4,35.544715,139.707623,2024-02-08 18:17:04
1216,K1-147.トヨタモビリティ東京GRGarage東京蒲田店,2,0,2,35.552741,139.718404,2024-02-08 18:17:04
1217,K1-148.トヨタモビリティ東京 蒲田仲六郷店,6,0,6,35.552068,139.71747,2024-02-08 18:17:04
1218,K1-150.トヨタモビリティ東京 池上第二京浜店,4,1,5,35.568019,139.696379,2024-02-08 18:17:04
1219,K1-149.トヨタモビリティ東京 大田店,6,0,6,35.59336,139.715879,2024-02-08 18:17:04
1220,C1-82.トヨタモビリティ東京 港三田店,5,0,5,35.647831,139.739048,2024-02-08 18:17:04
1221,D4-11.トヨタモビリティ東京 新宿明治通り南店,2,0,2,35.699835,139.70808,2024-02-08 18:17:04
1222,C3-31.赤坂一丁目,7,10,17,35.670239,139.744285,2024-02-08 18:17:04
1223,E1-04.礫川公園,30,10,40,35.707853,139.751518,2024-02-08 18:17:04
1224,M3-23.円山町7-1,4,5,9,35.658229,139.694885,2024-02-08 18:17:04
1225,M3-24.渋谷道玄坂２丁目駐輪場,2,15,17,35.66026,139.69684,2024-02-08 18:17:04
1226,T3-32.練馬北町1丁目,1,5,6,35.764452,139.666299,2024-02-08 18:17:04
1227,H1-197.セブン-イレブン江東南砂葛西橋通り店,3,0,3,35.675361,139.825034,2024-02-08 18:17:04
1228,T2-84.石神井町二丁目緑地,0,3,3,35.748395,139.605958,2024-02-08 18:17:04
1229,T2-82.梅の木児童遊園,2,3,5,35.737899,139.576584,2024-02-08 18:17:04
1230,T2-83.西大泉さくら緑地,5,3,8,35.760442,139.573145,2024-02-08 18:17:04
1231,D7-05.西落合図書館,7,1,8,35.725818,139.678976,2024-02-08 18:17:04
1232,D6-28.東急ステイ新宿,0,7,7,35.690899,139.706348,2024-02-08 18:17:04
1233,T2-85.泉新公園,3,1,4,35.7547,139.601497,2024-02-08 18:17:04
1234,T2-86.石神井町八丁目緑地,2,1,3,35.746956,139.600798,2024-02-08 18:17:04
1235,T2-87.南大泉四丁目児童遊園,1,3,4,35.745607,139.573947,2024-02-08 18:17:04
1236,T2-88.南大泉かたまち緑地,0,4,4,35.739633,139.570457,2024-02-08 18:17:04
1237,T2-89.南大泉三丁目児童遊園,0,3,3,35.742755,139.568335,2024-02-08 18:17:04
1238,E2-05.護国寺駅西自転車駐車場,23,0,23,35.719421,139.725584,2024-02-08 18:17:04
1239,J1-59.第44興和ビル,0,4,4,35.647704,139.693671,2024-02-08 18:17:04
1240,C1-15.東京タワー,10,6,16,35.65928,139.744767,2024-02-08 18:17:04
1241,C5-20.ローソン芝浦二丁目店,2,0,2,35.645254,139.754765,2024-02-08 18:17:04
1242,C2-27.有栖川宮記念公園第一,16,1,17,35.651382,139.724392,2024-02-08 18:17:04
1243,C2-28.有栖川宮記念公園第二,7,1,8,35.651129,139.726003,2024-02-08 18:17:04
1244,C2-29.狸穴公園,5,0,5,35.658204,139.738935,2024-02-08 18:17:04
1245,T2-90.南田中四丁目緑地,2,2,4,35.733195,139.612327,2024-02-08 18:17:04
1246,T2-91.石神井町四丁目緑地,4,1,5,35.745272,139.604579,2024-02-08 18:17:04
1247,A3-41.秋葉原ダイビル,1,6,7,35.698917,139.771856,2024-02-08 18:17:04
1248,J1-54.田道住区センター三田分室,2,2,4,35.638904,139.712518,2024-02-08 18:17:04
1249,H1-140.キャナルパレス住吉,9,6,15,35.689896,139.815116,2024-02-08 18:17:04
1250,C1-57.虎ノ門ツインビルディング,0,37,37,35.667259,139.745643,2024-02-08 18:17:04
1251,K1-54.ファミリーマート大田久が原五丁目店,3,2,5,35.579435,139.698552,2024-02-08 18:17:04
1252,B1-29.ASTILE日本橋浜町,7,1,8,35.685504,139.790817,2024-02-08 18:17:04
1253,N3-20.SYFORME NAKANO-SAKAUE,3,2,5,35.701157,139.679617,2024-02-08 18:17:04
1254,D6-31.東急歌舞伎町タワー駐輪場,3,6,9,35.696207,139.700521,2024-02-08 18:17:04
1255,I1-30.ローソン 大井三丁目店,6,0,6,35.603327,139.729006,2024-02-08 18:17:04
1256,K1-151.PATH仲六郷,9,0,9,35.549465,139.711157,2024-02-08 18:17:04
1257,H1-198.Br Tower 有明 MID CROSS,2,5,7,35.63464,139.783445,2024-02-08 18:17:04
1258,H1-04.石と光の広場（国際展示場駅）,40,23,63,35.63363,139.79082,2024-02-08 18:17:04
1259,B4-24.ミュプレ月島,5,2,7,35.66288,139.78329,2024-02-08 18:17:04
1260,H1-199.ラ・ヴェール東陽町,10,0,10,35.664244,139.814506,2024-02-08 18:17:04
1261,H1-200.ヴェッセル木場南,5,1,6,35.662414,139.813333,2024-02-08 18:17:04
1262,F1-04.台東2丁目21,3,2,5,35.703465,139.780325,2024-02-08 18:17:04
1263,F3-03.ヴェルステージ南千住,1,4,5,35.728704,139.801867,2024-02-08 18:17:04
1264,J1-46.五本木西みどり街かど公園,4,0,4,35.632735,139.683899,2024-02-08 18:17:04
1265,Z24.総合川崎臨港病院,1,4,5,35.525854,139.717848,2024-02-08 18:17:04
1266,K1-131.東急武蔵新田駅駐輪場,11,4,15,35.567146,139.693344,2024-02-08 18:17:04
1267,K1-152.アットホームスクエア前,0,7,7,35.543327,139.703223,2024-02-08 18:17:04
1268,B2-04.清水建設本社（都営地下鉄宝町駅 Ａ８出口）,1,13,14,35.676119,139.772895,2024-02-08 18:17:04
1269,H1-202.辰巳の森海浜公園,8,4,12,35.648107,139.813572,2024-02-08 18:17:04
1270,H1-201.ウエリスアーバン水天宮前2,5,1,6,35.678099,139.791831,2024-02-08 18:17:04
1271,I1-103.五反田ＪＰビルディング,0,3,3,35.622389,139.721552,2024-02-08 18:17:04
1272,L1-16.上祖師谷7丁目,13,1,14,35.65838,139.59231,2024-02-08 18:17:04
1273,O5-09.AppCruise中野,1,1,2,35.700772,139.66063,2024-02-08 18:17:04
1274,H1-203.セブン-イレブン江東木場３丁目店,0,1,1,35.67517,139.804087,2024-02-08 18:17:04
1275,H1-44.テプコ豊洲ビル,25,0,25,35.648726,139.790877,2024-02-08 18:17:04
1276,L1-17.赤堤3丁目,2,5,7,35.659787,139.636696,2024-02-08 18:17:04
1277,L1-18.上北沢1丁目,20,10,30,35.662796,139.626795,2024-02-08 18:17:04
1278,B3-16.明石町区民館,0,18,18,35.666001,139.778102,2024-02-08 18:17:04
1279,I1-104.源氏前ビル,4,1,5,35.603521,139.712345,2024-02-08 18:17:04
1280,J1-28.宮前公園,2,1,3,35.617699,139.664826,2024-02-08 18:17:04
1281,M6-18.セブン-イレブン渋谷本町3丁目店,3,0,3,35.686521,139.685017,2024-02-08 18:17:04
1282,O7-08.杉並区和泉2-3-17,1,3,4,35.67187,139.65474,2024-02-08 18:17:04
1283,T1-17.セブン-イレブン練馬田柄通店,6,1,7,35.75987,139.640474,2024-02-08 18:17:04
1284,H1-18.東京ビッグサイト,8,8,16,35.631192,139.79401,2024-02-08 18:17:04
1285,M3-01.渋谷マークシティ,12,1,13,35.657726,139.697802,2024-02-08 18:17:04
1286,H1-70.有明スポーツセンター,10,7,17,35.63403,139.784319,2024-02-08 18:17:04
1287,H1-41.深川北スポーツセンター,13,0,13,35.676475,139.804741,2024-02-08 18:17:04
1288,H1-55.深川江戸資料館,0,7,7,35.681089,139.800777,2024-02-08 18:17:04
1289,I1-61.五反田文化センター,4,2,6,35.622588,139.716159,2024-02-08 18:17:04
1290,N3-13.中部すこやか福祉センター,5,0,5,35.700052,139.673715,2024-02-08 18:17:04
1291,A4-02.東京サンケイビル,0,17,17,35.686847,139.765151,2024-02-08 18:17:04
1292,M3-09.ティップ.クロス TOKYO 渋谷,10,8,18,35.661475,139.699296,2024-02-08 18:17:04
1293,B3-02.サンクンガーデン,4,2,6,35.670336,139.771911,2024-02-08 18:17:04
1294,T2-10.勤労福祉会館,3,2,5,35.748153,139.58765,2024-02-08 18:17:04
1295,K1-133.東京港野鳥公園,12,0,12,35.584217,139.759232,2024-02-08 18:17:04
1296,K1-21.六郷特別出張所,4,0,4,35.55079,139.716517,2024-02-08 18:17:04
1297,H1-54.砂町文化センター,5,14,19,35.680052,139.831874,2024-02-08 18:17:04
1298,D1-08.新宿歴史博物館,4,0,4,35.689984,139.725261,2024-02-08 18:17:04
1299,E1-05.春日地下自転車駐車場,23,4,27,35.708291,139.753335,2024-02-08 18:17:04
1300,E1-15.播磨坂事業所,5,0,5,35.71724,139.74289,2024-02-08 18:17:04
1301,E5-02.不忍通りふれあい館,9,3,12,35.719356,139.764308,2024-02-08 18:17:04
1302,E4-02.向丘地域活動センター,11,2,13,35.717357,139.757817,2024-02-08 18:17:04
1303,C3-18.明治記念館,3,2,5,35.678509,139.721207,2024-02-08 18:17:04
1304,D5-05.中央図書館,12,3,15,35.705018,139.706841,2024-02-08 18:17:04
1305,E2-07.肥後細川庭園,13,0,13,35.713223,139.721699,2024-02-08 18:17:04
1306,A1-05.富士見出張所,1,2,3,35.699187,139.746348,2024-02-08 18:17:04
1307,E5-07.湯島三丁目児童遊園,5,3,8,35.707296,139.769393,2024-02-08 18:17:04
1308,D5-10.桜美林大学 新宿キャンパス,1,6,7,35.705154,139.697562,2024-02-08 18:17:04
1309,A3-08.神田明神（神田神社）,9,4,13,35.702029,139.768245,2024-02-08 18:17:04
1310,E2-14.永青文庫 ミュージアム,5,0,5,35.713145,139.723342,2024-02-08 18:17:04
1311,M5-17.小田急サザンタワー,5,3,8,35.6866,139.70014,2024-02-08 18:17:04
1312,K1-16.ファミリーマート 矢口二丁目店,6,0,6,35.563092,139.693548,2024-02-08 18:17:04
1313,H1-206.北砂5丁目団地2,0,5,5,35.683866,139.831809,2024-02-08 18:17:04
1314,G1-02.八広駅高架下,4,10,14,35.727495,139.828499,2024-02-08 18:17:04
1315,F4-02.Risingplace浅草四番館,0,4,4,35.717963,139.791025,2024-02-08 18:17:04
1316,H1-204.大島四丁目団地2,8,0,8,35.68832,139.828829,2024-02-08 18:17:04
1317,H1-205.大島四丁目団地3,9,1,10,35.688236,139.827711,2024-02-08 18:17:04
1318,H1-106.亀戸中央公園,15,4,19,35.699874,139.834263,2024-02-08 18:17:04
1319,E5-30.湯島3丁目15,2,8,10,35.705148,139.769314,2024-02-08 18:17:04
1320,B4-38.HARUMI FLAG SUN VILLAGE,0,22,22,35.650347,139.771785,2024-02-08 18:17:04
1321,B4-32.HARUMI FLAG SEA VILLAGE,3,8,11,35.648731,139.774995,2024-02-08 18:17:04
1322,B4-31.HARUMI FLAG PORT VILLAGE,0,18,18,35.650604,139.77724,2024-02-08 18:17:04
1323,B4-33.HARUMI FLAG SEA VILLAGE,0,14,14,35.649552,139.776369,2024-02-08 18:17:04
1324,B4-36.HARUMI FLAG SEA VILLAGE,4,8,12,35.650742,139.778097,2024-02-08 18:17:04
1325,B4-35.HARUMI FLAG SEA VILLAGE,5,7,12,35.650573,139.777908,2024-02-08 18:17:04
1326,B4-37.HARUMI FLAG SUN VILLAGE,0,17,17,35.649419,139.771447,2024-02-08 18:17:04
1327,B4-34.HARUMI FLAG SEA VILLAGE,5,7,12,35.649932,139.776958,2024-02-08 18:17:04
1328,B4-39.HARUMI FLAG SUN VILLAGE,0,15,15,35.650863,139.772549,2024-02-08 18:17:04
1329,B4-40.HARUMI FLAG SUN VILLAGE,0,17,17,35.651305,139.773379,2024-02-08 18:17:04
1330,B4-41.HARUMI FLAG SUN VILLAGE,0,13,13,35.649854,139.77334,2024-02-08 18:17:04
1331,B4-42.HARUMI FLAG SUN VILLAGE,2,9,11,35.649329,139.772656,2024-02-08 18:17:04
1332,B4-28.HARUMI FLAG PORT VILLAGE,0,12,12,35.651183,139.776119,2024-02-08 18:17:04
1333,B4-50.HARUMI FLAG PARK VILLAGE,4,5,9,35.648295,139.773973,2024-02-08 18:17:04
1334,B4-49.HARUMI FLAG PARK VILLAGE,8,8,16,35.648636,139.774251,2024-02-08 18:17:04
1335,B4-48.HARUMI FLAG PARK VILLAGE,0,4,4,35.649513,139.775287,2024-02-08 18:17:04
1336,B4-47.HARUMI FLAG PARK VILLAGE,2,4,6,35.649119,139.775138,2024-02-08 18:17:04
1337,B4-46.HARUMI FLAG PARK VILLAGE,0,25,25,35.649642,139.773859,2024-02-08 18:17:04
1338,B4-45.HARUMI FLAG PARK VILLAGE,0,26,26,35.649002,139.772764,2024-02-08 18:17:04
1339,B4-44.HARUMI FLAG PARK VILLAGE,3,10,13,35.648221,139.772666,2024-02-08 18:17:04
1340,B4-30.HARUMI FLAG PORT VILLAGE,3,8,11,35.651136,139.778218,2024-02-08 18:17:04
1341,B4-29.HARUMI FLAG PORT VILLAGE,6,5,11,35.651907,139.777391,2024-02-08 18:17:04
1342,L1-19.三軒茶屋1丁目駐輪場,1,4,5,35.639302,139.674744,2024-02-08 18:17:04
1343,O7-09.方南月極パーキング,11,6,17,35.678921,139.658289,2024-02-08 18:17:04
1344,O5-10.ローソン ツルハドラッグ杉並和田店,1,3,4,35.68942,139.662118,2024-02-08 18:17:04
1345,O2-04.西荻北1丁目,2,3,5,35.708082,139.607543,2024-02-08 18:17:04
1346,K1-75.三井不動産インダストリアルパーク羽田,0,12,12,35.556231,139.751408,2024-02-08 18:17:04
1347,F1-05.ホウエイコート秋葉原,2,1,3,35.703024,139.78052,2024-02-08 18:17:04
1348,C3-36.第35興和ビル,0,3,3,35.666349,139.741781,2024-02-08 18:17:04
1349,B4-53.晴海五丁目ターミナル,27,79,106,35.651627,139.773103,2024-02-08 18:17:04
1350,C5-44.ブランズタワー芝浦,9,0,9,35.643105,139.753039,2024-02-08 18:17:04
1351,A3-47.ホテルヴィラフォンテーヌ東京大手町,10,3,13,35.690602,139.766916,2024-02-08 18:17:04
1352,A1-20.菱和パレス九段,4,0,4,35.693021,139.740317,2024-02-08 18:17:04
0,E5-26.本郷4丁目,0,5,5,35.708596,139.758269,2024-02-08 15:15:03
1,A3-42.内神田3丁目,35,0,35,35.692599,139.770109,2024-02-08 15:15:03
2,T2-76.東中前の森緑地,3,2,5,35.748736,139.574839,2024-02-08 15:15:03
3,A2-20.神田スクエア,17,0,17,35.693408,139.762809,2024-02-08 15:15:03
4,K1-79.Tマークシティホテル東京大森,4,2,6,35.586993,139.736491,2024-02-08 15:15:03
5,K1-80.大森北6丁目,3,0,3,35.579849,139.731241,2024-02-08 15:15:03
6,H1-130.トヨタモビリティ東京 深川店,7,1,8,35.676643,139.816054,2024-02-08 15:15:03
7,H1-131.セブン-イレブン 江東佐賀2丁目店,0,12,12,35.679029,139.793535,2024-02-08 15:15:03
8,H1-132.セブン-イレブン 江東三好4丁目店,0,24,24,35.681418,139.809287,2024-02-08 15:15:03
9,A6-22.半蔵門PREX South,14,1,15,35.683433,139.740756,2024-02-08 15:15:03
10,I1-74.セブン-イレブン西五反田6丁目店,5,0,5,35.622403,139.71771,2024-02-08 15:15:03
11,G2-01.東京ソラマチ,6,1,7,35.709777,139.810189,2024-02-08 15:15:03
12,T2-59.平成公園,2,1,3,35.722917,139.587864,2024-02-08 15:15:03
13,I1-26.大崎西口公園,0,10,10,35.617475,139.729221,2024-02-08 15:15:03
14,I1-96.西五反田２丁目,9,0,9,35.627599,139.720463,2024-02-08 15:15:03
15,H1-172.サンヨーパシフィックマンション,0,9,9,35.668856,139.794069,2024-02-08 15:15:03
16,J1-56.青葉台四丁目街かど公園,3,0,3,35.654009,139.692727,2024-02-08 15:15:03
17,H1-173.森下駅前,11,28,39,35.687837,139.79654,2024-02-08 15:15:03
18,E3-01.大塚地域活動センター跡地,5,3,8,35.718656,139.734556,2024-02-08 15:15:03
19,E2-03.目白台運動公園,29,12,41,35.715556,139.721988,2024-02-08 15:15:03
20,T2-77.大泉なかよし緑地,3,1,4,35.759861,139.581682,2024-02-08 15:15:03
21,E2-01.江戸川橋Ｂ自転車駐車場,42,39,81,35.710381,139.732137,2024-02-08 15:15:03
22,E2-02.江戸川公園,9,10,19,35.710958,139.731165,2024-02-08 15:15:03
23,D7-14.大栄パーク西落合１丁目,4,2,6,35.720028,139.678936,2024-02-08 15:15:03
24,E1-07.礫川地域活動センター,4,2,6,35.712015,139.750284,2024-02-08 15:15:03
25,M6-05.七号通り公園,0,13,13,35.67917,139.67493,2024-02-08 15:15:03
26,H1-138.HW.HILLS新大橋,3,8,11,35.687416,139.795588,2024-02-08 15:15:03
27,B4-21.月島駅前第一駐輪場,19,13,32,35.663681,139.785651,2024-02-08 15:15:03
28,N2-03.野方1丁目,6,0,6,35.712179,139.65603,2024-02-08 15:15:03
29,C5-52.港南四丁目第3アパート駐車場,10,0,10,35.630109,139.747094,2024-02-08 15:15:03
30,E5-27.真正館駐車場,0,4,4,35.714875,139.76394,2024-02-08 15:15:03
31,C5-35.品川駅港南口,6,0,6,35.62822,139.741135,2024-02-08 15:15:03
32,N2-01.NTT野方ビル,3,2,5,35.710285,139.66173,2024-02-08 15:15:03
33,D6-27.新宿三井ビルディング二号館,7,1,8,35.686334,139.692881,2024-02-08 15:15:03
34,D1-10.曙橋駐輪場,2,14,16,35.691888,139.724365,2024-02-08 15:15:03
35,I1-39.MID POINT 目黒不動前,3,1,4,35.628116,139.713149,2024-02-08 15:15:03
36,E3-07.小日向1丁目,0,11,11,35.713388,139.737009,2024-02-08 15:15:03
37,C1-47.パークプレイス三田,8,1,9,35.641791,139.740734,2024-02-08 15:15:03
38,I1-38.ローソン 八潮三丁目店,17,27,44,35.594544,139.760423,2024-02-08 15:15:03
39,C2-24.Dash Living HigashiAzabu,6,0,6,35.655135,139.744449,2024-02-08 15:15:03
40,J1-04.菅刈公園,7,0,7,35.650351,139.692853,2024-02-08 15:15:03
41,O4-09.ローソン杉並本天沼一丁目店,0,3,3,35.712496,139.632778,2024-02-08 15:15:03
42,T3-29.平和台もものき緑地,1,2,3,35.755773,139.661913,2024-02-08 15:15:03
43,D2-10.市谷砂土原町3丁目,4,6,10,35.696242,139.735776,2024-02-08 15:15:03
44,C1-48.竹芝客船ターミナル,9,6,15,35.655139,139.762812,2024-02-08 15:15:03
45,B1-06.伊場仙ビル,3,2,5,35.687624,139.777125,2024-02-08 15:15:03
46,B2-01.鉄砲洲児童公園（西側）,0,16,16,35.67224,139.779348,2024-02-08 15:15:03
47,B1-04.産業会館,2,1,3,35.694164,139.787057,2024-02-08 15:15:03
48,B1-05.日本橋保健センター,0,10,10,35.687419,139.779053,2024-02-08 15:15:03
49,B2-05.ＮＴＴ東日本築地ビル,0,4,4,35.670674,139.775993,2024-02-08 15:15:03
50,B2-02.柳通り（東京スクエアガーデン前）,11,1,12,35.676393,139.768319,2024-02-08 15:15:03
51,B2-03.男女平等センター（ブーケ21）,7,1,8,35.673923,139.778671,2024-02-08 15:15:03
52,C2-13.麻布運動場,7,1,8,35.651718,139.728165,2024-02-08 15:15:03
53,D2-08.旧市ヶ谷商業高校,0,16,16,35.70074,139.731363,2024-02-08 15:15:03
54,C1-35.セブン-イレブン 三田駅北店,2,1,3,35.649032,139.750147,2024-02-08 15:15:03
55,B4-12.THE TOKYO TOWERS,0,92,92,35.655497,139.774556,2024-02-08 15:15:03
56,C5-21.セブン-イレブン 芝浦3丁目店,2,1,3,35.642399,139.746992,2024-02-08 15:15:03
57,H1-67.セブン-イレブン 江東亀戸9丁目店,6,8,14,35.69766,139.843408,2024-02-08 15:15:03
58,C2-15.住友不動産六本木グランドタワー,0,13,13,35.664367,139.737185,2024-02-08 15:15:03
59,C2-14.元麻布ヒルズ,1,9,10,35.653608,139.73138,2024-02-08 15:15:03
60,M6-14.ドコモショップ笹塚店,0,6,6,35.67323,139.66393,2024-02-08 15:15:03
61,N4-07.南台2丁目,2,10,12,35.68509,139.671102,2024-02-08 15:15:03
62,K1-68.ART FACTORY 城南島,2,6,8,35.580511,139.775957,2024-02-08 15:15:03
63,H1-178.北砂7丁目団地(第二),0,4,4,35.678031,139.837193,2024-02-08 15:15:03
64,H1-179.北砂7丁目団地(第三),0,11,11,35.678246,139.8366,2024-02-08 15:15:03
65,A1-17.雉子橋集積所,6,0,6,35.692605,139.755761,2024-02-08 15:15:03
66,H1-177.北砂7丁目団地(第一),0,11,11,35.678537,139.837391,2024-02-08 15:15:03
67,K1-95.城南島海浜公園,10,6,16,35.578259,139.783505,2024-02-08 15:15:03
68,B3-17.銀座6丁目-SQUARE,7,0,7,35.66711,139.76643,2024-02-08 15:15:03
69,J1-33.芳窪街かど公園,13,0,13,35.629861,139.666293,2024-02-08 15:15:03
70,N3-07.なかのZERO,2,3,5,35.70442,139.67141,2024-02-08 15:15:03
71,N4-04.弥生町5丁目,4,8,12,35.690897,139.668345,2024-02-08 15:15:03
72,A3-44.THE WAVES AKIHABARA,2,2,4,35.694679,139.779504,2024-02-08 15:15:03
73,K1-138.羽田エアポートガーデン,4,5,9,35.544534,139.763244,2024-02-08 15:15:03
74,C3-26.ホテルリブマックス赤坂,2,3,5,35.67011,139.733375,2024-02-08 15:15:03
75,C1-52.NTT三田ビル,5,1,6,35.652549,139.747789,2024-02-08 15:15:03
76,D1-07.Dash Living Shinjuku,4,0,4,35.689757,139.710091,2024-02-08 15:15:03
77,O4-07.ローソン成田西三丁目店,0,5,5,35.690311,139.62178,2024-02-08 15:15:03
78,H1-152.コンポジット亀戸ウエスト,0,8,8,35.699187,139.82429,2024-02-08 15:15:03
79,E1-13.エルアージュ小石川,0,25,25,35.71399,139.75137,2024-02-08 15:15:03
80,B4-22.リビオレゾン勝どきNEX,0,45,45,35.65554,139.77102,2024-02-08 15:15:03
81,H1-176.JMFビル東陽町02,1,5,6,35.667677,139.823552,2024-02-08 15:15:03
82,H1-102.ファミリーマート東砂七丁目店,0,9,9,35.672714,139.837914,2024-02-08 15:15:03
83,H1-101.ファミリーマート新木場一丁目店,0,8,8,35.642571,139.836766,2024-02-08 15:15:03
84,K1-67.京浜島防災広場,0,25,25,35.570508,139.764013,2024-02-08 15:15:03
85,K1-66.昭和島二丁目公園,0,13,13,35.575097,139.751446,2024-02-08 15:15:03
86,I1-80.リバーサイド品川港南ビル,7,1,8,35.622714,139.74471,2024-02-08 15:15:03
87,J1-10.NTTデータ駒場研修センター,6,5,11,35.655779,139.680948,2024-02-08 15:15:03
88,A2-17.竹橋ビル,8,0,8,35.692396,139.75639,2024-02-08 15:15:03
89,H1-91.亀戸駅北口第三自転車駐車場,12,5,17,35.696913,139.823911,2024-02-08 15:15:03
90,H1-92.亀戸駅東口第二自転車駐車場,7,8,15,35.69788,139.830559,2024-02-08 15:15:03
91,K1-59.京急梅屋敷第1駐車場,5,2,7,35.565768,139.727396,2024-02-08 15:15:03
92,K1-60.京急平和島第1駐車場,9,0,9,35.576336,139.733691,2024-02-08 15:15:03
93,I1-42.京急青横駐車場,2,0,2,35.611582,139.742528,2024-02-08 15:15:03
94,I1-43.京急南大井駐車場,4,4,8,35.594722,139.737101,2024-02-08 15:15:03
95,O7-05.ジーベック方南町,1,0,1,35.680849,139.65626,2024-02-08 15:15:03
96,H1-100.URアーバンライフ亀戸,21,7,28,35.697935,139.821855,2024-02-08 15:15:03
97,A6-10.紀尾井町ビル（西側）,10,2,12,35.682516,139.736494,2024-02-08 15:15:03
98,C3-02.赤坂地区総合支所,0,7,7,35.674788,139.731423,2024-02-08 15:15:03
99,C2-08.ファミリーマート西麻布霞町店,0,4,4,35.661673,139.721118,2024-02-08 15:15:03
100,A6-09.紀尾井町ビル（北側）,6,0,6,35.682902,139.736494,2024-02-08 15:15:03
101,H1-28.有明客船ターミナル,8,3,11,35.630063,139.792209,2024-02-08 15:15:03
102,B1-12.ファミリーマート堀留町二丁目店,0,8,8,35.687786,139.78205,2024-02-08 15:15:03
103,H1-26.青海客船ターミナル,11,4,15,35.619234,139.774485,2024-02-08 15:15:03
104,H1-27.パレットタウン乗船場,10,0,10,35.624467,139.781305,2024-02-08 15:15:03
105,O1-04.井草1-34,6,9,15,35.72758,139.62432,2024-02-08 15:15:03
106,C1-76.浜松町駅北口交通広場(ハマサイト前),14,2,16,35.656647,139.758301,2024-02-08 15:15:03
107,J1-52.駒沢一丁目公園前,7,2,9,35.629807,139.662398,2024-02-08 15:15:03
108,C1-75.虎ノ門PFビル,6,1,7,35.665466,139.748014,2024-02-08 15:15:03
109,B2-18.旭ビルディング,10,1,11,35.678291,139.78157,2024-02-08 15:15:03
110,N2-09.松山駐車場No.1,2,4,6,35.722991,139.673048,2024-02-08 15:15:03
111,I1-82.トミンハイム西五反田四丁目,2,4,6,35.627386,139.711182,2024-02-08 15:15:03
112,O4-03.ザ・ハウス,0,12,12,35.707035,139.633066,2024-02-08 15:15:03
113,O4-04.阿佐谷南3-43,15,1,16,35.704147,139.631955,2024-02-08 15:15:03
114,K1-83.北千束北児童公園,6,0,6,35.611085,139.68599,2024-02-08 15:15:03
115,I1-95.東京レールゲート EAST,3,7,10,35.584998,139.761055,2024-02-08 15:15:03
116,M5-19.グランリヴィエール代々木,3,2,5,35.68285,139.698528,2024-02-08 15:15:03
117,H1-192.ウエリスアーバン水天宮前,3,1,4,35.678296,139.791949,2024-02-08 15:15:03
118,N2-08.江古田区民活動センター,1,3,4,35.728893,139.670119,2024-02-08 15:15:03
119,D7-04.セブン-イレブン 新宿下落合3丁目店,2,1,3,35.722645,139.701982,2024-02-08 15:15:03
120,K1-82.西蒲田公園,6,1,7,35.561499,139.71123,2024-02-08 15:15:03
121,H1-68.芝浦工業大学附属中学高等学校,0,11,11,35.649274,139.792213,2024-02-08 15:15:03
122,K1-24.東糀谷防災公園,0,21,21,35.557074,139.74575,2024-02-08 15:15:03
123,H1-03.東雲駅,5,10,15,35.640736,139.804331,2024-02-08 15:15:03
124,K1-26.大森諏訪公園,0,11,11,35.574785,139.730762,2024-02-08 15:15:03
125,K1-25.鶴渡公園,2,1,3,35.56892,139.725082,2024-02-08 15:15:03
126,N3-10.エーエスホームズⅡ駐車場,5,1,6,35.702659,139.662563,2024-02-08 15:15:03
127,J1-37.中目黒公園,11,7,18,35.640398,139.704069,2024-02-08 15:15:03
128,A1-10.ヒューリック九段ビル,6,0,6,35.696449,139.750784,2024-02-08 15:15:03
129,K1-93.六間堀仲羽公園,3,1,4,35.548864,139.74484,2024-02-08 15:15:03
130,T2-53.上練馬公園,2,2,4,35.772863,139.626969,2024-02-08 15:15:03
131,M5-01.初台駅南口,0,13,13,35.680154,139.685937,2024-02-08 15:15:03
132,C1-60.専売ビル,11,1,12,35.647659,139.745055,2024-02-08 15:15:03
133,K1-85.大田区青少年交流センター ゆいっつ,1,3,4,35.583555,139.743381,2024-02-08 15:15:03
134,I1-64.株式会社ユアス ゆうパック取扱所：ポストのうしろ,7,2,9,35.622965,139.731014,2024-02-08 15:15:03
135,C4-09.ケーヨーデイツー三田店,2,4,6,35.646375,139.740061,2024-02-08 15:15:03
136,C1-61.環三浜松町駅南,24,14,38,35.653096,139.75739,2024-02-08 15:15:03
137,K1-84.佐伯山緑地,1,12,13,35.581698,139.71491,2024-02-08 15:15:03
138,C1-59.セレスティン芝三井ビルディング,6,6,12,35.650845,139.748346,2024-02-08 15:15:03
139,G2-07.レオーネ押上cube,3,1,4,35.706167,139.815955,2024-02-08 15:15:03
140,E1-06.文京シビックセンター,9,11,20,35.708265,139.751983,2024-02-08 15:15:03
141,D2-13.THE CENTER TOKYO,0,13,13,35.695646,139.725722,2024-02-08 15:15:03
142,E5-22.千駄木2丁目,0,6,6,35.724828,139.762583,2024-02-08 15:15:03
143,C4-07.品川プリンスホテル,8,1,9,35.628266,139.734171,2024-02-08 15:15:03
144,A3-43.unito CHIYODA,0,4,4,35.69474,139.77929,2024-02-08 15:15:03
145,C4-06.白金プラチナレジデンス,0,20,20,35.644134,139.723432,2024-02-08 15:15:03
146,I1-63.セブン-イレブン西五反田店,3,0,3,35.62765,139.719212,2024-02-08 15:15:03
147,H1-53.豊洲シビックセンター,1,17,18,35.653991,139.795513,2024-02-08 15:15:03
148,T3-16.練馬区役所東庁舎(第一),10,0,10,35.735428,139.652379,2024-02-08 15:15:03
149,T2-68.さくら原っぱ緑地,2,3,5,35.731372,139.619164,2024-02-08 15:15:03
150,T2-69.久保新田さくら公園,1,3,4,35.76525,139.575978,2024-02-08 15:15:03
151,H1-187.森下文化センター,1,4,5,35.685344,139.80234,2024-02-08 15:15:03
152,E4-04.セブン-イレブン 文京本駒込１丁目店,3,2,5,35.724707,139.750469,2024-02-08 15:15:03
153,M2-13.恵比寿プライムスクエアタワー南,8,0,8,35.649257,139.713272,2024-02-08 15:15:03
154,H1-48.セブン-イレブン 江東潮見２丁目店,0,10,10,35.658249,139.815775,2024-02-08 15:15:03
155,H1-51.豊洲交通広場　東,17,9,26,35.654958,139.795718,2024-02-08 15:15:03
156,H1-52.辰巳駅,0,30,30,35.646756,139.809295,2024-02-08 15:15:03
157,D7-01.下落合図書館,6,9,15,35.715894,139.698578,2024-02-08 15:15:03
158,H1-50.豊洲交通広場　北,0,10,10,35.655457,139.795161,2024-02-08 15:15:03
159,A6-14.MG市ヶ谷ビルディング,0,4,4,35.690861,139.736393,2024-02-08 15:15:03
160,T2-21.ファミリーマート 練馬大泉町一丁目店,2,2,4,35.768448,139.601679,2024-02-08 15:15:03
161,A6-15.東急番町ビル,3,2,5,35.688929,139.7358,2024-02-08 15:15:03
162,A1-18.東京区政会館別館(特別区研修所),2,0,2,35.696202,139.752351,2024-02-08 15:15:03
163,T3-18.練馬駅北,10,9,19,35.738585,139.653396,2024-02-08 15:15:03
164,C1-43.KDX浜松町プレイス,2,4,6,35.658169,139.752509,2024-02-08 15:15:03
165,C5-27.プレミア海岸ビル,12,7,19,35.648948,139.757895,2024-02-08 15:15:03
166,I1-29.ローソン 勝島一丁目店,0,17,17,35.599987,139.745195,2024-02-08 15:15:03
167,H1-72.ネクストサイト深川ビル,18,2,20,35.674578,139.797396,2024-02-08 15:15:03
168,T1-11.むつみ台,1,1,2,35.768528,139.639807,2024-02-08 15:15:03
169,T1-10.月見大橋下,2,3,5,35.758366,139.628982,2024-02-08 15:15:03
170,H1-167.大島八丁目公園,4,6,10,35.688074,139.838932,2024-02-08 15:15:03
171,K1-36.セブン-イレブン 大田区南雪谷5丁目店,0,8,8,35.587815,139.691748,2024-02-08 15:15:03
172,L1-01.羽根木公園,6,6,12,35.66088,139.654546,2024-02-08 15:15:03
173,P1-02.雑司ヶ谷一丁目,8,0,8,35.721738,139.723103,2024-02-08 15:15:03
174,I1-66.南大井文化センター駐車場,1,5,6,35.596733,139.73804,2024-02-08 15:15:03
175,L1-05.NTT烏山ビル,0,4,4,35.669285,139.597931,2024-02-08 15:15:03
176,L1-04.下馬中央公園,1,3,4,35.63367,139.678139,2024-02-08 15:15:03
177,L1-03.世田谷城阯公園,0,6,6,35.645838,139.647799,2024-02-08 15:15:03
178,L1-02.若林公園,5,2,7,35.647075,139.654472,2024-02-08 15:15:03
179,T2-30.ファミリーマート 練馬東大泉四丁目店,3,1,4,35.750804,139.58243,2024-02-08 15:15:03
180,L1-07.NTT成城ビル,2,1,3,35.648021,139.606529,2024-02-08 15:15:03
181,L1-06.NTT瀬田ビル,0,12,12,35.618357,139.626191,2024-02-08 15:15:03
182,T3-12.春日町西公園,3,1,4,35.748092,139.636587,2024-02-08 15:15:03
183,T3-13.平和台児童公園,2,2,4,35.757298,139.664139,2024-02-08 15:15:03
184,T2-38.ファミリーマート 練馬上石神井四丁目店,6,3,9,35.727195,139.590179,2024-02-08 15:15:03
185,B1-28.アイルイムーブル日本橋,9,0,9,35.684502,139.77906,2024-02-08 15:15:03
186,A2-28.NTTコミュニケーションズ一ツ橋ビル駐車場,8,0,8,35.6915,139.75685,2024-02-08 15:15:03
187,C3-32.乃木公園,4,1,5,35.667936,139.72745,2024-02-08 15:15:03
188,T3-14.わらべ児童遊園,3,1,4,35.759774,139.654529,2024-02-08 15:15:03
189,T2-52.田柄中央児童公園,3,2,5,35.762395,139.641522,2024-02-08 15:15:03
190,M4-06.THE SHARE 原宿,8,0,8,35.671823,139.708158,2024-02-08 15:15:03
191,K1-10.セブン‐イレブン 大田区西糀谷１丁目店,4,0,4,35.559647,139.730098,2024-02-08 15:15:03
192,K1-09.セブン‐イレブン 大田区西蒲田２丁目店,0,16,16,35.570763,139.705895,2024-02-08 15:15:03
193,H1-63.東京スイソミル,0,8,8,35.65637,139.811765,2024-02-08 15:15:03
194,B1-16.小網町児童遊園,3,3,6,35.683695,139.780043,2024-02-08 15:15:03
195,H1-61.Brilliaランニングスタジアムマギーズ東京前,0,9,9,35.648281,139.786112,2024-02-08 15:15:03
196,K1-08.セブン‐イレブン 大田区東蒲田キネマ通り店,4,0,4,35.562368,139.730143,2024-02-08 15:15:03
197,C1-34.城山ガーデン,7,1,8,35.664479,139.743731,2024-02-08 15:15:03
198,H1-62.扇橋一丁目公園南,0,37,37,35.683343,139.812161,2024-02-08 15:15:03
199,J1-23.清水池公園,8,14,22,35.623756,139.692517,2024-02-08 15:15:03
200,C5-18.パークタワー品川ベイワード,14,1,15,35.634529,139.748378,2024-02-08 15:15:03
201,E4-07.ファミリーマート 本駒込二丁目店,3,1,4,35.727279,139.74627,2024-02-08 15:15:03
202,C5-45.パークアクシス芝浦キャナル,5,0,5,35.644794,139.755688,2024-02-08 15:15:03
203,A2-02.西神田公園（北側）,7,1,8,35.698591,139.755113,2024-02-08 15:15:03
204,T2-49.善福寺公園テニスクラブ,5,4,9,35.719674,139.593696,2024-02-08 15:15:03
205,H1-193.ライフ豊洲店,26,0,26,35.651833,139.79962,2024-02-08 15:15:03
206,A2-01.神田駿河台下,53,0,53,35.695762,139.761585,2024-02-08 15:15:03
207,I1-51.京急鈴ヶ森駐車場,0,13,13,35.589573,139.735585,2024-02-08 15:15:03
208,T2-36.サントピア テニスパーク,5,5,10,35.75195,139.616028,2024-02-08 15:15:03
209,G4-13. Parking in 両国駅前第2,0,3,3,35.696492,139.791591,2024-02-08 15:15:03
210,K1-120.蒲田駅消費者生活センター横自転車駐車場 屋上部,6,0,6,35.560125,139.71569,2024-02-08 15:15:03
211,N3-18.藤和シティコープ新中野3,5,1,6,35.69942,139.673964,2024-02-08 15:15:03
212,K1-145.トヨタモビリティ東京馬込テクニカル研修センター,7,6,13,35.58209,139.701362,2024-02-08 15:15:03
213,K1-100.多摩川台公園,5,0,5,35.589794,139.666955,2024-02-08 15:15:03
214,C1-54.ニッセイ虎ノ門ビル,11,1,12,35.664344,139.746662,2024-02-08 15:15:03
215,I1-52.カスタリアタワー品川シーサイド,9,0,9,35.607557,139.746866,2024-02-08 15:15:03
216,I1-53.天王洲公園,1,3,4,35.620355,139.749339,2024-02-08 15:15:03
217,C2-18.ブランシェ東麻布,0,3,3,35.656769,139.743224,2024-02-08 15:15:03
218,A3-45.鍛冶町2丁目,13,3,16,35.691578,139.77138,2024-02-08 15:15:03
219,H1-87.パークアクシス木場キャナルウエスト,0,10,10,35.662514,139.803694,2024-02-08 15:15:03
220,D6-20.淀橋けやき橋公園,8,7,15,35.693544,139.685806,2024-02-08 15:15:03
221,A3-46.神田須田町2丁目,0,0,0,35.695457,139.772972,2024-02-08 15:15:03
222,B3-13.国立がん研究センター,11,0,11,35.664871,139.767188,2024-02-08 15:15:03
223,I1-35.シーフォートスクエア,16,1,17,35.622954,139.750593,2024-02-08 15:15:03
224,K1-55.カバヤビル,8,8,16,35.576275,139.713704,2024-02-08 15:15:03
225,C3-24.SHARE GREEN 南青山 西エントランス,0,7,7,35.668419,139.724676,2024-02-08 15:15:03
226,A5-06.APA HOTEL PRIDE〈国会議事堂前〉,10,0,10,35.674468,139.741328,2024-02-08 15:15:03
227,A6-17.東京ガーデンテラス紀尾井町（プリンス通り側）,12,0,12,35.680431,139.738203,2024-02-08 15:15:03
228,B4-07.勝どき駅地下駐輪場,58,2,60,35.658135,139.776131,2024-02-08 15:15:03
229,B4-08.東京ミッドベイ勝どき（西仲通り）,7,4,11,35.656449,139.771302,2024-02-08 15:15:03
230,B3-04.築地市場駅地下駐輪場,17,0,17,35.664265,139.767426,2024-02-08 15:15:03
231,C5-10.シーバンス,11,3,14,35.649959,139.756068,2024-02-08 15:15:03
232,H1-34.門前仲町駅,48,2,50,35.67391,139.796165,2024-02-08 15:15:03
233,C3-10.ファミリーマート特許庁前店,0,8,8,35.670364,139.744684,2024-02-08 15:15:03
234,A1-01.千代田区役所,6,0,6,35.693799,139.753281,2024-02-08 15:15:03
235,A1-03.東京区政会館（メトロA5出口）,7,0,7,35.701073,139.747525,2024-02-08 15:15:03
236,B3-06.朝日新聞東京本社,1,3,4,35.664457,139.767214,2024-02-08 15:15:03
237,A1-04.東京区政会館（西側駐輪場）,6,1,7,35.701347,139.746951,2024-02-08 15:15:03
238,T1-03.四季の香公園,4,0,4,35.760585,139.626284,2024-02-08 15:15:03
239,T1-04.春の風公園,3,0,3,35.75731,139.624922,2024-02-08 15:15:03
240,T1-05.夏の雲公園,5,0,5,35.753964,139.629116,2024-02-08 15:15:03
241,H1-194.セブン-イレブン江東北砂5丁目店,0,5,5,35.68268,139.8353,2024-02-08 15:15:03
242,O5-03.新高円寺地下自転車駐輪場,4,9,13,35.697265,139.649397,2024-02-08 15:15:03
243,O3-06.アミーズ荻窪,3,1,4,35.714616,139.625116,2024-02-08 15:15:03
244,T2-03.リヴィンオズ大泉店,7,1,8,35.752383,139.594855,2024-02-08 15:15:03
245,O6-06.上高井戸1丁目,0,7,7,35.673055,139.611293,2024-02-08 15:15:03
246,T2-05.石神井図書館,3,1,4,35.736076,139.599676,2024-02-08 15:15:03
247,T2-06.総合体育館,3,0,3,35.748957,139.621385,2024-02-08 15:15:03
248,O5-02.馬橋ハイツ,4,2,6,35.705686,139.642587,2024-02-08 15:15:03
249,N1-07.プランドール上鷺宮,1,6,7,35.733292,139.630369,2024-02-08 15:15:03
250,E1-18.アーバネックス小石川春日,3,1,4,35.709261,139.746374,2024-02-08 15:15:03
251,T3-03.新桜台駅自転車駐車場,5,2,7,35.740378,139.667502,2024-02-08 15:15:03
252,O3-05.Nちゃりパーク,15,7,22,35.70389,139.6185,2024-02-08 15:15:03
253,O5-01.朝霞ハイツ,7,3,10,35.71038,139.64519,2024-02-08 15:15:03
254,L1-11.アイムタウン上祖師谷,2,1,3,35.656849,139.594422,2024-02-08 15:15:03
255,L1-12.鈴木リースホーム駐車場,11,3,14,35.646648,139.633038,2024-02-08 15:15:03
256,L1-13.わびさびホステル,2,2,4,35.647393,139.667085,2024-02-08 15:15:03
257,G2-05.リアナスカイパーク押上,5,1,6,35.715733,139.815451,2024-02-08 15:15:03
258,T3-02.早宮第二自転車駐車場,7,4,11,35.756846,139.652154,2024-02-08 15:15:03
259,I1-37.ガーデンシティ品川御殿山,5,4,9,35.623466,139.734359,2024-02-08 15:15:03
260,T2-47.上石神井駅北第二自転車駐車場,6,4,10,35.726523,139.5905,2024-02-08 15:15:03
261,C1-51.環二新橋四丁目,10,2,12,35.663843,139.757697,2024-02-08 15:15:03
262,M6-07.笹塚東,15,6,21,35.675436,139.670594,2024-02-08 15:15:03
263,M3-10.ウノサワ東急ビル,8,0,8,35.647757,139.712981,2024-02-08 15:15:03
264,C2-26.一の橋公園,5,2,7,35.655367,139.738075,2024-02-08 15:15:03
265,H1-14.ホテルリブマックス東京潮見駅前,4,2,6,35.658351,139.818229,2024-02-08 15:15:03
266,D2-12.ヴィアイン飯田橋後楽園,0,15,15,35.705774,139.743366,2024-02-08 15:15:03
267,D3-08.ホテルリブマックス高田馬場駅前,7,1,8,35.712952,139.701356,2024-02-08 15:15:03
268,H1-103.清澄庭園,6,2,8,35.680948,139.796917,2024-02-08 15:15:03
269,H1-104.木場公園,3,10,13,35.676488,139.809616,2024-02-08 15:15:03
270,H1-105.猿江恩賜公園,8,0,8,35.692277,139.817491,2024-02-08 15:15:03
271,G4-07.ディアレイシャス両国,2,1,3,35.69955,139.803204,2024-02-08 15:15:03
272,T2-46.大泉郵便局バス停自転車駐車場,0,9,9,35.766491,139.587232,2024-02-08 15:15:03
273,I1-18.東品川公園,6,0,6,35.61379,139.746617,2024-02-08 15:15:03
274,J1-03.西郷山公園,5,1,6,35.650688,139.696696,2024-02-08 15:15:03
275,J1-02.駒場野公園,10,4,14,35.657718,139.681043,2024-02-08 15:15:03
276,D2-14.ローソン 神楽坂駅北店,0,13,13,35.704201,139.735815,2024-02-08 15:15:03
277,K1-65.下丸子3丁目,6,6,12,35.571711,139.685337,2024-02-08 15:15:03
278,T2-43.学園通り自転車駐車場,8,0,8,35.7547,139.5871,2024-02-08 15:15:03
279,I1-46.セブン-イレブン 品川東中延2丁目店,0,4,4,35.608721,139.714158,2024-02-08 15:15:03
280,T2-04.石神井公園駅南口,8,4,12,35.743354,139.606592,2024-02-08 15:15:03
281,J1-06.観音橋自転車置場,17,27,44,35.642251,139.69692,2024-02-08 15:15:03
282,J1-05.東山公園　北,0,11,11,35.64853,139.686309,2024-02-08 15:15:03
283,J1-45.プラウド中目黒,0,1,1,35.63767,139.7045,2024-02-08 15:15:03
284,H1-168.大島五丁目公園,11,2,13,35.68642,139.836151,2024-02-08 15:15:03
285,J1-47.本町みなみ街かど公園,5,11,16,35.61847,139.70019,2024-02-08 15:15:03
286,J1-48.グランドエクセル祐天寺,0,16,16,35.64372,139.68777,2024-02-08 15:15:03
287,K1-101.小池公園,1,3,4,35.599541,139.697962,2024-02-08 15:15:03
288,H1-171.LOGI’Q南砂町,7,0,7,35.672877,139.842339,2024-02-08 15:15:03
289,H1-153.三井リンクラボ新木場1,4,6,10,35.63851,139.823534,2024-02-08 15:15:03
290,H1-154.やぐら橋下,18,2,20,35.631132,139.792726,2024-02-08 15:15:03
291,D5-11.NTTコミュニケーションズ新宿ビル,2,7,9,35.699312,139.696468,2024-02-08 15:15:03
292,C5-31.ヒルトン東京お台場,3,7,10,35.626267,139.771438,2024-02-08 15:15:03
293,K1-78.城南鋳物団地協同組合,0,10,10,35.567562,139.766854,2024-02-08 15:15:03
294,I1-68.八潮公園第二,0,6,6,35.600003,139.754288,2024-02-08 15:15:03
295,I1-67.八潮公園第一,0,10,10,35.601149,139.754284,2024-02-08 15:15:03
296,H1-123.ダイワロイネットホテル東京有明,16,1,17,35.634316,139.793199,2024-02-08 15:15:03
297,J1-24.ボヌールREIWA,4,1,5,35.612389,139.676238,2024-02-08 15:15:03
298,B2-12.東京ダイヤビルディング（東側）,14,3,17,35.674835,139.785656,2024-02-08 15:15:03
299,J1-15.二の橋自転車置場2,14,2,16,35.614391,139.678396,2024-02-08 15:15:03
300,H1-77.ライフ東砂店,0,10,10,35.684641,139.844243,2024-02-08 15:15:03
301,D1-09.NTT四谷ビル,1,2,3,35.691188,139.712079,2024-02-08 15:15:03
302,E4-11.プライマル千石,0,13,13,35.727519,139.742815,2024-02-08 15:15:03
303,I1-23.東海橋防災船着場,1,3,4,35.616114,139.74033,2024-02-08 15:15:03
304,A4-12.東京ミッドタウン日比谷,0,5,5,35.674274,139.759111,2024-02-08 15:15:03
305,K1-46.池上駅前自転車駐車場,6,5,11,35.571478,139.702779,2024-02-08 15:15:03
306,I1-24.しながわ区民公園(中央口),2,12,14,35.593611,139.738056,2024-02-08 15:15:03
307,T2-13.セブン-イレブン 練馬石神井町8丁目店,0,5,5,35.750414,139.600011,2024-02-08 15:15:03
308,O3-04.アヴァンセ阿佐ヶ谷,1,1,2,35.712,139.62816,2024-02-08 15:15:03
309,B4-01.黎明橋公園（駐輪場）,1,10,11,35.656071,139.780068,2024-02-08 15:15:03
310,T2-32.セブン-イレブン 練馬東大泉NTTビル店,4,4,8,35.750761,139.594457,2024-02-08 15:15:03
311,K1-142.コーラル洗足池,9,1,10,35.604567,139.689096,2024-02-08 15:15:03
312,K1-28.鵜の木特別出張所,4,0,4,35.574886,139.685122,2024-02-08 15:15:03
313,T1-02.ホテルカデンツァ東京,12,0,12,35.755106,139.621675,2024-02-08 15:15:03
314,C2-16.ザ・ベルグレイヴィア麻布,0,6,6,35.657264,139.743821,2024-02-08 15:15:03
315,N3-11.上高田区民活動センター,3,2,5,35.711501,139.672761,2024-02-08 15:15:03
316,T3-30.北西大松公園,2,2,4,35.765979,139.64931,2024-02-08 15:15:03
317,D6-05.新宿中央公園（水の広場）,5,1,6,35.690474,139.690219,2024-02-08 15:15:03
318,D6-07.新宿フロントタワー,3,6,9,35.696387,139.689924,2024-02-08 15:15:03
319,T2-73.早実グラウンド記念公園,2,2,4,35.734615,139.576214,2024-02-08 15:15:03
320,O7-03.永福町西幸モータープール東,2,9,11,35.67156,139.64609,2024-02-08 15:15:03
321,D1-03.新左門児童遊園,1,3,4,35.684523,139.720519,2024-02-08 15:15:03
322,D1-04.四谷見附公園,0,31,31,35.683448,139.728425,2024-02-08 15:15:03
323,I1-54.天王洲オーシャンスクエア,10,5,15,35.622356,139.749468,2024-02-08 15:15:03
324,D6-01.新宿区役所本庁舎,46,1,47,35.693602,139.703229,2024-02-08 15:15:03
325,D6-02.新宿区役所第二分庁舎,34,1,35,35.693976,139.706134,2024-02-08 15:15:03
326,D6-03.新宿中央公園（ポケットパーク）,8,1,9,35.691559,139.690029,2024-02-08 15:15:03
327,D6-04.新宿中央公園（ちびっこ広場）,7,3,10,35.686649,139.689821,2024-02-08 15:15:03
328,A6-21.日本工営ビル,3,1,4,35.684584,139.734442,2024-02-08 15:15:03
329,I1-77.セブン-イレブン品川西中延1丁目店,0,16,16,35.612217,139.708164,2024-02-08 15:15:03
330,T1-01.光が丘駅前広場,9,4,13,35.759164,139.629466,2024-02-08 15:15:03
331,T2-37.上石神井2丁目,2,6,8,35.729615,139.59532,2024-02-08 15:15:03
332,I1-75.セブン-イレブン品川二葉4丁目店,0,6,6,35.603275,139.713428,2024-02-08 15:15:03
333,M5-13.セブン-イレブン初台店,0,13,13,35.675049,139.68444,2024-02-08 15:15:03
334,D6-24.ＮＴＴ東日本 本社ビル,8,4,12,35.683102,139.688852,2024-02-08 15:15:03
335,H1-134.豊洲ぐるり公園,10,12,22,35.643141,139.777821,2024-02-08 15:15:03
336,H1-133.北砂2丁目公園,0,26,26,35.679001,139.825809,2024-02-08 15:15:03
337,E3-08.サガラマンション,0,4,4,35.722833,139.734662,2024-02-08 15:15:03
338,O4-05.阿佐ヶ谷南1-30,1,2,3,35.700703,139.639985,2024-02-08 15:15:03
339,O5-06.EXAM高円寺南,5,0,5,35.70273,139.65864,2024-02-08 15:15:03
340,G2-03.押上１丁目２６-４,5,0,5,35.710323,139.815215,2024-02-08 15:15:03
341,K1-132.多摩川駅前自転車等駐車場,15,0,15,35.587232,139.669519,2024-02-08 15:15:03
342,C5-47.oak港南品川,23,2,25,35.62413,139.744831,2024-02-08 15:15:03
343,D3-15.カースルいずみ,8,6,14,35.711324,139.711976,2024-02-08 15:15:03
344,C5-15.セブン-イレブン 港区芝浦ふ頭店,0,5,5,35.640215,139.755971,2024-02-08 15:15:03
345,C5-14.セブン-イレブン 港区汐彩橋店,0,10,10,35.640481,139.753659,2024-02-08 15:15:03
346,D5-01.新宿コズミックセンター,0,8,8,35.705244,139.70841,2024-02-08 15:15:03
347,H1-45.夢の島競技場,18,2,20,35.648596,139.824936,2024-02-08 15:15:03
348,E1-01.後楽橋横,24,0,24,35.702746,139.752009,2024-02-08 15:15:03
349,B1-15.ロイヤルパークホテル,0,14,14,35.682332,139.78722,2024-02-08 15:15:03
350,C4-05.白金台駅自転車駐車場,7,7,14,35.638927,139.727083,2024-02-08 15:15:03
351,E1-02.東京ドーム（ミーツポート）,6,3,9,35.70311,139.754951,2024-02-08 15:15:03
352,M2-06.あいおいニッセイ同和損保恵比寿ビル,6,1,7,35.647237,139.71512,2024-02-08 15:15:03
353,J1-12.工大橋下流自転車置場,4,0,4,35.605828,139.680265,2024-02-08 15:15:03
354,C5-25.NEX-TEC芝浦,38,0,38,35.639571,139.755551,2024-02-08 15:15:03
355,H1-175.ダイアパレス大島駅前,1,1,2,35.689543,139.836394,2024-02-08 15:15:03
356,C1-65.東京ポートシティ竹芝,11,2,13,35.654757,139.761516,2024-02-08 15:15:03
357,O2-03.西荻北5-8-17,3,2,5,35.709712,139.601846,2024-02-08 15:15:03
358,B2-21.八重洲二丁目北地区広場,0,8,8,35.67942,139.77004,2024-02-08 15:15:03
359,I1-101.下神明駅前,25,0,25,35.60838,139.726587,2024-02-08 15:15:03
360,N2-04.野方2丁目,5,1,6,35.713018,139.656768,2024-02-08 15:15:03
361,N2-05.野方3丁目,0,11,11,35.717877,139.654732,2024-02-08 15:15:03
362,K1-88.大田久が原西郵便局,0,6,6,35.582756,139.6925,2024-02-08 15:15:03
363,C5-51.トミンタワー台場一番街,1,4,5,35.634627,139.77663,2024-02-08 15:15:03
364,C4-10.亀塚公園,10,0,10,35.642764,139.741174,2024-02-08 15:15:03
365,H1-190.福山通運 東京支店,0,21,21,35.664845,139.796643,2024-02-08 15:15:03
366,C1-80.浜松町262ビル,9,3,12,35.654289,139.75557,2024-02-08 15:15:03
367,B2-19.リエトコートアルクスタワー,4,2,6,35.670506,139.77854,2024-02-08 15:15:03
368,C1-79.髙松コンストラクショングループ 東京本社ビル,0,5,5,35.648765,139.753363,2024-02-08 15:15:03
369,C5-43.オアーゼ芝浦MJビル,9,0,9,35.644798,139.752697,2024-02-08 15:15:03
370,J1-44.五本木2丁目,1,7,8,35.634441,139.687186,2024-02-08 15:15:03
371,B2-17.アーバネックス八丁堀,3,0,3,35.67518,139.77364,2024-02-08 15:15:03
372,M6-16.パールマンション,2,0,2,35.67464,139.67876,2024-02-08 15:15:03
373,G4-06.ドムス・スタイル両国,1,5,6,35.700453,139.798978,2024-02-08 15:15:03
374,G2-04.ラ　ステュディオ押上,4,1,5,35.712157,139.815298,2024-02-08 15:15:03
375,T3-15.セブン-イレブン練馬北町8丁目店,6,0,6,35.768105,139.646049,2024-02-08 15:15:03
376,C1-77.芝公園,13,5,18,35.65513,139.749645,2024-02-08 15:15:03
377,I1-27.小関橋公園,0,6,6,35.620699,139.730904,2024-02-08 15:15:03
378,B3-01.中央区役所,6,0,6,35.670855,139.772052,2024-02-08 15:15:03
379,A6-08.二番町ガーデン,4,1,5,35.685489,139.734562,2024-02-08 15:15:03
380,B1-01.十思公園,0,8,8,35.691058,139.777915,2024-02-08 15:15:03
381,B4-02.月島特別出張所,0,34,34,35.662197,139.782719,2024-02-08 15:15:03
382,A4-05.大手町タワー,12,5,17,35.685938,139.764886,2024-02-08 15:15:03
383,H1-22.豊洲市場（7街区）,17,53,70,35.6447,139.784512,2024-02-08 15:15:03
384,A6-07.二番町センタービル,0,3,3,35.685966,139.736328,2024-02-08 15:15:03
385,A2-12.神保町三井ビルディング,10,0,10,35.694532,139.760695,2024-02-08 15:15:03
386,E2-06.oto no ha Cafe,0,4,4,35.713991,139.725665,2024-02-08 15:15:03
387,B4-10.リバーシティ,0,11,11,35.668795,139.784784,2024-02-08 15:15:03
388,B1-03.常盤公園（北側）,7,1,8,35.688405,139.770068,2024-02-08 15:15:03
389,C5-19.グランドメゾン田町,7,0,7,35.645537,139.754899,2024-02-08 15:15:03
390,K1-11.ファミリーマート かわだ多摩川２丁目店,0,5,5,35.558289,139.697403,2024-02-08 15:15:03
391,J1-43.アルコタワー・ホテル雅叙園東京,12,0,12,35.63237,139.712681,2024-02-08 15:15:03
392,N1-03.鷺宮南駐輪場,6,3,9,35.721827,139.635949,2024-02-08 15:15:03
393,N2-06.江古田1丁目B,3,3,6,35.72515,139.672614,2024-02-08 15:15:03
394,D7-12.プラウド高田馬場,4,1,5,35.715538,139.701683,2024-02-08 15:15:03
395,K1-118.久が原3丁目,0,9,9,35.580741,139.687152,2024-02-08 15:15:03
396,K1-125.池上駅南口第1,1,1,2,35.571866,139.703214,2024-02-08 15:15:03
397,K1-117.安詳寺,6,13,19,35.581798,139.695222,2024-02-08 15:15:03
398,I1-91.アクロス目黒タワー,7,1,8,35.634019,139.719749,2024-02-08 15:15:03
399,K1-126.池上駅南口第2,2,1,3,35.571815,139.702387,2024-02-08 15:15:03
400,C5-50.お台場レインボー公園,12,0,12,35.633133,139.777315,2024-02-08 15:15:03
401,T3-26.富士見ランド公園,0,8,8,35.73701,139.627244,2024-02-08 15:15:03
402,T1-15.つのの山緑地,4,0,4,35.765144,139.636606,2024-02-08 15:15:03
403,T1-16.ゆりの木通り南公園,3,1,4,35.767582,139.636304,2024-02-08 15:15:03
404,H1-185.UR大島六丁目団地(第二),3,2,5,35.690038,139.833252,2024-02-08 15:15:03
405,H1-186.セブン-イレブン亀戸昭和橋通り店,0,8,8,35.694804,139.831357,2024-02-08 15:15:03
406,K1-96.西馬込駅前自転車駐車場,7,7,14,35.586408,139.705425,2024-02-08 15:15:03
407,H1-184.UR大島六丁目団地(第一),0,4,4,35.689913,139.833279,2024-02-08 15:15:03
408,A6-25.麹町仮住宅,4,0,4,35.679192,139.74019,2024-02-08 15:15:03
409,C1-69.塩釜公園,0,8,8,35.662908,139.755014,2024-02-08 15:15:03
410,C1-68.桜田公園,26,0,26,35.665214,139.757008,2024-02-08 15:15:03
411,A2-14.興和一橋ビル,14,1,15,35.6927,139.759311,2024-02-08 15:15:03
412,C5-41.トヨタモビリティ東京 芝浦店,4,1,5,35.639644,139.745532,2024-02-08 15:15:03
413,T2-22.ファミリーマート 石神井台7丁目店,4,1,5,35.731909,139.579685,2024-02-08 15:15:03
414,A6-20.紀尾井町PREX,6,0,6,35.68369,139.736936,2024-02-08 15:15:03
415,C5-24.GLOBAL FRONT TOWER,1,12,13,35.647713,139.755534,2024-02-08 15:15:03
416,E5-09.文京区 男女平等センター,3,12,15,35.70861,139.75768,2024-02-08 15:15:03
417,K1-37.東京サーハウス前,19,1,20,35.563874,139.685011,2024-02-08 15:15:03
418,B4-15.リバーシティ　イーストタワーズ,0,15,15,35.669188,139.785301,2024-02-08 15:15:03
419,M6-08.Be Good 幡ヶ谷,3,2,5,35.682453,139.677687,2024-02-08 15:15:03
420,D5-09.ハウジングステージ新宿,8,5,13,35.702277,139.701214,2024-02-08 15:15:03
421,D6-21.新宿5丁目,4,3,7,35.691613,139.711233,2024-02-08 15:15:03
422,K1-39.東京モノレール 流通センター駅前,16,13,29,35.581752,139.748705,2024-02-08 15:15:03
423,K1-38.ネクストサイト蒲田ビル,8,0,8,35.558916,139.717253,2024-02-08 15:15:03
424,T3-17.練馬区役所東庁舎(第二),4,1,5,35.735585,139.652544,2024-02-08 15:15:03
425,H1-107.大島小松川公園,0,27,27,35.692641,139.846346,2024-02-08 15:15:03
426,B1-11.浜町川緑道,8,39,47,35.684158,139.787649,2024-02-08 15:15:03
427,A6-19.番町麹町ビルディング,10,2,12,35.685578,139.732078,2024-02-08 15:15:03
428,B3-12.築地場外市場,17,1,18,35.665254,139.769301,2024-02-08 15:15:03
429,I1-40.御殿山トラストタワー,25,0,25,35.622371,139.737457,2024-02-08 15:15:03
430,M5-08.古賀政男音楽博物館,2,0,2,35.668091,139.680243,2024-02-08 15:15:03
431,H1-90.富士倉庫運輸(株) FACE-1前,0,4,4,35.655102,139.805205,2024-02-08 15:15:03
432,A3-38.パークホームズ千代田淡路町,4,0,4,35.695163,139.769566,2024-02-08 15:15:03
433,D2-11.神楽坂アインスタワー,2,4,6,35.702833,139.739,2024-02-08 15:15:03
434,C2-04.飯倉いきいきプラザ,0,6,6,35.656991,139.740739,2024-02-08 15:15:03
435,B1-09.スマイルホテル日本橋三越前,18,0,18,35.686101,139.776089,2024-02-08 15:15:03
436,E5-15.文京千駄木の郷,6,5,11,35.726499,139.759884,2024-02-08 15:15:03
437,C2-05.ありすいきいきプラザ,9,2,11,35.651046,139.727745,2024-02-08 15:15:03
438,C5-06.品川シーズンテラス,19,0,19,35.632303,139.742393,2024-02-08 15:15:03
439,B1-10.箱崎川第二公園,5,2,7,35.680833,139.784267,2024-02-08 15:15:03
440,L1-15.ソフィア,0,3,3,35.663222,139.587803,2024-02-08 15:15:03
441,A3-12.秋葉原UDX北側駐輪場前,14,1,15,35.70111,139.772855,2024-02-08 15:15:03
442,A2-08.KDX御茶ノ水ビル,6,3,9,35.700568,139.76013,2024-02-08 15:15:03
443,A3-07.淡路公園,3,2,5,35.696942,139.767302,2024-02-08 15:15:03
444,A1-08.飯田橋サクラテラス（早稲田通り）,0,12,12,35.699132,139.74462,2024-02-08 15:15:03
445,A3-13.富士ソフトビル（駐車場入口横）,3,15,18,35.700486,139.774254,2024-02-08 15:15:03
446,A2-09.テラススクエア,7,1,8,35.6931,139.7599,2024-02-08 15:15:03
447,A6-11.東京ガーデンテラス紀尾井町,17,4,21,35.67962,139.7364,2024-02-08 15:15:03
448,K1-124.矢口2丁目,3,1,4,35.564161,139.695187,2024-02-08 15:15:03
449,N3-15.ライオンズマンション中野東,2,1,3,35.71046,139.6855,2024-02-08 15:15:03
450,M3-11.渋谷道玄坂東急ビル,10,0,10,35.65718,139.698687,2024-02-08 15:15:03
451,H1-180.シティコート大島,8,0,8,35.691954,139.836462,2024-02-08 15:15:03
452,B1-27.日本橋本町4丁目,24,4,28,35.68973,139.77598,2024-02-08 15:15:03
453,M3-22.森谷ビル,15,0,15,35.64514,139.71686,2024-02-08 15:15:03
454,N3-17.東中野3丁目,10,0,10,35.70862,139.680679,2024-02-08 15:15:03
455,N2-10.関根ビル,0,4,4,35.733432,139.671241,2024-02-08 15:15:03
456,T1-06.秋の陽公園,4,1,5,35.762326,139.635226,2024-02-08 15:15:03
457,N1-02.鷺宮東駐輪場,0,13,13,35.721556,139.640397,2024-02-08 15:15:03
458,K1-140.西馬込駅前自転車駐車場(奥),12,2,14,35.586382,139.705116,2024-02-08 15:15:03
459,H1-182.錦糸町プライムタワー,12,1,13,35.695695,139.820507,2024-02-08 15:15:03
460,E5-05.駒込地域活動センター,0,8,8,35.728644,139.752183,2024-02-08 15:15:03
461,M3-06.渋谷第一生命ビル,5,0,5,35.657556,139.704129,2024-02-08 15:15:03
462,T2-42.石神井公園駅北第二自転車駐車場,2,3,5,35.74553,139.608939,2024-02-08 15:15:03
463,K1-144.蒲田五丁目44番自転車駐車場,10,0,10,35.559809,139.716993,2024-02-08 15:15:03
464,M3-07.渋谷ファーストプレイス,9,1,10,35.65506,139.69384,2024-02-08 15:15:03
465,H1-74.タダノ教習センター,9,1,10,35.63848,139.832305,2024-02-08 15:15:03
466,H1-151.コスモリード錦糸町,2,7,9,35.701347,139.819973,2024-02-08 15:15:03
467,T2-23.セブン-イレブン 練馬南大泉5丁目店,5,1,6,35.750185,139.579216,2024-02-08 15:15:03
468,M4-13.J-cube,3,0,3,35.66616,139.70458,2024-02-08 15:15:03
469,T2-65.さくらの辻公園,2,1,3,35.734805,139.599906,2024-02-08 15:15:03
470,T2-24.セブン-イレブン 練馬インター店,0,24,24,35.754586,139.606409,2024-02-08 15:15:03
471,O5-05.モンテ・ベルテ,0,2,2,35.701454,139.650518,2024-02-08 15:15:03
472,J1-42.都立大学駅北口バス停前,3,6,9,35.618622,139.67596,2024-02-08 15:15:03
473,K1-97.トミンタワー多摩川二丁目,6,1,7,35.555561,139.704345,2024-02-08 15:15:03
474,D1-14.コモレ四谷,0,5,5,35.68752,139.72818,2024-02-08 15:15:03
475,K1-106.ファミリーマート上池台夫婦坂店,2,7,9,35.599329,139.703343,2024-02-08 15:15:03
476,J1-39.松見坂公園,0,9,9,35.655483,139.687325,2024-02-08 15:15:03
477,J1-40.西小山公園,7,1,8,35.616541,139.697369,2024-02-08 15:15:03
478,J1-38.林試の森公園 北,6,6,12,35.626355,139.700153,2024-02-08 15:15:03
479,I1-84.セブン-イレブン西品川2丁目店,0,0,0,35.613819,139.728418,2024-02-08 15:15:03
480,D6-26.セブン-イレブン新宿６丁目文化センター通り店,8,1,9,35.694951,139.708219,2024-02-08 15:15:03
481,T2-25.ファミリーマート 高野台二丁目店,0,6,6,35.746045,139.620087,2024-02-08 15:15:03
482,I1-85.GOODOFFICE品川,1,0,1,35.621081,139.741178,2024-02-08 15:15:03
483,K1-74.大田スタジアム,3,4,7,35.587423,139.753871,2024-02-08 15:15:03
484,C1-64.東京虎ノ門グローバルスクエア,3,2,5,35.669941,139.749261,2024-02-08 15:15:03
485,K1-72.ファミリーマート大森西四丁目店,0,5,5,35.573358,139.723105,2024-02-08 15:15:03
486,H1-118.ファミリーマート亀戸駅前店,7,3,10,35.69839,139.825484,2024-02-08 15:15:03
487,I1-62.天王洲Rim,0,5,5,35.622277,139.745638,2024-02-08 15:15:03
488,H1-40.深川東京モダン館,4,1,5,35.674076,139.795008,2024-02-08 15:15:03
489,H1-117.東京パークサイドビル,8,0,8,35.671225,139.808561,2024-02-08 15:15:03
490,J1-01.目黒区総合庁舎,8,1,9,35.640675,139.698088,2024-02-08 15:15:03
491,C5-16.品川インターシティ,23,0,23,35.626704,139.742174,2024-02-08 15:15:03
492,A1-12.北の丸スクエア,6,1,7,35.695515,139.750213,2024-02-08 15:15:03
493,H1-46.セブン-イレブン 江東枝川2丁目店,0,8,8,35.659287,139.807358,2024-02-08 15:15:03
494,A2-25.プラウド神田駿河台,11,2,13,35.698991,139.76091,2024-02-08 15:15:03
495,C5-49.プラウドタワー芝浦,0,8,8,35.638912,139.747422,2024-02-08 15:15:03
496,T3-25.北町みのり公園,1,3,4,35.767627,139.65243,2024-02-08 15:15:03
497,H1-75.ジオ深川住吉,4,6,10,35.684247,139.815638,2024-02-08 15:15:03
498,T1-09.ローソン練馬旭町一丁目店,4,1,5,35.765704,139.625178,2024-02-08 15:15:03
499,T2-26.ファミリーマート 大泉学園町四丁目店,0,7,7,35.767388,139.587625,2024-02-08 15:15:03
500,T2-27.ファミリーマート 大泉長久保通り店,2,3,5,35.773841,139.591456,2024-02-08 15:15:03
501,C3-19.明治記念館西,2,2,4,35.678179,139.720809,2024-02-08 15:15:03
502,I1-11.鮫洲入江広場,12,0,12,35.603984,139.744504,2024-02-08 15:15:03
503,I1-10.品川シーサイド公園第1,11,6,17,35.607717,139.749478,2024-02-08 15:15:03
504,I1-09.東品川海上公園第1,0,5,5,35.616633,139.748945,2024-02-08 15:15:03
505,D3-06.セブン-イレブン高田馬場3丁目中央店,0,7,7,35.713872,139.698301,2024-02-08 15:15:03
506,K1-40.大田文化の森,0,15,15,35.579649,139.720263,2024-02-08 15:15:03
507,C1-41.港区立エコプラザ,7,2,9,35.658709,139.757036,2024-02-08 15:15:03
508,I1-13.八潮北公園,0,11,11,35.613421,139.75375,2024-02-08 15:15:03
509,I1-12.しながわ区民公園（北側）,1,1,2,35.596091,139.740884,2024-02-08 15:15:03
510,T2-09.こぐれの森緑地,4,6,10,35.763741,139.588847,2024-02-08 15:15:03
511,T3-31.パークサイド関口,3,5,8,35.74097,139.63836,2024-02-08 15:15:03
512,H1-183.MFLP新木場1,0,4,4,35.643958,139.838358,2024-02-08 15:15:03
513,T2-33.ウインドヒルズ189,3,3,6,35.74642,139.581204,2024-02-08 15:15:03
514,T2-67.陽和病院,0,7,7,35.761211,139.603316,2024-02-08 15:15:03
515,H1-82.セブンｰイレブン 北砂3丁目明治通り店,0,20,20,35.683514,139.827081,2024-02-08 15:15:03
516,T2-60.武蔵関公園（第一）,9,0,9,35.724747,139.565817,2024-02-08 15:15:03
517,I1-48.NTT 東日本 関東病院(北側),7,2,9,35.632191,139.725002,2024-02-08 15:15:03
518,T2-58.立野公園,3,2,5,35.716776,139.577975,2024-02-08 15:15:03
519,I1-100.東急荏原中延駅駐輪場,5,2,7,35.610444,139.712333,2024-02-08 15:15:03
520,T2-56.大泉公園（第一）,2,2,4,35.77228,139.58325,2024-02-08 15:15:03
521,T2-55.大泉町もみじやま公園,2,1,3,35.767296,139.602321,2024-02-08 15:15:03
522,T2-54.土支田農業公園,1,8,9,35.760939,139.609264,2024-02-08 15:15:03
523,I1-44.大井三ツ又商店街入口,7,0,7,35.604606,139.734483,2024-02-08 15:15:03
524,T2-62.大泉井頭公園,6,4,10,35.746681,139.57754,2024-02-08 15:15:03
525,T2-61.武蔵関公園（第二）,4,0,4,35.727826,139.570056,2024-02-08 15:15:03
526,T3-09.学田公園,3,2,5,35.730428,139.648704,2024-02-08 15:15:03
527,K1-105.東糀谷二丁目児童公園,0,6,6,35.555702,139.740802,2024-02-08 15:15:03
528,T3-04.サンパレス平和台,8,4,12,35.759827,139.659121,2024-02-08 15:15:03
529,K1-104.六郷BASE,1,5,6,35.543573,139.714393,2024-02-08 15:15:03
530,M4-16.神宮前6丁目,2,1,3,35.668673,139.702816,2024-02-08 15:15:03
531,K1-69.京急平和島第2Bバイク駐輪場,3,0,3,35.585747,139.735242,2024-02-08 15:15:03
532,H1-155.メブクス豊洲,0,28,28,35.645726,139.784496,2024-02-08 15:15:03
533,C2-11.一の橋,13,36,49,35.654726,139.737491,2024-02-08 15:15:03
534,C4-11.ザ・パークハウス 三田ガーデン,4,5,9,35.64816,139.737991,2024-02-08 15:15:03
535,H1-161.昭文社制作本部ビル,4,2,6,35.684003,139.794983,2024-02-08 15:15:03
536,N2-07.新井区民活動センター,1,4,5,35.714292,139.663327,2024-02-08 15:15:03
537,K1-87.羽田イノベーションシティ,2,8,10,35.547061,139.756277,2024-02-08 15:15:03
538,N3-16.COURT 5,5,0,5,35.699743,139.664608,2024-02-08 15:15:03
539,C4-01.高輪地区総合支所(5F),2,7,9,35.641833,139.734519,2024-02-08 15:15:03
540,C5-48.セブンイレブン港区海岸三丁目店,2,2,4,35.636808,139.752517,2024-02-08 15:15:03
541,H1-42.江東区スポーツ会館,0,27,27,35.683961,139.821559,2024-02-08 15:15:03
542,B2-10.東京ダイヤビルディング（北側）,0,7,7,35.675702,139.785229,2024-02-08 15:15:03
543,H1-43.東京イースト21,0,15,15,35.675639,139.815255,2024-02-08 15:15:03
544,B3-20.歌舞伎座タワー駐輪場2F,5,1,6,35.670106,139.768041,2024-02-08 15:15:03
545,B3-21.歌舞伎座タワー駐輪場3F,10,1,11,35.6701,139.76801,2024-02-08 15:15:03
546,K1-139.プラットホステル京急 羽田ホーム,8,2,10,35.548104,139.748889,2024-02-08 15:15:03
547,J1-58.目黒女子会館前,3,1,4,35.629011,139.69716,2024-02-08 15:15:03
548,T2-18.ファミリーマート練馬西税務署前店,3,0,3,35.745505,139.580878,2024-02-08 15:15:03
549,C3-23.LIFORK 南青山 北エントランス,14,15,29,35.669916,139.725701,2024-02-08 15:15:03
550,C1-46.新虎通りCORE,16,1,17,35.665124,139.754054,2024-02-08 15:15:03
551,C1-45.浜松町クレアタワー,15,2,17,35.656324,139.755927,2024-02-08 15:15:03
552,K1-53.セブン-イレブン 田園調布郵便局前店,16,4,20,35.589309,139.678587,2024-02-08 15:15:03
553,K1-52.大田区総合体育館,7,0,7,35.564152,139.727422,2024-02-08 15:15:03
554,T1-12.ファミリーマート 高松六丁目店,4,0,4,35.756873,139.616612,2024-02-08 15:15:03
555,D7-07.ローソン 新宿西落合三丁目店,0,5,5,35.725171,139.675897,2024-02-08 15:15:03
556,A6-16.一番町第二TGビル,3,2,5,35.688351,139.744321,2024-02-08 15:15:03
557,C3-33.PASONA SQUARE,12,0,12,35.667462,139.716058,2024-02-08 15:15:03
558,A3-24.岩本町ほほえみプラザ,0,10,10,35.69441,139.777715,2024-02-08 15:15:03
559,H1-35.ヒューリック豊洲プライムスクエア,6,0,6,35.652376,139.797724,2024-02-08 15:15:03
560,C5-11.フェイバリッチタワー品川,0,36,36,35.631729,139.749767,2024-02-08 15:15:03
561,E2-13.デルックス文京神楽坂,3,1,4,35.70781,139.732227,2024-02-08 15:15:03
562,C5-01.こうなん星の公園,8,37,45,35.629697,139.742167,2024-02-08 15:15:03
563,C5-02.港南緑水公園,0,62,62,35.628955,139.750731,2024-02-08 15:15:03
564,A3-22.龍閑児童公園,2,5,7,35.693234,139.779702,2024-02-08 15:15:03
565,A3-21.神田ふれあい通り第３,8,4,12,35.695176,139.772832,2024-02-08 15:15:03
566,H1-30.江東区役所（北側）,6,6,12,35.67338,139.8164,2024-02-08 15:15:03
567,C1-17.港区役所,4,0,4,35.657866,139.751068,2024-02-08 15:15:03
568,H1-31.江東区役所（南側）,12,4,16,35.67214,139.8166,2024-02-08 15:15:03
569,C1-09.愛宕グリーンヒルズ,7,2,9,35.662051,139.748132,2024-02-08 15:15:03
570,D1-02.四谷特別出張所（新宿御苑大木戸門前）,14,3,17,35.687435,139.714169,2024-02-08 15:15:03
571,D1-01.花園西公園,5,0,5,35.690612,139.711631,2024-02-08 15:15:03
572,C1-04.虎ノ門ヒルズ,10,3,13,35.666527,139.748804,2024-02-08 15:15:03
573,C1-05.西新橋2丁目（新虎通り）,14,0,14,35.665593,139.752617,2024-02-08 15:15:03
574,C1-73.日比谷フォートタワー,14,0,14,35.669871,139.753147,2024-02-08 15:15:03
575,K1-102.上池台四丁目公園,0,7,7,35.595119,139.6996,2024-02-08 15:15:03
576,M2-01.恵比寿保健相談所（恵比寿社会教育館）,0,12,12,35.64524,139.71946,2024-02-08 15:15:03
577,I1-98.コーポ荏原,0,4,4,35.60411,139.709784,2024-02-08 15:15:03
578,C3-17.セブン-イレブン 港区溜池山王店,2,16,18,35.670308,139.743242,2024-02-08 15:15:03
579,T2-11.石神井松の風文化公園,2,0,2,35.739471,139.595578,2024-02-08 15:15:03
580,M2-03.サイカパーク恵比寿,13,2,15,35.646581,139.710613,2024-02-08 15:15:03
581,M2-02.アメリカ橋公園,8,0,8,35.643606,139.713099,2024-02-08 15:15:03
582,T2-50.North Ridge 吉祥寺,6,3,9,35.72305,139.579555,2024-02-08 15:15:03
583,J1-35.目黒川田道街かど公園,6,0,6,35.634574,139.710332,2024-02-08 15:15:03
584,H1-174.ジュネス(エントランス側),1,0,1,35.682712,139.823961,2024-02-08 15:15:03
585,M6-17.笹塚一丁目駐輪場,1,6,7,35.672922,139.668729,2024-02-08 15:15:03
586,C4-14.神応ほっとプラザ,4,6,10,35.643711,139.724753,2024-02-08 15:15:03
587,K1-107.馬込駅A2出口,4,6,10,35.596854,139.712139,2024-02-08 15:15:03
588,T3-11.ガラクタ公園,1,2,3,35.740321,139.631256,2024-02-08 15:15:03
589,T2-80.みその緑地,2,3,5,35.756825,139.590528,2024-02-08 15:15:03
590,T3-24.AZEST新桜台,5,2,7,35.743962,139.670315,2024-02-08 15:15:03
591,D4-07.新宿余丁町ビル,0,7,7,35.698512,139.716482,2024-02-08 15:15:03
592,T3-01.練馬春日町駅自転車駐車場,6,1,7,35.751438,139.641265,2024-02-08 15:15:03
593,H1-89.BUDDY スポーツアリーナ,4,10,14,35.637041,139.781088,2024-02-08 15:15:03
594,E5-14.上野広小路駅（湯島側）,1,12,13,35.707313,139.771857,2024-02-08 15:15:03
595,H1-109.Brillia ist 東雲キャナルコート東側,0,38,38,35.648008,139.803487,2024-02-08 15:15:03
596,H1-108.Brillia ist 東雲キャナルコート北側,0,11,11,35.648431,139.803125,2024-02-08 15:15:03
597,C1-53.ホテルリブマックス新橋,3,1,4,35.661149,139.754612,2024-02-08 15:15:03
598,D7-10.染の里 おちあい,1,5,6,35.715211,139.689788,2024-02-08 15:15:03
599,A1-15.富士見みらい館,0,5,5,35.697167,139.745629,2024-02-08 15:15:03
600,E4-15.千石4丁目,2,3,5,35.729153,139.741368,2024-02-08 15:15:03
601,H1-111.ファミリーマート木場六丁目店,0,1,1,35.66688,139.80779,2024-02-08 15:15:03
602,C5-36.お台場海浜公園駅,2,0,2,35.62974,139.778178,2024-02-08 15:15:03
603,H1-10.出会い橋,15,0,15,35.625029,139.777344,2024-02-08 15:15:03
604,H1-11.テレコムセンター駅,2,19,21,35.61813,139.778698,2024-02-08 15:15:03
605,H1-47.トピレックプラザ,0,30,30,35.672481,139.835877,2024-02-08 15:15:03
606,H1-13.アーバンドック ららぽーと豊洲,17,2,19,35.654067,139.792376,2024-02-08 15:15:03
607,T2-66.大泉学園町希望ヶ丘公園,0,4,4,35.778605,139.588883,2024-02-08 15:15:03
608,C5-37.台場駅,0,26,26,35.626388,139.772453,2024-02-08 15:15:03
609,H1-16.豊洲三丁目公園,13,5,18,35.657477,139.796629,2024-02-08 15:15:03
610,H1-17.東雲水辺公園,0,42,42,35.64704,139.80469,2024-02-08 15:15:03
611,C1-72.新田町ビル,4,6,10,35.646307,139.746428,2024-02-08 15:15:03
612,K1-98.鵜の木松山公園,2,5,7,35.577433,139.680752,2024-02-08 15:15:03
613,C1-71.芝商業高校前交差点,0,5,5,35.65583,139.759896,2024-02-08 15:15:03
614,H1-122.東砂スポーツセンター,1,11,12,35.679167,139.839746,2024-02-08 15:15:03
615,O6-05.コージーコート久我山,0,5,5,35.687531,139.60439,2024-02-08 15:15:03
616,T2-39.ローソン 練馬大泉町五丁目店,4,4,8,35.758929,139.597548,2024-02-08 15:15:03
617,J1-50.大岡山公園,2,1,3,35.609958,139.684087,2024-02-08 15:15:03
618,J1-51.池尻大橋駅東口駐輪場,0,5,5,35.650627,139.687228,2024-02-08 15:15:03
619,K1-99.東原くすのき公園,6,2,8,35.584086,139.67898,2024-02-08 15:15:03
620,N3-12.桃園区民活動センター,2,1,3,35.702414,139.667327,2024-02-08 15:15:03
621,H1-191.三井リンクラボ新木場2,13,1,14,35.644863,139.831107,2024-02-08 15:15:03
622,M5-09.代々木上原駅前,5,0,5,35.66865,139.679251,2024-02-08 15:15:03
623,O3-09.NTT井草ビル第3ポート,4,3,7,35.714151,139.61693,2024-02-08 15:15:03
624,T1-07.土支田一丁目（笹目通り）,1,9,10,35.765913,139.619285,2024-02-08 15:15:03
625,K1-22.矢口特別出張所,3,2,5,35.562324,139.690486,2024-02-08 15:15:03
626,T3-08.中新井川児童遊園,2,5,7,35.728268,139.649188,2024-02-08 15:15:03
627,H1-78.ローソン新木場一丁目店,13,1,14,35.645604,139.834941,2024-02-08 15:15:03
628,A6-13.番町会館,4,2,6,35.689131,139.733071,2024-02-08 15:15:03
629,H1-71.セブン-イレブン 江東東陽4丁目,0,6,6,35.670906,139.819386,2024-02-08 15:15:03
630,D2-09.セブン-イレブン 新宿岩戸町店,2,0,2,35.700993,139.736355,2024-02-08 15:15:03
631,I1-08.天王洲アイル第一水辺広場,16,15,31,35.622294,139.751644,2024-02-08 15:15:03
632,I1-07.しながわ水族館,8,6,14,35.590641,139.736354,2024-02-08 15:15:03
633,D3-09.西早稲田3丁目,2,2,4,35.712545,139.713319,2024-02-08 15:15:03
634,E1-16.小石川3丁目緑地,5,10,15,35.714338,139.746346,2024-02-08 15:15:03
635,C5-28.芝浦ルネサイトタワー,6,0,6,35.643683,139.7506,2024-02-08 15:15:03
636,I1-59.文庫の森第一,15,2,17,35.612357,139.721484,2024-02-08 15:15:03
637,I1-60.文庫の森第二,1,2,3,35.611368,139.720424,2024-02-08 15:15:03
638,C1-38.KDX西新橋ビル（西側）,2,2,4,35.66495,139.750459,2024-02-08 15:15:03
639,C1-37.KDX西新橋ビル（北側）,5,0,5,35.665218,139.750827,2024-02-08 15:15:03
640,T2-14.NPC24H東大泉第6パーキング,0,6,6,35.747807,139.593599,2024-02-08 15:15:03
641,C3-12.赤坂センタービルディング前（青山通り）,4,4,8,35.676732,139.733905,2024-02-08 15:15:03
642,H1-36.フジゴルフセンター,0,16,16,35.66605,139.806699,2024-02-08 15:15:03
643,C1-27.虎ノ門2丁目タワー,13,1,14,35.668547,139.747175,2024-02-08 15:15:03
644,C5-12.第2東運ビル,6,0,6,35.633742,139.748281,2024-02-08 15:15:03
645,D6-08.新宿イーストサイドスクエア,5,1,6,35.697158,139.707887,2024-02-08 15:15:03
646,A4-08.永代通り（大手町駅B2c出口前）,22,0,22,35.684349,139.766958,2024-02-08 15:15:03
647,H1-37.東雲駅（東京湾岸道路）,29,5,34,35.640618,139.802455,2024-02-08 15:15:03
648,C3-11.赤坂見附南,0,2,2,35.676566,139.737083,2024-02-08 15:15:03
649,M6-04.本町東べんてん橋公園,0,18,18,35.687126,139.680702,2024-02-08 15:15:03
650,I1-79.品川浦第二,13,0,13,35.621904,139.741429,2024-02-08 15:15:03
651,K1-81.コーナン本羽田萩中店,10,3,13,35.549568,139.731093,2024-02-08 15:15:03
652,D6-25.新宿駅東南口自転車駐輪場,28,3,31,35.689755,139.701323,2024-02-08 15:15:03
653,I1-78.セブン-イレブン西大井店,7,4,11,35.601431,139.718659,2024-02-08 15:15:03
654,H1-136.東砂一丁目公園,1,16,17,35.683542,139.839763,2024-02-08 15:15:03
655,A6-23.セブン-イレブン 千代田三番町店,0,13,13,35.689466,139.745316,2024-02-08 15:15:03
656,C5-34.五色橋ビル,0,13,13,35.636644,139.751798,2024-02-08 15:15:03
657,K1-41.郷土博物館,0,11,11,35.588644,139.710413,2024-02-08 15:15:03
658,G2-06.ディアレイシャス押上スカイヴィレッジ,0,5,5,35.71408,139.810588,2024-02-08 15:15:03
659,O3-11.ハイリビング関根,5,3,8,35.707877,139.618926,2024-02-08 15:15:03
660,O7-02.永福中央公園,6,0,6,35.67121,139.64145,2024-02-08 15:15:03
661,K1-29.萩中文化センター,4,5,9,35.55017,139.728146,2024-02-08 15:15:03
662,K1-30.テクノFRONT森ケ崎,1,2,3,35.567922,139.746181,2024-02-08 15:15:03
663,K1-130.COCOONひろば平和島,13,0,13,35.578728,139.735238,2024-02-08 15:15:03
664,H1-81.豊洲IHIビル（北側）,17,2,19,35.659829,139.793243,2024-02-08 15:15:03
665,E4-03.昭和小学校北側（不忍通り）,27,6,33,35.73166,139.748625,2024-02-08 15:15:03
666,C2-12.六本木ファーストビル,14,1,15,35.66249,139.741397,2024-02-08 15:15:03
667,D3-16.セジョリ江戸川橋,6,9,15,35.708734,139.730509,2024-02-08 15:15:03
668,A5-04.日比谷パークフロント前　日比谷公園南面向い歩道上,4,3,7,35.671514,139.753952,2024-02-08 15:15:03
669,C3-22.OMO3東京赤坂 by 星野リゾート,8,0,8,35.674929,139.736053,2024-02-08 15:15:03
670,B1-20.竜閑さくら橋際街角広場,0,18,18,35.688301,139.768958,2024-02-08 15:15:03
671,H1-83.ローソン江東東雲店,2,9,11,35.642165,139.800439,2024-02-08 15:15:03
672,H1-84.NTT東日本辰巳ビル,0,21,21,35.647091,139.817333,2024-02-08 15:15:03
673,C5-26.ピアシティ芝浦ビル,10,0,10,35.644155,139.756216,2024-02-08 15:15:03
674,T3-28.ほしぞら緑地,0,3,3,35.755137,139.661208,2024-02-08 15:15:03
675,I1-88.セブン-イレブン品川南大井3丁目店,1,0,1,35.58768,139.734515,2024-02-08 15:15:03
676,I1-87.セブン-イレブン西大井滝王子通り店,0,5,5,35.599774,139.723467,2024-02-08 15:15:03
677,G4-11.ホテルマイステイズ浅草,19,2,21,35.703972,139.797327,2024-02-08 15:15:03
678,C5-30.フェイム芝浦インターウェーブ,2,4,6,35.647872,139.75391,2024-02-08 15:15:03
679,M6-13.JICA東京,9,2,11,35.673409,139.675203,2024-02-08 15:15:03
680,A4-13.アーバンネット大手町ビル,3,2,5,35.68557,139.766929,2024-02-08 15:15:03
681,B4-27.リバーシティ西ブロック,11,4,15,35.670491,139.784447,2024-02-08 15:15:03
682,K1-143.大森北1丁目,60,0,60,35.584914,139.730504,2024-02-08 15:15:03
683,E5-24.本郷6丁目,3,1,4,35.712445,139.758157,2024-02-08 15:15:03
684,D2-17.genten市ヶ谷店,10,0,10,35.690657,139.73255,2024-02-08 15:15:03
685,A4-14.東京国際フォーラム（有楽町駅ガード側）,2,2,4,35.675739,139.763712,2024-02-08 15:15:03
686,A2-27.丸紅ビル,5,0,5,35.690958,139.759876,2024-02-08 15:15:03
687,K1-135.北千束2丁目,4,2,6,35.608633,139.693653,2024-02-08 15:15:03
688,A1-19.九段会館テラス,4,0,4,35.694065,139.751801,2024-02-08 15:15:03
689,K1-136.BIG FUN 平和島,0,9,9,35.585489,139.740194,2024-02-08 15:15:03
690,K1-137.京浜島つばさ公園,0,16,16,35.571578,139.770532,2024-02-08 15:15:03
691,D1-16.ルネ新宿御苑タワー,6,2,8,35.690155,139.713377,2024-02-08 15:15:03
692,G6-01.オーキッドレジデンス森下,6,0,6,35.692547,139.799231,2024-02-08 15:15:03
693,T2-63.三原台公園,1,6,7,35.751471,139.599835,2024-02-08 15:15:03
694,O4-01.阿佐ヶ谷南公園,1,1,2,35.70328,139.62981,2024-02-08 15:15:03
695,B4-11.ダンスキューブ勝どき,0,13,13,35.656565,139.775073,2024-02-08 15:15:03
696,D1-06.四谷第六小学校北,10,0,10,35.681754,139.715256,2024-02-08 15:15:03
697,T2-64.高野台中央公園,1,2,3,35.746768,139.613885,2024-02-08 15:15:03
698,H1-169.セブンイレブン江東亀戸7丁目東店,1,9,10,35.697157,139.839835,2024-02-08 15:15:03
699,H1-170.セブンイレブン江東亀戸7丁目南店,0,30,30,35.695937,139.838017,2024-02-08 15:15:03
700,B2-16.ホテルサードニクス東京,3,2,5,35.67684,139.77876,2024-02-08 15:15:03
701,I1-93.中央海浜公園前交差点（南側）,5,0,5,35.595498,139.750654,2024-02-08 15:15:03
702,I1-92.中央海浜公園前交差点（北側）,10,0,10,35.595873,139.75134,2024-02-08 15:15:03
703,B1-26.Dash Living Nihonbashi,5,1,6,35.68802,139.78112,2024-02-08 15:15:03
704,H1-158.東京国際交流館,12,0,12,35.621845,139.776833,2024-02-08 15:15:03
705,J1-32.緑が丘駅前高架下,6,1,7,35.606793,139.678372,2024-02-08 15:15:03
706,K1-90.ファミリーマート大田仲池上一丁目店,1,5,6,35.5873,139.701644,2024-02-08 15:15:03
707,K1-91.穴守稲荷神社,3,7,10,35.550027,139.74973,2024-02-08 15:15:03
708,C1-67.京阪神 虎ノ門ビル,18,2,20,35.669228,139.751668,2024-02-08 15:15:03
709,K1-89.ファミリーマート大田千鳥三丁目店,3,2,5,35.572086,139.68708,2024-02-08 15:15:03
710,I1-97.トミンハイム東品川三丁目第二,17,1,18,35.613387,139.749307,2024-02-08 15:15:03
711,T2-51.練馬区役所石神井庁舎,7,3,10,35.743772,139.603317,2024-02-08 15:15:03
712,T2-75.石神井台二丁目緑地,3,0,3,35.734684,139.593628,2024-02-08 15:15:03
713,E5-19.千駄木公園,2,5,7,35.728333,139.757629,2024-02-08 15:15:03
714,E5-18.団子坂上広場,0,11,11,35.724921,139.75903,2024-02-08 15:15:03
715,A5-07.富国生命ビル,2,2,4,35.670452,139.75557,2024-02-08 15:15:03
716,H1-156.つどい橋下,0,9,9,35.630791,139.787396,2024-02-08 15:15:03
717,H1-159.夢の大橋西,14,2,16,35.627599,139.782953,2024-02-08 15:15:03
718,H1-143.ダイバーシティ東京 プラザ,8,2,10,35.624619,139.776006,2024-02-08 15:15:03
719,I1-57.大井水神公園,71,0,71,35.589972,139.729368,2024-02-08 15:15:03
720,B2-15.KABUTO ONE,4,2,6,35.68168,139.77825,2024-02-08 15:15:03
721,K1-64.多摩川グリーンスクエア,0,12,12,35.545459,139.719489,2024-02-08 15:15:03
722,T2-57.大泉公園（第二）,5,1,6,35.771708,139.583551,2024-02-08 15:15:03
723,A4-06.大手町ファーストスクエア,3,7,10,35.686037,139.764472,2024-02-08 15:15:03
724,C1-50.NTT虎ノ門ビル,11,3,14,35.666075,139.748008,2024-02-08 15:15:03
725,C1-23.三田いきいきプラザ,9,0,9,35.648637,139.749834,2024-02-08 15:15:03
726,H1-29.スカイズタワー＆ガーデン,0,40,40,35.647618,139.792152,2024-02-08 15:15:03
727,C1-21.汐留ビルディング,7,3,10,35.657363,139.75918,2024-02-08 15:15:03
728,A3-16.地蔵橋東児童遊園,3,3,6,35.691069,139.775376,2024-02-08 15:15:03
729,A3-18.美倉橋北児童遊園,0,8,8,35.69703,139.779928,2024-02-08 15:15:03
730,A4-01.丸ビル（南側駐輪場）,9,2,11,35.680514,139.764002,2024-02-08 15:15:03
731,A3-11.練成公園,0,8,8,35.703735,139.770629,2024-02-08 15:15:03
732,A3-10.芳林公園（北側）,0,7,7,35.701978,139.7698,2024-02-08 15:15:03
733,A6-02.いきいきプラザ一番町（西側駐輪場）,5,1,6,35.687031,139.739327,2024-02-08 15:15:03
734,A6-01.東郷元帥記念公園（南側）,2,0,2,35.689879,139.740178,2024-02-08 15:15:03
735,A5-03.参議院第二別館（永田町駅2番出口）,11,5,16,35.677763,139.74271,2024-02-08 15:15:03
736,A4-03.東京国際フォーラム（メトロD5出口）,8,0,8,35.675843,139.763329,2024-02-08 15:15:03
737,K1-15.セブン‐イレブン 大田区西蒲田店,3,0,3,35.56694,139.716331,2024-02-08 15:15:03
738,K1-49.ローソン仲池上一丁目店,5,2,7,35.586585,139.698552,2024-02-08 15:15:03
739,A2-06.東光電気工事 別館（屋内駐輪場）,7,0,7,35.69919,139.75701,2024-02-08 15:15:03
740,M4-01.新宿タカシマヤ,4,2,6,35.68714,139.702775,2024-02-08 15:15:03
741,M4-03.NTTドコモ代々木ビル,7,3,10,35.684451,139.702884,2024-02-08 15:15:03
742,M3-03.代官山 T-SITE,5,3,8,35.649823,139.700139,2024-02-08 15:15:03
743,K1-14.大森地域庁舎,6,1,7,35.578239,139.723262,2024-02-08 15:15:03
744,C5-46.ウエリスアーバン品川タワー,1,5,6,35.630961,139.746875,2024-02-08 15:15:03
745,C4-13.コシダコネクトビル,0,15,15,35.637765,139.739128,2024-02-08 15:15:03
746,K1-127.第二石井ビル,3,1,4,35.559286,139.722611,2024-02-08 15:15:03
747,C1-74.札の辻スクエア,6,2,8,35.645155,139.744543,2024-02-08 15:15:03
748,H1-164.森下三丁目第三児童遊園,5,13,18,35.68546,139.80244,2024-02-08 15:15:03
749,C1-78.CIRCLES新橋,9,0,9,35.66646,139.752138,2024-02-08 15:15:03
750,C3-34.3rd MINAMI AOYAMA,5,0,5,35.668622,139.715957,2024-02-08 15:15:03
751,O4-06.杉並区役所本庁舎,2,3,5,35.699328,139.636343,2024-02-08 15:15:03
752,D3-14.コーシャハイム高田馬場,6,0,6,35.712413,139.70168,2024-02-08 15:15:03
753,D7-11.新宿清掃事務所,2,4,6,35.716359,139.704377,2024-02-08 15:15:03
754,D5-08.ウエリス新宿早稲田の森,0,8,8,35.704597,139.708397,2024-02-08 15:15:03
755,E2-12.水道2丁目,0,19,19,35.709147,139.739183,2024-02-08 15:15:03
756,M6-10.京王コインパーク幡ヶ谷,0,10,10,35.6772,139.678117,2024-02-08 15:15:03
757,E3-05.文京スポーツセンター,44,16,60,35.721045,139.735687,2024-02-08 15:15:03
758,J1-36.WJ Haus,0,6,6,35.629067,139.711779,2024-02-08 15:15:03
759,K1-51.テクノポートカマタ 第2,11,0,11,35.555808,139.722791,2024-02-08 15:15:03
760,D1-13.新宿御苑新宿門【西側】,0,23,23,35.688945,139.706536,2024-02-08 15:15:03
761,I1-31.セブン-イレブン 品川戸越5丁目店,3,3,6,35.608193,139.719139,2024-02-08 15:15:03
762,T3-27.貫井川緑地,1,3,4,35.738427,139.632251,2024-02-08 15:15:03
763,H1-147.大島四丁目団地,14,2,16,35.68744,139.827075,2024-02-08 15:15:03
764,O4-02.成宗さくら公園,2,0,2,35.69638,139.63482,2024-02-08 15:15:03
765,O1-01.上瀬戸公園,2,2,4,35.72077,139.6045,2024-02-08 15:15:03
766,T2-15.NPC24H大泉学園南口パーキング,8,2,10,35.748611,139.584251,2024-02-08 15:15:03
767,O3-03.桃井1丁目5番地,7,0,7,35.71013,139.61194,2024-02-08 15:15:03
768,H1-08.東京テレポート駅,0,46,46,35.627087,139.779779,2024-02-08 15:15:03
769,H1-05.相鉄グランドフレッサ 東京ベイ有明,13,1,14,35.632148,139.79017,2024-02-08 15:15:03
770,H1-06.武蔵野大学,0,16,16,35.630185,139.786618,2024-02-08 15:15:03
771,A4-15.TOKIWAブリッジ,3,6,9,35.686389,139.769237,2024-02-08 15:15:03
772,H1-160.花の広場,8,9,17,35.633908,139.793322,2024-02-08 15:15:03
773,H1-01.豊洲ＩＨＩビル前（晴海通り）,10,0,10,35.658911,139.792531,2024-02-08 15:15:03
774,H1-02.豊洲駅,0,22,22,35.654196,139.79626,2024-02-08 15:15:03
775,J1-19.NTT東日本自由が丘ビル,3,1,4,35.615098,139.675954,2024-02-08 15:15:03
776,C2-19.広尾駅,5,0,5,35.650732,139.72256,2024-02-08 15:15:03
777,H1-114.東京夢の島マリーナ,5,9,14,35.651987,139.830691,2024-02-08 15:15:03
778,K1-71.ファミリーマート大田大森南店,0,6,6,35.562769,139.74327,2024-02-08 15:15:03
779,J1-20.すずめのお宿緑地公園,2,7,9,35.617773,139.685351,2024-02-08 15:15:03
780,H1-115.東京夢の島マリーナ 第4駐車場,2,12,14,35.650235,139.835993,2024-02-08 15:15:03
781,M5-10.富ヶ谷2丁目,16,1,17,35.665961,139.686491,2024-02-08 15:15:03
782,J1-21.中央緑地公園,0,6,6,35.630694,139.690482,2024-02-08 15:15:03
783,H1-116.出会い橋高架下,27,22,49,35.625037,139.777646,2024-02-08 15:15:03
784,M3-12.渋谷南東急ビル,6,0,6,35.656228,139.706284,2024-02-08 15:15:03
785,T2-01.大泉学園駅北口,3,1,4,35.749918,139.58618,2024-02-08 15:15:03
786,K1-06.大森駅入新井自転車駐車場,6,0,6,35.585269,139.726279,2024-02-08 15:15:03
787,D6-06.新宿中央公園（エコギャラリー下）,0,15,15,35.691199,139.687966,2024-02-08 15:15:03
788,D6-14.新宿ファーストウエスト,9,5,14,35.689529,139.695995,2024-02-08 15:15:03
789,D6-15.住友不動産西新宿ビル,10,1,11,35.69465,139.695911,2024-02-08 15:15:03
790,H1-56.南砂三丁目緑地公園西,0,26,26,35.672361,139.829825,2024-02-08 15:15:03
791,T2-74.扇橋公園,2,3,5,35.731791,139.588844,2024-02-08 15:15:03
792,B2-20.SHビル,3,0,3,35.675398,139.779962,2024-02-08 15:15:03
793,I1-17.東品川海上公園第2,0,12,12,35.616364,139.749171,2024-02-08 15:15:03
794,I1-16.品川浦,14,0,14,35.6214,139.741958,2024-02-08 15:15:03
795,A4-11.二重橋前駅(メトロ4番出口),5,0,5,35.680753,139.762069,2024-02-08 15:15:03
796,H1-76.有明物流センター,6,10,16,35.638571,139.78829,2024-02-08 15:15:03
797,K1-43.北馬込わくわく公園,0,12,12,35.600707,139.703216,2024-02-08 15:15:03
798,K1-42.馬込西公園,11,3,14,35.58849,139.70376,2024-02-08 15:15:03
799,T1-08.セブン-イレブン 練馬高松6丁目店,4,0,4,35.756506,139.620347,2024-02-08 15:15:03
800,T2-17.ファミリーマート 練馬石神井町八丁目店,0,4,4,35.74755,139.597968,2024-02-08 15:15:03
801,K1-31.テクノWING,0,10,10,35.546252,139.731708,2024-02-08 15:15:03
802,K1-32.石川町文化センター,5,0,5,35.601958,139.682876,2024-02-08 15:15:03
803,I1-20.しおじ公園,14,6,20,35.59632,139.751279,2024-02-08 15:15:03
804,I1-19.品川シーサイド公園第2,7,0,7,35.607571,139.749108,2024-02-08 15:15:03
805,J1-29.カスタリア目黒鷹番,2,3,5,35.626121,139.688576,2024-02-08 15:15:03
806,H1-127.古石場川親水公園,0,33,33,35.669291,139.795364,2024-02-08 15:15:03
807,D4-05.カスタリア新宿7丁目,0,14,14,35.700732,139.711472,2024-02-08 15:15:03
808,I1-71.セブン-イレブン南大井浜川店,0,1,1,35.596483,139.7355,2024-02-08 15:15:03
809,I1-72.セブン-イレブン大井店,0,12,12,35.600081,139.728193,2024-02-08 15:15:03
810,T3-21.くまのやま緑地,4,1,5,35.747038,139.667965,2024-02-08 15:15:03
811,K1-110.萩中集会所裏,8,6,14,35.550479,139.739538,2024-02-08 15:15:03
812,O2-02.シエール荻窪,30,0,30,35.708265,139.612703,2024-02-08 15:15:03
813,H1-128.豊洲市場（5街区）,23,11,34,35.645162,139.785386,2024-02-08 15:15:03
814,N1-09.若宮レジデンス,2,3,5,35.716184,139.643905,2024-02-08 15:15:03
815,M6-12.LIVART SEASON 幡ヶ谷,0,12,12,35.683156,139.67338,2024-02-08 15:15:03
816,H1-142.東京ベイ潮見プリンスホテル,0,13,13,35.660632,139.817294,2024-02-08 15:15:03
817,G1-01.鐘ヶ淵駅南自転車駐車場,1,8,9,35.732291,139.82012,2024-02-08 15:15:03
818,M1-01.渋谷区役所,7,1,8,35.66362,139.69801,2024-02-08 15:15:03
819,I1-83.かもめ歩道橋,0,22,22,35.600161,139.749902,2024-02-08 15:15:03
820,N4-05.セブン-イレブン中野鍋横店,3,2,5,35.693815,139.668571,2024-02-08 15:15:03
821,D4-02.JICA市ヶ谷ビル（地球ひろば／研究所）,6,0,6,35.694927,139.731328,2024-02-08 15:15:03
822,T3-19.なかみや児童遊園,1,4,5,35.749388,139.651824,2024-02-08 15:15:03
823,N1-08.上鷺自転車保管場所,2,5,7,35.729056,139.627864,2024-02-08 15:15:03
824,O7-06.松木1丁目,2,11,13,35.686015,139.642784,2024-02-08 15:15:03
825,E4-16.ビレッジワン,2,4,6,35.723723,139.740143,2024-02-08 15:15:03
826,D1-15.フロンティア四谷,1,7,8,35.68768,139.71937,2024-02-08 15:15:03
827,K1-128.大森西3丁目,8,4,12,35.571975,139.732137,2024-02-08 15:15:03
828,N1-06.大和区民活動センター,1,4,5,35.713562,139.649075,2024-02-08 15:15:03
829,G4-01.両国ビューホテル1,0,7,7,35.69566,139.79214,2024-02-08 15:15:03
830,G4-02.両国ビューホテル2,1,7,8,35.69562,139.79206,2024-02-08 15:15:03
831,G4-05.両国駅西口臨時自転車駐車場,18,2,20,35.698588,139.792946,2024-02-08 15:15:03
832,G4-03.本所1-6-5,9,5,14,35.702525,139.796632,2024-02-08 15:15:03
833,G5-01.牡丹橋自転車駐車場,15,1,16,35.693059,139.813417,2024-02-08 15:15:03
834,G5-02.横川3-7-10,18,19,37,35.70378,139.814298,2024-02-08 15:15:03
835,G4-04.NTTドコモ墨田ビル,14,7,21,35.697898,139.795345,2024-02-08 15:15:03
836,G2-02.押上1-23-8,1,7,8,35.710111,139.81488,2024-02-08 15:15:03
837,C5-13.区立芝浦西運河沿緑地,20,13,33,35.638245,139.749754,2024-02-08 15:15:03
838,D6-12.東京ビジネスホテル,0,4,4,35.69342,139.710568,2024-02-08 15:15:03
839,D6-11.ホテルリステル新宿,0,3,3,35.693029,139.711327,2024-02-08 15:15:03
840,D6-10.ホテルサンライト新宿,1,1,2,35.694201,139.707047,2024-02-08 15:15:03
841,H1-39.辰巳駅東口自転車駐車場,21,4,25,35.645823,139.812178,2024-02-08 15:15:03
842,H1-38.辰巳駅西口自転車駐車場,89,0,89,35.646857,139.808912,2024-02-08 15:15:03
843,C2-10.元麻布三丁目,0,7,7,35.655865,139.730566,2024-02-08 15:15:03
844,C2-09.麻布地区総合支所,0,2,2,35.660614,139.734771,2024-02-08 15:15:03
845,M3-20.東急ステイ渋谷新南口,8,0,8,35.65494,139.70534,2024-02-08 15:15:03
846,I1-86.ファミリーマート二葉三丁目店,0,2,2,35.601694,139.719778,2024-02-08 15:15:03
847,A2-23.axle御茶ノ水,7,0,7,35.696126,139.763297,2024-02-08 15:15:03
848,C4-02.白金台いきいきプラザ,4,1,5,35.63756,139.724981,2024-02-08 15:15:03
849,N3-04.東中野駅地下駐輪場,0,22,22,35.707883,139.683284,2024-02-08 15:15:03
850,N3-05.中野坂上駅地下駐輪場,0,6,6,35.698068,139.682781,2024-02-08 15:15:03
851,N3-03.青桐公園,0,14,14,35.697024,139.677846,2024-02-08 15:15:03
852,N3-01.中野四季の森公園,7,3,10,35.708487,139.662135,2024-02-08 15:15:03
853,N4-01.本四公園,1,8,9,35.69693,139.672721,2024-02-08 15:15:03
854,N4-02.栄町公園,0,7,7,35.686474,139.671383,2024-02-08 15:15:03
855,K1-57.池上本門寺,5,1,6,35.579585,139.705377,2024-02-08 15:15:03
856,C1-49.汐留シティセンター,13,0,13,35.666213,139.760907,2024-02-08 15:15:03
857,C4-15.クロスレジデンス白金高輪,0,14,14,35.642771,139.733046,2024-02-08 15:15:03
858,K1-56.NTT馬込ビル,0,7,7,35.588106,139.718852,2024-02-08 15:15:03
859,J1-41.CASSIA目黒,2,3,5,35.631319,139.70237,2024-02-08 15:15:03
860,A2-22.専修大学,5,1,6,35.696147,139.753709,2024-02-08 15:15:03
861,T3-20.はやいち公園,2,2,4,35.75312,139.65661,2024-02-08 15:15:03
862,B3-19.本の森ちゅうおう,7,1,8,35.67363,139.77623,2024-02-08 15:15:03
863,K1-86.IMPREST STAY TOKYO 蒲田,21,1,22,35.556267,139.727246,2024-02-08 15:15:03
864,T3-23.氷川台二丁目緑地,3,1,4,35.756575,139.669689,2024-02-08 15:15:03
865,T3-22.氷川台三丁目ちびっこ公園,1,2,3,35.750547,139.66707,2024-02-08 15:15:03
866,B1-23.NANAEI日本橋,3,1,4,35.679616,139.784341,2024-02-08 15:15:03
867,B2-11.京橋エドグラン,11,1,12,35.677576,139.769822,2024-02-08 15:15:03
868,N1-05.大野ハイツ,1,4,5,35.7266,139.62948,2024-02-08 15:15:03
869,B2-09.茅場町一丁目平和ビル,8,2,10,35.680203,139.778679,2024-02-08 15:15:03
870,B2-08.共同ビル（茅場町交差点前）,7,2,9,35.681012,139.778569,2024-02-08 15:15:03
871,B2-07.東京証券会館（北側）,0,1,1,35.680864,139.779331,2024-02-08 15:15:03
872,O3-12.大宮前体育館,0,3,3,35.696567,139.610517,2024-02-08 15:15:03
873,B1-08.明治座,0,20,20,35.688038,139.786561,2024-02-08 15:15:03
874,B4-05.ドコモ・バイクシェア晴海ポート,0,30,30,35.654165,139.781568,2024-02-08 15:15:03
875,B4-04.ＫＤＸ晴海ビル,0,0,0,35.65443,139.77843,2024-02-08 15:15:03
876,B4-03.桜の散歩道（晴海トリトンスクエア前）,8,7,15,35.658665,139.782553,2024-02-08 15:15:03
877,E5-08.セブン-イレブン 文京動坂上店,3,1,4,35.727778,139.756296,2024-02-08 15:15:03
878,H1-65.ローソン南砂日曹橋店,14,0,14,35.669507,139.825553,2024-02-08 15:15:03
879,H1-66.中川船番所資料館,1,5,6,35.687732,139.846383,2024-02-08 15:15:03
880,K1-113.ファミリーマート大田上池台四丁目店,0,7,7,35.594658,139.700133,2024-02-08 15:15:03
881,H1-64.ローソン東雲駅前店,9,1,10,35.640228,139.804267,2024-02-08 15:15:03
882,E1-11.小石川運動場前,12,3,15,35.703914,139.747061,2024-02-08 15:15:03
883,T2-70.三ツ塚けやき緑地,2,2,4,35.720318,139.570762,2024-02-08 15:15:03
884,H1-137.住友不動産ショッピングシティ有明ガーデン,19,0,19,35.638985,139.793653,2024-02-08 15:15:03
885,C5-40.芝浦ふ頭駅前暫定自転車駐車場,2,2,4,35.64096,139.75754,2024-02-08 15:15:03
886,M3-21.渋谷ソラスタ,10,2,12,35.65618,139.69612,2024-02-08 15:15:03
887,D7-03.中井駅北,19,12,31,35.715645,139.687486,2024-02-08 15:15:03
888,K1-119.シーンズ大森パークサイド,4,0,4,35.58223,139.72763,2024-02-08 15:15:03
889,M6-15.cova Hatagaya,0,2,2,35.67741,139.67383,2024-02-08 15:15:03
890,C2-25.アパホテル＆リゾート＜六本木駅東＞,37,6,43,35.661783,139.737242,2024-02-08 15:15:03
891,D4-10.東新宿ポート(余丁町6番),1,4,5,35.696585,139.713081,2024-02-08 15:15:03
892,O1-02.井荻南地下自転車駐車場,6,8,14,35.72424,139.61431,2024-02-08 15:15:03
893,O1-03.LUCKY HOUSE,1,3,4,35.72489,139.62383,2024-02-08 15:15:03
894,D6-30.京王プラザホテル,7,0,7,35.6897,139.694823,2024-02-08 15:15:03
895,D6-29.都庁第二本庁舎前,12,1,13,35.688735,139.692249,2024-02-08 15:15:03
896,O3-02.アートメゾン荻窪,6,2,8,35.71355,139.6199,2024-02-08 15:15:03
897,J1-57.トレインチ自由が丘,4,1,5,35.606667,139.667324,2024-02-08 15:15:03
898,O2-01.サカエフラット荻窪,10,1,11,35.70535,139.61497,2024-02-08 15:15:03
899,O3-01.西田公園,2,5,7,35.69575,139.62065,2024-02-08 15:15:03
900,K1-47.NTT雪ヶ谷ビル,8,3,11,35.598601,139.684747,2024-02-08 15:15:03
901,O7-04.永福町西幸モータープール西,7,1,8,35.67161,139.64527,2024-02-08 15:15:03
902,K1-48.ファミリーマート大田上池台三丁目店,0,16,16,35.590934,139.696915,2024-02-08 15:15:03
903,K1-111.本羽田公園,5,1,6,35.546499,139.736761,2024-02-08 15:15:03
904,C1-58.ウォーターズ竹芝,3,7,10,35.655937,139.763251,2024-02-08 15:15:03
905,K1-109.萩中公園プール駐輪場,8,0,8,35.549323,139.737091,2024-02-08 15:15:03
906,K1-108.仲江名公園,3,1,4,35.557999,139.732564,2024-02-08 15:15:03
907,E1-17.小石川パークスクエア,1,2,3,35.713913,139.745416,2024-02-08 15:15:03
908,D6-23.アパホテル 東新宿 歌舞伎町西,1,1,2,35.697535,139.703633,2024-02-08 15:15:03
909,H1-98.洲崎川緑道公園,0,29,29,35.668705,139.810549,2024-02-08 15:15:03
910,H1-99.南砂三丁目公園,19,5,24,35.669695,139.831874,2024-02-08 15:15:03
911,H1-96.越中島公園,0,19,19,35.668757,139.790156,2024-02-08 15:15:03
912,H1-97.浜園公園,0,13,13,35.661852,139.802224,2024-02-08 15:15:03
913,H1-94.新木場一丁目緑地公園,4,5,9,35.64423,139.835823,2024-02-08 15:15:03
914,H1-95.若洲公園,5,19,24,35.619451,139.834429,2024-02-08 15:15:03
915,J1-09.ファミリーマート佐野久下目黒店,3,0,3,35.629252,139.712716,2024-02-08 15:15:03
916,H1-93.新木場一丁目公園,2,5,7,35.64143,139.835455,2024-02-08 15:15:03
917,I1-55.鈴ヶ森公園,0,10,10,35.593559,139.734704,2024-02-08 15:15:03
918,O6-04.柏の宮公園,1,4,5,35.67834,139.62711,2024-02-08 15:15:03
919,B4-14.Brillia ist Tower 勝どき,0,11,11,35.660526,139.776816,2024-02-08 15:15:03
920,D7-08.上落合3丁目,2,11,13,35.71115,139.68232,2024-02-08 15:15:03
921,H1-21.UR東雲キャナルコート,0,66,66,35.646041,139.804495,2024-02-08 15:15:03
922,H1-20.日本科学未来館,23,7,30,35.619377,139.777582,2024-02-08 15:15:03
923,H1-19.UR豊洲四丁目団地,19,0,19,35.653603,139.80144,2024-02-08 15:15:03
924,T2-45.風致地区バス停第三自転車駐車場,2,5,7,35.771068,139.586798,2024-02-08 15:15:03
925,H1-33.深川ギャザリア（ウエストスクエア）,0,24,24,35.66789,139.803,2024-02-08 15:15:03
926,H1-32.区営塩浜住宅前,0,18,18,35.664591,139.813954,2024-02-08 15:15:03
927,H1-23.KDX豊洲グランスクエア,11,0,11,35.648085,139.798986,2024-02-08 15:15:03
928,C2-22.飯倉公園,9,1,10,35.655649,139.74427,2024-02-08 15:15:03
929,I1-89.下神明駅自転車駐車場,5,0,5,35.608402,139.726118,2024-02-08 15:15:03
930,C5-39.お台場海浜公園東,11,0,11,35.631021,139.778109,2024-02-08 15:15:03
931,C5-38.お台場海浜公園乗船場,0,17,17,35.628743,139.773915,2024-02-08 15:15:03
932,O4-08.ローソン阿佐ヶ谷青梅街道店,0,5,5,35.703203,139.62804,2024-02-08 15:15:03
933,T2-72.高塚南緑地,5,1,6,35.733132,139.570311,2024-02-08 15:15:03
934,O6-03.みなみ荘,6,4,10,35.68073,139.62803,2024-02-08 15:15:03
935,K1-129.ローソン東糀谷一丁目店,0,8,8,35.557427,139.739126,2024-02-08 15:15:03
936,E1-03.東京ドーム（黄色いビル横）,8,0,8,35.70319,139.751888,2024-02-08 15:15:03
937,K1-23.大田区役所本庁舎前,5,0,5,35.561183,139.716339,2024-02-08 15:15:03
938,T2-78.北大泉くれはし公園,2,1,3,35.761474,139.592735,2024-02-08 15:15:03
939,J1-53.ボヌールAllamanda,3,2,5,35.612833,139.675047,2024-02-08 15:15:03
940,A3-39.トーシン東神田ビル,0,4,4,35.694834,139.780333,2024-02-08 15:15:03
941,O6-01.高井戸みどり公園,5,4,9,35.67912,139.61074,2024-02-08 15:15:03
942,T2-79.大泉学園町八丁目緑地,4,2,6,35.774457,139.596182,2024-02-08 15:15:03
943,O5-04.リヴィエール,16,4,20,35.70104,139.65839,2024-02-08 15:15:03
944,N3-08.中野区役所(西側),4,2,6,35.707968,139.663519,2024-02-08 15:15:03
945,I1-99.北品川２丁目,6,0,6,35.61663,139.74192,2024-02-08 15:15:03
946,P1-01.サンシャインシティ,5,1,6,35.728846,139.718577,2024-02-08 15:15:03
947,N3-14.ヴィラソンサ落合,0,7,7,35.713227,139.680966,2024-02-08 15:15:03
948,H1-49.セブン-イレブン 江東新砂３丁目店,0,21,21,35.667892,139.8311,2024-02-08 15:15:03
949,I1-06.大森貝塚遺跡庭園,9,0,9,35.593489,139.72967,2024-02-08 15:15:03
950,M2-12.恵比寿プライムスクエアタワー北,8,0,8,35.650541,139.713361,2024-02-08 15:15:03
951,H1-69.ファミリーマート 江東石島店,0,29,29,35.680474,139.812316,2024-02-08 15:15:03
952,B3-09.築地永谷コーポラス,3,8,11,35.66523,139.776313,2024-02-08 15:15:03
953,E4-10.白山四丁目第二児童遊園横,6,5,11,35.720349,139.746924,2024-02-08 15:15:03
954,I1-03.大井町駅中央口（西側）,6,1,7,35.605617,139.73472,2024-02-08 15:15:03
955,I1-04.大井町歩道橋,4,0,4,35.605146,139.734694,2024-02-08 15:15:03
956,I1-01.品川区役所 本庁舎前,10,0,10,35.609052,139.729825,2024-02-08 15:15:03
957,I1-02.品川区役所 第三庁舎前,9,0,9,35.608161,139.730048,2024-02-08 15:15:03
958,G4-08.ブオンサンヴァレンティーノ,2,2,4,35.691677,139.793857,2024-02-08 15:15:03
959,J1-13.洗足二丁目駐輪場,12,5,17,35.61061,139.693443,2024-02-08 15:15:03
960,J1-16.八雲橋自転車置場,2,4,6,35.617353,139.672256,2024-02-08 15:15:03
961,H1-189.MFLP新木場2,0,37,37,35.634453,139.824,2024-02-08 15:15:03
962,M6-09.ファミリーマート渋谷本町店,0,11,11,35.683756,139.684965,2024-02-08 15:15:03
963,H1-113.123+N東雲店,0,27,27,35.646366,139.801492,2024-02-08 15:15:03
964,J1-17.ファミリーマート原町二丁目店,0,6,6,35.613902,139.691476,2024-02-08 15:15:03
965,E5-21.動坂公園,3,7,10,35.73176,139.756669,2024-02-08 15:15:03
966,E5-20.本郷2丁目,0,7,7,35.704391,139.758575,2024-02-08 15:15:03
967,T2-48.武蔵関駅南第二自転車駐車場,3,1,4,35.726064,139.578015,2024-02-08 15:15:03
968,A6-26.相互半蔵門ビル,8,1,9,35.683378,139.743189,2024-02-08 15:15:03
969,J1-31.守屋図書館,12,8,20,35.634194,139.688833,2024-02-08 15:15:03
970,M3-19.渋谷キャスト,21,0,21,35.662146,139.702793,2024-02-08 15:15:03
971,N1-04.都立家政南駐輪場,0,10,10,35.721679,139.645265,2024-02-08 15:15:03
972,N2-02.江古田1丁目A,1,2,3,35.724988,139.672511,2024-02-08 15:15:03
973,C1-56.鈴与竹芝ビル,2,3,5,35.654873,139.762103,2024-02-08 15:15:03
974,D3-07.戸塚特別出張所,5,1,6,35.71429,139.70507,2024-02-08 15:15:03
975,G4-12.プレミアムキューブ両国,3,3,6,35.70103,139.803341,2024-02-08 15:15:03
976,A2-21.神田神保町3丁目,7,0,7,35.694578,139.754434,2024-02-08 15:15:03
977,B4-19.コーシャタワー佃,0,20,20,35.668044,139.785801,2024-02-08 15:15:03
978,I1-81.戸越6丁目,17,1,18,35.608127,139.717865,2024-02-08 15:15:03
979,A6-24.国立劇場,0,15,15,35.682218,139.743292,2024-02-08 15:15:03
980,E5-23.ビレッジ千駄木,0,6,6,35.722353,139.760966,2024-02-08 15:15:03
981,H1-119.榎戸材木店,0,18,18,35.638319,139.834741,2024-02-08 15:15:03
982,C5-29.Hi-NODE(ハイノード),7,1,8,35.651672,139.760549,2024-02-08 15:15:03
983,J1-22.NTTコミュニケーションズ唐ヶ崎ビル,0,5,5,35.627373,139.692044,2024-02-08 15:15:03
984,A2-18.猿楽町SSビル東,5,1,6,35.698654,139.759762,2024-02-08 15:15:03
985,A2-19.猿楽町SSビル西,2,0,2,35.698641,139.759306,2024-02-08 15:15:03
986,C1-55.アーバンネット内幸町ビル,19,1,20,35.669267,139.756018,2024-02-08 15:15:03
987,D4-06.グリーンフォート河田,0,11,11,35.697143,139.718739,2024-02-08 15:15:03
988,K1-134.東調布公園,3,7,10,35.588363,139.69042,2024-02-08 15:15:03
989,M5-18.Luxe初台,1,4,5,35.679182,139.68596,2024-02-08 15:15:03
990,D7-06.エムアイセミナーハウス,3,0,3,35.721064,139.677128,2024-02-08 15:15:03
991,A3-37.ポータル秋葉原,0,18,18,35.695737,139.78162,2024-02-08 15:15:03
992,M5-11.あおい通り,8,0,8,35.688154,139.698975,2024-02-08 15:15:03
993,E5-04.保健サービスセンター本郷支所,0,5,5,35.727046,139.760439,2024-02-08 15:15:03
994,E5-03.汐見地域活動センター（本郷図書館）,0,5,5,35.725538,139.76116,2024-02-08 15:15:03
995,E5-01.文京総合体育館,30,1,31,35.708121,139.763583,2024-02-08 15:15:03
996,E4-01.千石南自転車駐車場,7,18,25,35.72707,139.746112,2024-02-08 15:15:03
997,E3-03.大塚公園,2,19,21,35.724286,139.730954,2024-02-08 15:15:03
998,E3-02.教育の森公園,4,13,17,35.719345,139.736198,2024-02-08 15:15:03
999,I1-25.セブン-イレブン 品川旗の台2丁目店,0,3,3,35.607084,139.705007,2024-02-08 15:15:03
1000,B1-21.日本橋二丁目街角広場,4,6,10,35.680861,139.774493,2024-02-08 15:15:03
1001,C3-30.東京赤坂NKビル (ヴィアインプライム赤坂),8,1,9,35.672652,139.738908,2024-02-08 15:15:03
1002,A3-36.クロックカフェ東神田,0,5,5,35.694943,139.782718,2024-02-08 15:15:03
1003,E1-14.いきいき礫川,1,6,7,35.711147,139.747386,2024-02-08 15:15:03
1004,D4-09.トミンハイム仲之町,0,15,15,35.69617,139.722021,2024-02-08 15:15:03
1005,L1-08.NTT砧ビル,1,5,6,35.63534,139.601602,2024-02-08 15:15:03
1006,L1-09.コージーK・駒沢,2,1,3,35.632689,139.654804,2024-02-08 15:15:03
1007,L1-10.宮坂2-4-10,0,7,7,35.652913,139.644825,2024-02-08 15:15:03
1008,I1-22.ウィラ大井 (ショッピングモール),0,5,5,35.596579,139.745009,2024-02-08 15:15:03
1009,K1-76.グリーンベルト,8,0,8,35.585178,139.726339,2024-02-08 15:15:03
1010,H1-121.南砂5丁目,0,35,35,35.676603,139.829736,2024-02-08 15:15:03
1011,M3-02.文化総合センター大和田,5,0,5,35.65558,139.69966,2024-02-08 15:15:03
1012,D4-04.ジェノヴィア新宿早稲田グリーンヴェール,3,1,4,35.700033,139.71983,2024-02-08 15:15:03
1013,A3-20.神田ふれあい通り第２,0,2,2,35.695005,139.772747,2024-02-08 15:15:03
1014,H1-120.豊洲5丁目,16,0,16,35.650948,139.799711,2024-02-08 15:15:03
1015,C5-42.DHC芝浦2丁目ビル,4,0,4,35.644241,139.753834,2024-02-08 15:15:03
1016,I1-65.セブン-イレブン品川東大井1丁目店,7,0,7,35.605996,139.743037,2024-02-08 15:15:03
1017,M2-04.広尾東公園,5,1,6,35.653382,139.721059,2024-02-08 15:15:03
1018,M3-13.渋谷駅東口地下駐輪場,18,1,19,35.657682,139.703307,2024-02-08 15:15:03
1019,A3-19.神田ふれあい通り第１,0,5,5,35.694904,139.772712,2024-02-08 15:15:03
1020,O6-07.ローソン杉並宮前一丁目店,2,3,5,35.689639,139.613516,2024-02-08 15:15:03
1021,T3-10.貫井一丁目緑地,0,3,3,35.736378,139.632485,2024-02-08 15:15:03
1022,M2-05.日本赤十字医療センター,3,7,10,35.65519,139.718559,2024-02-08 15:15:03
1023,T2-20.パークサイド石神井,0,9,9,35.741769,139.591103,2024-02-08 15:15:03
1024,N4-06.ローソン中野本町新橋通り店,0,5,5,35.695819,139.674326,2024-02-08 15:15:03
1025,T3-07.徳殿公園,3,1,4,35.726728,139.65874,2024-02-08 15:15:03
1026,K1-35.セブン-イレブン 大田区西六郷2丁目店,0,12,12,35.549778,139.707362,2024-02-08 15:15:03
1027,A3-27.秋葉原駅中央口（ヨドバシカメラ前）,7,3,10,35.698986,139.774099,2024-02-08 15:15:03
1028,A3-28.秋葉原駅電気街口(西側交通広場),4,1,5,35.699173,139.772629,2024-02-08 15:15:03
1029,H1-57.新木場駅,34,21,55,35.64508,139.826456,2024-02-08 15:15:03
1030,H1-58.潮見駅,0,32,32,35.658703,139.817251,2024-02-08 15:15:03
1031,D7-02.セブン-イレブン 新宿中落合3丁目店,0,15,15,35.722202,139.691712,2024-02-08 15:15:03
1032,D2-06.飯田濠,10,4,14,35.70057,139.74301,2024-02-08 15:15:03
1033,C5-17.鈴与浜松町ビル,4,6,10,35.651103,139.759092,2024-02-08 15:15:03
1034,H1-59.LYURO 東京清澄,0,22,22,35.681316,139.792176,2024-02-08 15:15:03
1035,H1-60.荒川・砂町庭球場西,0,31,31,35.679678,139.844892,2024-02-08 15:15:03
1036,K1-44.中馬込貝塚公園,1,4,5,35.594795,139.704951,2024-02-08 15:15:03
1037,M6-11.京王サイクルパーク笹塚,0,6,6,35.674337,139.668801,2024-02-08 15:15:03
1038,J1-49.伊勢脇公園,3,1,4,35.638864,139.696568,2024-02-08 15:15:03
1039,K1-45.たぬき山公園,3,4,7,35.592801,139.715472,2024-02-08 15:15:03
1040,D2-01.あずさセンタービル,12,6,18,35.702286,139.741093,2024-02-08 15:15:03
1041,C1-02.西新橋1丁目（外堀通り）,5,1,6,35.668791,139.753582,2024-02-08 15:15:03
1042,O3-07.NTT井草ビル第1ポート,2,1,3,35.714044,139.61688,2024-02-08 15:15:03
1043,T2-41.ローソン 練馬東大泉五丁目店,0,4,4,35.74248,139.58715,2024-02-08 15:15:03
1044,H1-144.南砂住宅,0,15,15,35.674199,139.822018,2024-02-08 15:15:03
1045,C3-28.ヒューリックＪＰ赤坂ビル,10,1,11,35.672477,139.739743,2024-02-08 15:15:03
1046,H1-145.東雲都橋住宅,0,6,6,35.643131,139.797784,2024-02-08 15:15:03
1047,I1-58.品川区役所　第二庁舎前,18,0,18,35.609664,139.730006,2024-02-08 15:15:03
1048,K1-92.蒲田駅西口自転車駐車場,24,0,24,35.561101,139.715173,2024-02-08 15:15:03
1049,A2-24.水道橋駅西口前,6,0,6,35.702271,139.752619,2024-02-08 15:15:03
1050,K1-94.昭和島駅前,0,27,27,35.572188,139.749613,2024-02-08 15:15:03
1051,M5-15.新宿マインズタワー,16,4,20,35.686567,139.699355,2024-02-08 15:15:03
1052,D7-13.日本光電本社南側,11,4,15,35.71936,139.679083,2024-02-08 15:15:03
1053,N3-09.中野区役所(北側),3,2,5,35.708259,139.663829,2024-02-08 15:15:03
1054,H1-163.森下公園,2,2,4,35.68663,139.799529,2024-02-08 15:15:03
1055,B4-23.交通広場（豊海町）,0,11,11,35.653771,139.769295,2024-02-08 15:15:03
1056,D6-18.ヨドバシカメラ 新宿西口本店前,0,8,8,35.689689,139.698231,2024-02-08 15:15:03
1057,I1-47.NTT 東日本 関東病院(南側),6,1,7,35.630151,139.725215,2024-02-08 15:15:03
1058,H1-112.ファミリーマート江東塩浜二丁目店,3,0,3,35.66305,139.8087,2024-02-08 15:15:03
1059,K1-103.雪谷特別出張所,0,7,7,35.594515,139.691219,2024-02-08 15:15:03
1060,E5-17.Village藍染,0,5,5,35.720896,139.76422,2024-02-08 15:15:03
1061,I1-49.京急鮫洲バイク駐輪場,6,0,6,35.603815,139.741362,2024-02-08 15:15:03
1062,I1-50.京急立会川第2バイク駐輪場,0,4,4,35.599196,139.739158,2024-02-08 15:15:03
1063,E4-14.NTT東日本大塚ビル,0,17,17,35.726188,139.741375,2024-02-08 15:15:03
1064,M2-07.ファミリーマート恵比寿駅東店,7,0,7,35.6471,139.712818,2024-02-08 15:15:03
1065,M4-07.千駄ヶ谷駅前,3,0,3,35.68082,139.71188,2024-02-08 15:15:03
1066,O5-07.バーンホーフ キクチ,11,9,20,35.698169,139.655665,2024-02-08 15:15:03
1067,J1-11.コンフォリア目黒青葉台,0,6,6,35.649023,139.696086,2024-02-08 15:15:03
1068,L1-14.給田3丁目,0,13,13,35.664335,139.590114,2024-02-08 15:15:03
1069,B4-06.月島駅地下駐輪場,2,14,16,35.66291,139.782564,2024-02-08 15:15:03
1070,C5-09.グランパーク,20,1,21,35.643202,139.746244,2024-02-08 15:15:03
1071,C5-08.AQUACITY芝浦,4,5,9,35.637366,139.74844,2024-02-08 15:15:03
1072,C3-08.赤坂パークビルヂング,5,0,5,35.671792,139.733668,2024-02-08 15:15:03
1073,C3-07.新青山ビル,16,2,18,35.672659,139.725644,2024-02-08 15:15:03
1074,C3-06.ホテルアジア会館,0,10,10,35.67064,139.728166,2024-02-08 15:15:03
1075,C1-24.三田国際ビル,0,11,11,35.653159,139.744673,2024-02-08 15:15:03
1076,C5-07.港区立港南図書館,0,12,12,35.632842,139.7495,2024-02-08 15:15:03
1077,A3-04.秋葉原公園,0,20,20,35.697642,139.774867,2024-02-08 15:15:03
1078,A3-05.和泉公園（西側入口）,3,3,6,35.698817,139.778898,2024-02-08 15:15:03
1079,A3-02.絶滅メディア博物館（楓ビル）,8,0,8,35.689575,139.767848,2024-02-08 15:15:03
1080,O3-10.メゾンパークス,5,3,8,35.716265,139.618954,2024-02-08 15:15:03
1081,A2-05.神田橋公園,0,2,2,35.689665,139.764091,2024-02-08 15:15:03
1082,A3-01.神田児童公園（西側交番横）,5,1,6,35.692983,139.76773,2024-02-08 15:15:03
1083,A2-03.西神田公園（西側）,4,1,5,35.698338,139.754876,2024-02-08 15:15:03
1084,M6-03.十三号通り公園,0,9,9,35.675198,139.663587,2024-02-08 15:15:03
1085,M6-02.サイカパーク笹塚,0,8,8,35.673444,139.666553,2024-02-08 15:15:03
1086,H1-165.亀戸梅屋敷,0,9,9,35.701318,139.825916,2024-02-08 15:15:03
1087,H1-166.亀戸クロック,13,5,18,35.696574,139.82972,2024-02-08 15:15:03
1088,M5-02.あいおいニッセイ同和損保新宿ビル,1,4,5,35.684423,139.692262,2024-02-08 15:15:03
1089,M6-01.幡ヶ谷駅高架下第一,24,12,36,35.677175,139.676769,2024-02-08 15:15:03
1090,A5-02.山王パークタワー,4,1,5,35.673555,139.741293,2024-02-08 15:15:03
1091,K1-116.旧呑川緑地（大森東五丁目）,5,6,11,35.567176,139.742345,2024-02-08 15:15:03
1092,K1-115.旧呑川緑地（大森中三丁目）,0,5,5,35.565685,139.736195,2024-02-08 15:15:03
1093,K1-114.下丸子公園,7,0,7,35.568722,139.680736,2024-02-08 15:15:03
1094,T3-05.東武練馬駅南,0,10,10,35.767129,139.664365,2024-02-08 15:15:03
1095,T1-14.ファミリーマート 練馬高松五丁目北店,4,0,4,35.761038,139.623148,2024-02-08 15:15:03
1096,C3-29.高橋是清翁記念公園,5,1,6,35.674094,139.728895,2024-02-08 15:15:03
1097,K1-141.蒲田駅西口歩道,3,0,3,35.561291,139.715076,2024-02-08 15:15:03
1098,C3-35.ワールド北青山ビル,17,0,17,35.667069,139.713423,2024-02-08 15:15:03
1099,M5-03.代々木大山公園,11,5,16,35.671282,139.675307,2024-02-08 15:15:03
1100,E5-13.弥生二丁目,3,3,6,35.715592,139.76192,2024-02-08 15:15:03
1101,E5-12.NK本郷ビル,1,5,6,35.704475,139.763041,2024-02-08 15:15:03
1102,B3-18.銀座松竹スクエア,10,0,10,35.668395,139.769849,2024-02-08 15:15:03
1103,C1-44.三田Avanti,4,2,6,35.64115,139.741471,2024-02-08 15:15:03
1104,T2-31.ファミリーマート 石神井台二丁目店,0,4,4,35.739488,139.590273,2024-02-08 15:15:03
1105,H1-150.ホテルヴィラフォンテーヌ南側,9,0,9,35.636978,139.791858,2024-02-08 15:15:03
1106,H1-149.有明ガーデン 公園口,8,0,8,35.639132,139.793047,2024-02-08 15:15:03
1107,H1-148.大島七丁目団地,0,17,17,35.694104,139.840278,2024-02-08 15:15:03
1108,B4-26.東武ストア晴海三丁目店,2,10,12,35.654371,139.779545,2024-02-08 15:15:03
1109,J1-26.田向公園,4,3,7,35.623459,139.687128,2024-02-08 15:15:03
1110,J1-25.碑文谷公園,3,4,7,35.625081,139.682632,2024-02-08 15:15:03
1111,H1-195.東京アクアティクスセンター,7,12,19,35.65238,139.815613,2024-02-08 15:15:03
1112,T1-13.ファミリーマート 練馬土支田二丁目店,0,10,10,35.761613,139.61349,2024-02-08 15:15:03
1113,T2-34.ファミリーマート 練馬富士見台店,0,5,5,35.73969,139.62125,2024-02-08 15:15:03
1114,T2-35.ファミリーマート 石神井台六丁目店,0,4,4,35.738607,139.585331,2024-02-08 15:15:03
1115,C1-81.田町タワー,17,2,19,35.646534,139.748913,2024-02-08 15:15:03
1116,J1-07.目黒川船入場,13,2,15,35.641992,139.701588,2024-02-08 15:15:03
1117,J1-08.目黒区民センター公園,14,3,17,35.634533,139.708868,2024-02-08 15:15:03
1118,D4-01.市谷仲之町,3,2,5,35.695102,139.723345,2024-02-08 15:15:03
1119,M2-11.鉢山町,15,1,16,35.652151,139.698426,2024-02-08 15:15:03
1120,E4-08.ドコモ・バイクシェア向丘ポート,0,10,10,35.720546,139.756685,2024-02-08 15:15:03
1121,D4-03.市谷加賀町2丁目,0,5,5,35.695636,139.727882,2024-02-08 15:15:03
1122,N1-01.BeGood野方,0,10,10,35.719717,139.64785,2024-02-08 15:15:03
1123,C2-03.アークヒルズサウスタワー,9,2,11,35.666357,139.73923,2024-02-08 15:15:03
1124,C2-01.アークヒルズ（アーク森ビル）,7,3,10,35.667107,139.739565,2024-02-08 15:15:03
1125,C2-02.六本木ヒルズ,21,3,24,35.661158,139.728533,2024-02-08 15:15:03
1126,C5-03.港南公園C,0,32,32,35.624966,139.746657,2024-02-08 15:15:03
1127,C5-04.みなとパーク芝浦,10,0,10,35.646801,139.751208,2024-02-08 15:15:03
1128,C1-16.機械振興会館,6,0,6,35.659442,139.745549,2024-02-08 15:15:03
1129,C1-14.新橋プラザビル,1,2,3,35.664461,139.756082,2024-02-08 15:15:03
1130,H1-73.イシマビル,4,2,6,35.67386,139.79976,2024-02-08 15:15:03
1131,O7-01.西永福公園,4,1,5,35.67753,139.63667,2024-02-08 15:15:03
1132,O6-02.富士見ヶ丘南自転車駐車場,6,2,8,35.68296,139.60861,2024-02-08 15:15:03
1133,K1-50.テクノポートカマタ 第1,6,0,6,35.556199,139.721476,2024-02-08 15:15:03
1134,J1-14.二の橋自転車置場1,39,0,39,35.614856,139.678208,2024-02-08 15:15:03
1135,O3-08.NTT井草ビル第２ポート,1,2,3,35.714077,139.61694,2024-02-08 15:15:03
1136,H1-124.セブン-イレブン 江東海辺店,4,4,8,35.680636,139.817977,2024-02-08 15:15:03
1137,D1-11.三井ガーデンホテル神宮外苑の杜プレミア,5,0,5,35.679807,139.715931,2024-02-08 15:15:03
1138,O7-07.ハレ永福,1,7,8,35.678913,139.639944,2024-02-08 15:15:03
1139,C5-32.トレードピアお台場,4,1,5,35.627891,139.776896,2024-02-08 15:15:03
1140,B4-18.豊海センタービル,0,4,4,35.653531,139.769431,2024-02-08 15:15:03
1141,D5-04.西戸山公園野球場,2,5,7,35.707388,139.700204,2024-02-08 15:15:03
1142,D5-03.北新宿公園,0,13,13,35.702288,139.68862,2024-02-08 15:15:03
1143,D3-04.鶴巻南公園,0,24,24,35.706182,139.723394,2024-02-08 15:15:03
1144,D3-03.甘泉園公園,0,15,15,35.712431,139.715418,2024-02-08 15:15:03
1145,K1-03.池上会館,0,7,7,35.576593,139.706597,2024-02-08 15:15:03
1146,K1-02.平和の森公園,12,3,15,35.579049,139.739878,2024-02-08 15:15:03
1147,K1-01.大森海苔のふるさと館,0,11,11,35.57685,139.742496,2024-02-08 15:15:03
1148,D6-13.新宿中央公園（ジャブジャブ池下）,8,1,9,35.687652,139.689254,2024-02-08 15:15:03
1149,T2-28.ファミリーマート 南大泉六丁目店,3,2,5,35.752217,139.571095,2024-02-08 15:15:03
1150,K1-05.平和島公園プール,11,6,17,35.581832,139.741581,2024-02-08 15:15:03
1151,K1-04.京急蒲田駅東口,20,0,20,35.559483,139.724273,2024-02-08 15:15:03
1152,E2-10.音羽パークロード（北入口）,13,2,15,35.716586,139.727705,2024-02-08 15:15:03
1153,E2-11.音羽パークロード（キャッチボール場横）,16,4,20,35.715382,139.728533,2024-02-08 15:15:03
1154,I1-21.大井競馬場(正門前),10,0,10,35.593887,139.741204,2024-02-08 15:15:03
1155,J1-27.衾町公園,1,0,1,35.623215,139.668472,2024-02-08 15:15:03
1156,T2-44.中島橋自転車駐車場,5,2,7,35.75372,139.584332,2024-02-08 15:15:03
1157,B3-15.ACホテル・バイ・マリオット東京銀座,8,0,8,35.668845,139.765144,2024-02-08 15:15:03
1158,D5-07.百人町1丁目,4,2,6,35.699252,139.697606,2024-02-08 15:15:03
1159,C4-04.ショパン高輪,0,6,6,35.632128,139.732097,2024-02-08 15:15:03
1160,B1-18.セブン-イレブン 日本橋小網町店,1,1,2,35.681352,139.781436,2024-02-08 15:15:03
1161,T2-71.わかば児童公園,4,3,7,35.7211,139.574669,2024-02-08 15:15:03
1162,M3-15.co-ba ebisu,4,2,6,35.647076,139.703964,2024-02-08 15:15:03
1163,C2-20.三井ガーデンホテル六本木プレミア,4,0,4,35.66206,139.735501,2024-02-08 15:15:03
1164,I1-70.五反田リバーステーション,2,2,4,35.624566,139.72448,2024-02-08 15:15:03
1165,E5-25.ジェノヴィア東大前グリーンヴェール,7,0,7,35.711875,139.759306,2024-02-08 15:15:03
1166,D1-12.ジェノヴィア新宿御苑グリーンヴェール,2,5,7,35.689017,139.714755,2024-02-08 15:15:03
1167,C5-33.msb Tamachi,29,6,35,35.645682,139.748768,2024-02-08 15:15:03
1168,G4-09.SYFORME MORISHITA Ⅱ 1,1,0,1,35.690348,139.796133,2024-02-08 15:15:03
1169,G4-10.SYFORME MORISHITA Ⅱ 2,4,1,5,35.690307,139.796128,2024-02-08 15:15:03
1170,N3-19.上高田パーキング,0,17,17,35.715878,139.673669,2024-02-08 15:15:03
1171,F6-01.松坂屋上野店,3,1,4,35.707305,139.773657,2024-02-08 15:15:03
1172,F4-01.SYFORME ASAKUSA,2,2,4,35.718832,139.791133,2024-02-08 15:15:03
1173,F2-02.アップルパーク浅草6丁目第3,0,3,3,35.716062,139.799552,2024-02-08 15:15:03
1174,F2-01.松が谷2丁目2,0,20,20,35.71283,139.787754,2024-02-08 15:15:03
1175,F1-02.台東デザイナーズビレッジ,1,6,7,35.706023,139.783751,2024-02-08 15:15:03
1176,F2-03.台東区生涯学習センター,0,6,6,35.717497,139.790055,2024-02-08 15:15:03
1177,K1-146.南馬込6丁目25-11,1,2,3,35.582743,139.710561,2024-02-08 15:15:03
1178,F3-01.清川1丁目18-11,0,17,17,35.724944,139.801684,2024-02-08 15:15:03
1179,F1-03.新御徒町駅自転車駐車場,3,13,16,35.706793,139.782985,2024-02-08 15:15:03
1180,F3-02.台東区リバーサイドスポーツセンター,0,7,7,35.717571,139.804216,2024-02-08 15:15:03
1181,I1-45.セブン-イレブン品川西五反田3丁目店,5,0,5,35.62541,139.718135,2024-02-08 15:15:03
1182,H1-135.北砂5丁目団地,0,30,30,35.684218,139.832843,2024-02-08 15:15:03
1183,C3-16.赤坂ガーデンシティ,0,8,8,35.6738,139.731525,2024-02-08 15:15:03
1184,J1-34.田道広場公園,7,3,10,35.636269,139.709073,2024-02-08 15:15:03
1185,O5-08.セシオン杉並,0,3,3,35.69714,139.65432,2024-02-08 15:15:03
1186,A2-04.ちよだプラットフォームスクウェア,9,1,10,35.691456,139.762228,2024-02-08 15:15:03
1187,I1-102.J.GRAN Court 品川西大井 EAST,3,2,5,35.598244,139.722447,2024-02-08 15:15:03
1188,H1-196.フットサルクラブ東京東陽町,5,1,6,35.665288,139.824294,2024-02-08 15:15:03
1189,F2-04.コンフォラス浅草マンション,1,2,3,35.717241,139.801674,2024-02-08 15:15:03
1190,G5-03.京成リッチモンドホテル東京錦糸町,2,2,4,35.693492,139.81506,2024-02-08 15:15:03
1191,K1-27.六郷文化センター,1,1,2,35.544715,139.707623,2024-02-08 15:15:03
1192,K1-147.トヨタモビリティ東京GRGarage東京蒲田店,2,0,2,35.552741,139.718404,2024-02-08 15:15:03
1193,K1-148.トヨタモビリティ東京 蒲田仲六郷店,6,0,6,35.552068,139.71747,2024-02-08 15:15:03
1194,K1-150.トヨタモビリティ東京 池上第二京浜店,1,4,5,35.568019,139.696379,2024-02-08 15:15:03
1195,K1-149.トヨタモビリティ東京 大田店,3,3,6,35.59336,139.715879,2024-02-08 15:15:03
1196,C1-82.トヨタモビリティ東京 港三田店,2,2,4,35.647831,139.739048,2024-02-08 15:15:03
1197,D4-11.トヨタモビリティ東京 新宿明治通り南店,2,0,2,35.699835,139.70808,2024-02-08 15:15:03
1198,C3-31.赤坂一丁目,13,4,17,35.670239,139.744285,2024-02-08 15:15:03
1199,E1-04.礫川公園,31,10,41,35.707853,139.751518,2024-02-08 15:15:03
1200,M3-23.円山町7-1,2,7,9,35.658229,139.694885,2024-02-08 15:15:03
1201,M3-24.渋谷道玄坂２丁目駐輪場,3,15,18,35.66026,139.69684,2024-02-08 15:15:03
1202,T3-32.練馬北町1丁目,1,4,5,35.764452,139.666299,2024-02-08 15:15:03
1203,H1-197.セブン-イレブン江東南砂葛西橋通り店,0,1,1,35.675361,139.825034,2024-02-08 15:15:03
1204,T2-84.石神井町二丁目緑地,0,3,3,35.748395,139.605958,2024-02-08 15:15:03
1205,T2-82.梅の木児童遊園,0,5,5,35.737899,139.576584,2024-02-08 15:15:03
1206,T2-83.西大泉さくら緑地,4,4,8,35.760442,139.573145,2024-02-08 15:15:03
1207,D7-05.西落合図書館,7,1,8,35.725818,139.678976,2024-02-08 15:15:03
1208,D6-28.東急ステイ新宿,3,1,4,35.690899,139.706348,2024-02-08 15:15:03
1209,T2-85.泉新公園,3,1,4,35.7547,139.601497,2024-02-08 15:15:03
1210,T2-86.石神井町八丁目緑地,2,1,3,35.746956,139.600798,2024-02-08 15:15:03
1211,T2-87.南大泉四丁目児童遊園,0,4,4,35.745607,139.573947,2024-02-08 15:15:03
1212,T2-88.南大泉かたまち緑地,0,4,4,35.739633,139.570457,2024-02-08 15:15:03
1213,T2-89.南大泉三丁目児童遊園,0,3,3,35.742755,139.568335,2024-02-08 15:15:03
1214,E2-05.護国寺駅西自転車駐車場,21,2,23,35.719421,139.725584,2024-02-08 15:15:03
1215,J1-59.第44興和ビル,3,1,4,35.647704,139.693671,2024-02-08 15:15:03
1216,C1-15.東京タワー,11,4,15,35.65928,139.744767,2024-02-08 15:15:03
1217,C5-20.ローソン芝浦二丁目店,3,0,3,35.645254,139.754765,2024-02-08 15:15:03
1218,C2-27.有栖川宮記念公園第一,17,0,17,35.651382,139.724392,2024-02-08 15:15:03
1219,C2-28.有栖川宮記念公園第二,4,4,8,35.651129,139.726003,2024-02-08 15:15:03
1220,C2-29.狸穴公園,4,1,5,35.658204,139.738935,2024-02-08 15:15:03
1221,T2-90.南田中四丁目緑地,2,2,4,35.733195,139.612327,2024-02-08 15:15:03
1222,T2-91.石神井町四丁目緑地,5,0,5,35.745272,139.604579,2024-02-08 15:15:03
1223,A3-41.秋葉原ダイビル,4,2,6,35.698917,139.771856,2024-02-08 15:15:03
1224,J1-54.田道住区センター三田分室,5,0,5,35.638904,139.712518,2024-02-08 15:15:03
1225,H1-140.キャナルパレス住吉,8,5,13,35.689896,139.815116,2024-02-08 15:15:03
1226,C1-57.虎ノ門ツインビルディング,5,2,7,35.667259,139.745643,2024-02-08 15:15:03
1227,K1-54.ファミリーマート大田久が原五丁目店,0,4,4,35.579435,139.698552,2024-02-08 15:15:03
1228,B1-29.ASTILE日本橋浜町,0,7,7,35.685504,139.790817,2024-02-08 15:15:03
1229,N3-20.SYFORME NAKANO-SAKAUE,3,2,5,35.701157,139.679617,2024-02-08 15:15:03
1230,D6-31.東急歌舞伎町タワー駐輪場,5,3,8,35.696207,139.700521,2024-02-08 15:15:03
1231,I1-30.ローソン 大井三丁目店,6,0,6,35.603327,139.729006,2024-02-08 15:15:03
1232,K1-151.PATH仲六郷,10,0,10,35.549465,139.711157,2024-02-08 15:15:03
1233,H1-198.Br Tower 有明 MID CROSS,4,3,7,35.63464,139.783445,2024-02-08 15:15:03
1234,H1-04.石と光の広場（国際展示場駅）,41,20,61,35.63363,139.79082,2024-02-08 15:15:03
1235,B4-24.ミュプレ月島,5,2,7,35.66288,139.78329,2024-02-08 15:15:03
1236,H1-199.ラ・ヴェール東陽町,5,3,8,35.664244,139.814506,2024-02-08 15:15:03
1237,H1-200.ヴェッセル木場南,0,9,9,35.662414,139.813333,2024-02-08 15:15:03
1238,F1-04.台東2丁目21,0,5,5,35.703465,139.780325,2024-02-08 15:15:03
1239,F3-03.ヴェルステージ南千住,0,5,5,35.728704,139.801867,2024-02-08 15:15:03
1240,J1-46.五本木西みどり街かど公園,0,5,5,35.632735,139.683899,2024-02-08 15:15:03
1241,K1-131.東急武蔵新田駅駐輪場,11,4,15,35.567146,139.693344,2024-02-08 15:15:03
1242,K1-152.アットホームスクエア前,0,8,8,35.543327,139.703223,2024-02-08 15:15:03
1243,B2-04.清水建設本社（都営地下鉄宝町駅 Ａ８出口）,13,3,16,35.676119,139.772895,2024-02-08 15:15:03
1244,H1-202.辰巳の森海浜公園,7,5,12,35.648107,139.813572,2024-02-08 15:15:03
1245,H1-201.ウエリスアーバン水天宮前2,4,1,5,35.678099,139.791831,2024-02-08 15:15:03
1246,I1-103.五反田ＪＰビルディング,3,0,3,35.622389,139.721552,2024-02-08 15:15:03
1247,L1-16.上祖師谷7丁目,13,1,14,35.65838,139.59231,2024-02-08 15:15:03
1248,O5-09.AppCruise中野,1,1,2,35.700772,139.66063,2024-02-08 15:15:03
1249,H1-203.セブン-イレブン江東木場３丁目店,0,3,3,35.67517,139.804087,2024-02-08 15:15:03
1250,H1-44.テプコ豊洲ビル,21,3,24,35.648726,139.790877,2024-02-08 15:15:03
1251,L1-17.赤堤3丁目,3,4,7,35.659787,139.636696,2024-02-08 15:15:03
1252,L1-18.上北沢1丁目,21,9,30,35.662796,139.626795,2024-02-08 15:15:03
1253,B3-16.明石町区民館,0,13,13,35.666001,139.778102,2024-02-08 15:15:03
1254,I1-104.源氏前ビル,5,0,5,35.603521,139.712345,2024-02-08 15:15:03
1255,J1-28.宮前公園,0,7,7,35.617699,139.664826,2024-02-08 15:15:03
1256,M6-18.セブン-イレブン渋谷本町3丁目店,4,0,4,35.686521,139.685017,2024-02-08 15:15:03
1257,O7-08.杉並区和泉2-3-17,0,4,4,35.67187,139.65474,2024-02-08 15:15:03
1258,T1-17.セブン-イレブン練馬田柄通店,6,1,7,35.75987,139.640474,2024-02-08 15:15:03
1259,H1-18.東京ビッグサイト,7,9,16,35.631192,139.79401,2024-02-08 15:15:03
1260,M3-01.渋谷マークシティ,11,2,13,35.657726,139.697802,2024-02-08 15:15:03
1261,H1-70.有明スポーツセンター,13,4,17,35.63403,139.784319,2024-02-08 15:15:03
1262,H1-41.深川北スポーツセンター,2,11,13,35.676475,139.804741,2024-02-08 15:15:03
1263,H1-55.深川江戸資料館,3,5,8,35.681089,139.800777,2024-02-08 15:15:03
1264,I1-61.五反田文化センター,3,4,7,35.622588,139.716159,2024-02-08 15:15:03
1265,N3-13.中部すこやか福祉センター,3,2,5,35.700052,139.673715,2024-02-08 15:15:03
1266,A4-02.東京サンケイビル,5,5,10,35.686847,139.765151,2024-02-08 15:15:03
1267,M3-09.ティップ.クロス TOKYO 渋谷,10,9,19,35.661475,139.699296,2024-02-08 15:15:03
1268,B3-02.サンクンガーデン,2,4,6,35.670336,139.771911,2024-02-08 15:15:03
1269,T2-10.勤労福祉会館,5,0,5,35.748153,139.58765,2024-02-08 15:15:03
1270,K1-133.東京港野鳥公園,13,0,13,35.584217,139.759232,2024-02-08 15:15:03
1271,K1-21.六郷特別出張所,0,8,8,35.55079,139.716517,2024-02-08 15:15:03
1272,H1-54.砂町文化センター,3,17,20,35.680052,139.831874,2024-02-08 15:15:03
1273,D1-08.新宿歴史博物館,3,1,4,35.689984,139.725261,2024-02-08 15:15:03
1274,E1-05.春日地下自転車駐車場,22,5,27,35.708291,139.753335,2024-02-08 15:15:03
1275,E1-15.播磨坂事業所,1,0,1,35.71724,139.74289,2024-02-08 15:15:03
1276,E5-02.不忍通りふれあい館,0,12,12,35.719356,139.764308,2024-02-08 15:15:03
1277,E4-02.向丘地域活動センター,8,5,13,35.717357,139.757817,2024-02-08 15:15:03
1278,C3-18.明治記念館,4,0,4,35.678509,139.721207,2024-02-08 15:15:03
1279,D5-05.中央図書館,13,2,15,35.705018,139.706841,2024-02-08 15:15:03
1280,E2-07.肥後細川庭園,10,3,13,35.713223,139.721699,2024-02-08 15:15:03
1281,A1-05.富士見出張所,0,4,4,35.699187,139.746348,2024-02-08 15:15:03
1282,E5-07.湯島三丁目児童遊園,3,5,8,35.707296,139.769393,2024-02-08 15:15:03
1283,D5-10.桜美林大学 新宿キャンパス,1,5,6,35.705154,139.697562,2024-02-08 15:15:03
1284,A3-08.神田明神（神田神社）,11,2,13,35.702029,139.768245,2024-02-08 15:15:03
1285,E2-14.永青文庫 ミュージアム,5,0,5,35.713145,139.723342,2024-02-08 15:15:03
1286,M5-17.小田急サザンタワー,8,1,9,35.6866,139.70014,2024-02-08 15:15:03
1287,K1-16.ファミリーマート 矢口二丁目店,4,2,6,35.563092,139.693548,2024-02-08 15:15:03
1288,H1-206.北砂5丁目団地2,0,10,10,35.683866,139.831809,2024-02-08 15:15:03
1289,G1-02.八広駅高架下,4,10,14,35.727495,139.828499,2024-02-08 15:15:03
1290,F4-02.Risingplace浅草四番館,0,4,4,35.717963,139.791025,2024-02-08 15:15:03
1291,H1-204.大島四丁目団地2,4,4,8,35.68832,139.828829,2024-02-08 15:15:03
1292,H1-205.大島四丁目団地3,6,2,8,35.688236,139.827711,2024-02-08 15:15:03
1293,H1-106.亀戸中央公園,12,7,19,35.699874,139.834263,2024-02-08 15:15:03
1294,E5-30.湯島3丁目15,0,11,11,35.705148,139.769314,2024-02-08 15:15:03
1295,B4-38.HARUMI FLAG SUN VILLAGE,0,24,24,35.650347,139.771785,2024-02-08 15:15:03
1296,B4-32.HARUMI FLAG SEA VILLAGE,0,10,10,35.648731,139.774995,2024-02-08 15:15:03
1297,B4-31.HARUMI FLAG PORT VILLAGE,0,19,19,35.650604,139.77724,2024-02-08 15:15:03
1298,B4-33.HARUMI FLAG SEA VILLAGE,0,15,15,35.649552,139.776369,2024-02-08 15:15:03
1299,B4-36.HARUMI FLAG SEA VILLAGE,2,10,12,35.650742,139.778097,2024-02-08 15:15:03
1300,B4-35.HARUMI FLAG SEA VILLAGE,2,10,12,35.650573,139.777908,2024-02-08 15:15:03
1301,B4-37.HARUMI FLAG SUN VILLAGE,0,16,16,35.649419,139.771447,2024-02-08 15:15:03
1302,B4-34.HARUMI FLAG SEA VILLAGE,3,9,12,35.649932,139.776958,2024-02-08 15:15:03
1303,B4-39.HARUMI FLAG SUN VILLAGE,0,16,16,35.650863,139.772549,2024-02-08 15:15:03
1304,B4-40.HARUMI FLAG SUN VILLAGE,0,17,17,35.651305,139.773379,2024-02-08 15:15:03
1305,B4-41.HARUMI FLAG SUN VILLAGE,0,17,17,35.649854,139.77334,2024-02-08 15:15:03
1306,B4-42.HARUMI FLAG SUN VILLAGE,0,12,12,35.649329,139.772656,2024-02-08 15:15:03
1307,B4-28.HARUMI FLAG PORT VILLAGE,4,7,11,35.651183,139.776119,2024-02-08 15:15:03
1308,B4-50.HARUMI FLAG PARK VILLAGE,2,7,9,35.648295,139.773973,2024-02-08 15:15:03
1309,B4-49.HARUMI FLAG PARK VILLAGE,5,11,16,35.648636,139.774251,2024-02-08 15:15:03
1310,B4-48.HARUMI FLAG PARK VILLAGE,0,5,5,35.649513,139.775287,2024-02-08 15:15:03
1311,B4-47.HARUMI FLAG PARK VILLAGE,2,4,6,35.649119,139.775138,2024-02-08 15:15:03
1312,B4-46.HARUMI FLAG PARK VILLAGE,0,28,28,35.649642,139.773859,2024-02-08 15:15:03
1313,B4-45.HARUMI FLAG PARK VILLAGE,0,25,25,35.649002,139.772764,2024-02-08 15:15:03
1314,B4-44.HARUMI FLAG PARK VILLAGE,3,10,13,35.648221,139.772666,2024-02-08 15:15:03
1315,B4-30.HARUMI FLAG PORT VILLAGE,2,9,11,35.651136,139.778218,2024-02-08 15:15:03
1316,B4-29.HARUMI FLAG PORT VILLAGE,0,12,12,35.651907,139.777391,2024-02-08 15:15:03
1317,L1-19.三軒茶屋1丁目駐輪場,1,3,4,35.639302,139.674744,2024-02-08 15:15:03
1318,O7-09.方南月極パーキング,8,9,17,35.678921,139.658289,2024-02-08 15:15:03
1319,O5-10.ローソン ツルハドラッグ杉並和田店,1,3,4,35.68942,139.662118,2024-02-08 15:15:03
1320,O2-04.西荻北1丁目,2,3,5,35.708082,139.607543,2024-02-08 15:15:03
1321,K1-75.三井不動産インダストリアルパーク羽田,6,4,10,35.556231,139.751408,2024-02-08 15:15:03
1322,F1-05.ホウエイコート秋葉原,0,1,1,35.703024,139.78052,2024-02-08 15:15:03
1323,C3-36.第35興和ビル,2,1,3,35.666349,139.741781,2024-02-08 15:15:03
1324,B4-53.晴海五丁目ターミナル,25,81,106,35.651627,139.773103,2024-02-08 15:15:03
1325,C5-44.ブランズタワー芝浦,9,0,9,35.643105,139.753039,2024-02-08 15:15:03
1326,A3-47.ホテルヴィラフォンテーヌ東京大手町,13,0,13,35.690602,139.766916,2024-02-08 15:15:03
1327,A1-20.菱和パレス九段,3,2,5,35.693021,139.740317,2024-02-08 15:15:03
0,E5-26.本郷4丁目,0,5,5,35.708596,139.758269,2024-02-08 12:35:04
1,A3-42.内神田3丁目,30,5,35,35.692599,139.770109,2024-02-08 12:35:04
2,T2-76.東中前の森緑地,3,2,5,35.748736,139.574839,2024-02-08 12:35:04
3,A2-20.神田スクエア,19,0,19,35.693408,139.762809,2024-02-08 12:35:04
4,K1-79.Tマークシティホテル東京大森,3,4,7,35.586993,139.736491,2024-02-08 12:35:04
5,K1-80.大森北6丁目,1,3,4,35.579849,139.731241,2024-02-08 12:35:04
6,H1-130.トヨタモビリティ東京 深川店,3,7,10,35.676643,139.816054,2024-02-08 12:35:04
7,H1-131.セブン-イレブン 江東佐賀2丁目店,0,18,18,35.679029,139.793535,2024-02-08 12:35:04
8,H1-132.セブン-イレブン 江東三好4丁目店,0,37,37,35.681418,139.809287,2024-02-08 12:35:04
9,A6-22.半蔵門PREX South,12,3,15,35.683433,139.740756,2024-02-08 12:35:04
10,I1-74.セブン-イレブン西五反田6丁目店,2,4,6,35.622403,139.71771,2024-02-08 12:35:04
11,G2-01.東京ソラマチ,4,3,7,35.709777,139.810189,2024-02-08 12:35:04
12,T2-59.平成公園,2,1,3,35.722917,139.587864,2024-02-08 12:35:04
13,Z15.ファミリーマート藤崎一丁目店,0,6,6,35.52928,139.722762,2024-02-08 12:35:04
14,I1-26.大崎西口公園,1,7,8,35.617475,139.729221,2024-02-08 12:35:04
15,I1-96.西五反田２丁目,10,0,10,35.627599,139.720463,2024-02-08 12:35:04
16,H1-172.サンヨーパシフィックマンション,0,11,11,35.668856,139.794069,2024-02-08 12:35:04
17,J1-56.青葉台四丁目街かど公園,4,0,4,35.654009,139.692727,2024-02-08 12:35:04
18,H1-173.森下駅前,6,33,39,35.687837,139.79654,2024-02-08 12:35:04
19,E3-01.大塚地域活動センター跡地,5,5,10,35.718656,139.734556,2024-02-08 12:35:04
20,E2-03.目白台運動公園,26,15,41,35.715556,139.721988,2024-02-08 12:35:04
21,T2-77.大泉なかよし緑地,3,1,4,35.759861,139.581682,2024-02-08 12:35:04
22,E2-01.江戸川橋Ｂ自転車駐車場,44,37,81,35.710381,139.732137,2024-02-08 12:35:04
23,E2-02.江戸川公園,9,10,19,35.710958,139.731165,2024-02-08 12:35:04
24,D7-14.大栄パーク西落合１丁目,4,2,6,35.720028,139.678936,2024-02-08 12:35:04
25,E1-07.礫川地域活動センター,0,8,8,35.712015,139.750284,2024-02-08 12:35:04
26,M6-05.七号通り公園,0,15,15,35.67917,139.67493,2024-02-08 12:35:04
27,H1-138.HW.HILLS新大橋,0,11,11,35.687416,139.795588,2024-02-08 12:35:04
28,B4-21.月島駅前第一駐輪場,14,20,34,35.663681,139.785651,2024-02-08 12:35:04
29,N2-03.野方1丁目,5,2,7,35.712179,139.65603,2024-02-08 12:35:04
30,C5-52.港南四丁目第3アパート駐車場,7,4,11,35.630109,139.747094,2024-02-08 12:35:04
31,E5-27.真正館駐車場,0,4,4,35.714875,139.76394,2024-02-08 12:35:04
32,C5-35.品川駅港南口,6,0,6,35.62822,139.741135,2024-02-08 12:35:04
33,N2-01.NTT野方ビル,2,3,5,35.710285,139.66173,2024-02-08 12:35:04
34,D6-27.新宿三井ビルディング二号館,8,1,9,35.686334,139.692881,2024-02-08 12:35:04
35,D1-10.曙橋駐輪場,4,12,16,35.691888,139.724365,2024-02-08 12:35:04
36,I1-39.MID POINT 目黒不動前,2,3,5,35.628116,139.713149,2024-02-08 12:35:04
37,E3-07.小日向1丁目,0,20,20,35.713388,139.737009,2024-02-08 12:35:04
38,C1-47.パークプレイス三田,8,1,9,35.641791,139.740734,2024-02-08 12:35:04
39,I1-38.ローソン 八潮三丁目店,25,20,45,35.594544,139.760423,2024-02-08 12:35:04
40,C2-24.Dash Living HigashiAzabu,6,0,6,35.655135,139.744449,2024-02-08 12:35:04
41,J1-04.菅刈公園,7,1,8,35.650351,139.692853,2024-02-08 12:35:04
42,O4-09.ローソン杉並本天沼一丁目店,0,3,3,35.712496,139.632778,2024-02-08 12:35:04
43,T3-29.平和台もものき緑地,1,2,3,35.755773,139.661913,2024-02-08 12:35:04
44,D2-10.市谷砂土原町3丁目,3,9,12,35.696242,139.735776,2024-02-08 12:35:04
45,C1-48.竹芝客船ターミナル,10,5,15,35.655139,139.762812,2024-02-08 12:35:04
46,B1-06.伊場仙ビル,3,2,5,35.687624,139.777125,2024-02-08 12:35:04
47,B2-01.鉄砲洲児童公園（西側）,0,21,21,35.67224,139.779348,2024-02-08 12:35:04
48,B1-04.産業会館,2,3,5,35.694164,139.787057,2024-02-08 12:35:04
49,B1-05.日本橋保健センター,0,11,11,35.687419,139.779053,2024-02-08 12:35:04
50,B2-05.ＮＴＴ東日本築地ビル,0,9,9,35.670674,139.775993,2024-02-08 12:35:04
51,B2-02.柳通り（東京スクエアガーデン前）,12,0,12,35.676393,139.768319,2024-02-08 12:35:04
52,B2-03.男女平等センター（ブーケ21）,8,3,11,35.673923,139.778671,2024-02-08 12:35:04
53,C2-13.麻布運動場,8,0,8,35.651718,139.728165,2024-02-08 12:35:04
54,D2-08.旧市ヶ谷商業高校,0,18,18,35.70074,139.731363,2024-02-08 12:35:04
55,C1-35.セブン-イレブン 三田駅北店,4,1,5,35.649032,139.750147,2024-02-08 12:35:04
56,B4-12.THE TOKYO TOWERS,0,95,95,35.655497,139.774556,2024-02-08 12:35:04
57,C5-21.セブン-イレブン 芝浦3丁目店,3,3,6,35.642399,139.746992,2024-02-08 12:35:04
58,H1-67.セブン-イレブン 江東亀戸9丁目店,1,15,16,35.69766,139.843408,2024-02-08 12:35:04
59,C2-15.住友不動産六本木グランドタワー,0,13,13,35.664367,139.737185,2024-02-08 12:35:04
60,C2-14.元麻布ヒルズ,0,10,10,35.653608,139.73138,2024-02-08 12:35:04
61,M6-14.ドコモショップ笹塚店,0,5,5,35.67323,139.66393,2024-02-08 12:35:04
62,N4-07.南台2丁目,2,10,12,35.68509,139.671102,2024-02-08 12:35:04
63,K1-68.ART FACTORY 城南島,6,2,8,35.580511,139.775957,2024-02-08 12:35:04
64,H1-178.北砂7丁目団地(第二),0,4,4,35.678031,139.837193,2024-02-08 12:35:04
65,H1-179.北砂7丁目団地(第三),1,10,11,35.678246,139.8366,2024-02-08 12:35:04
66,A1-17.雉子橋集積所,6,0,6,35.692605,139.755761,2024-02-08 12:35:04
67,H1-177.北砂7丁目団地(第一),0,13,13,35.678537,139.837391,2024-02-08 12:35:04
68,K1-95.城南島海浜公園,11,5,16,35.578259,139.783505,2024-02-08 12:35:04
69,B3-17.銀座6丁目-SQUARE,7,0,7,35.66711,139.76643,2024-02-08 12:35:04
70,J1-33.芳窪街かど公園,12,1,13,35.629861,139.666293,2024-02-08 12:35:04
71,N3-07.なかのZERO,1,4,5,35.70442,139.67141,2024-02-08 12:35:04
72,N4-04.弥生町5丁目,3,9,12,35.690897,139.668345,2024-02-08 12:35:04
73,A3-44.THE WAVES AKIHABARA,0,6,6,35.694679,139.779504,2024-02-08 12:35:04
74,K1-138.羽田エアポートガーデン,7,2,9,35.544534,139.763244,2024-02-08 12:35:04
75,C3-26.ホテルリブマックス赤坂,2,3,5,35.67011,139.733375,2024-02-08 12:35:04
76,C1-52.NTT三田ビル,3,3,6,35.652549,139.747789,2024-02-08 12:35:04
77,D1-07.Dash Living Shinjuku,4,0,4,35.689757,139.710091,2024-02-08 12:35:04
78,O4-07.ローソン成田西三丁目店,0,5,5,35.690311,139.62178,2024-02-08 12:35:04
79,H1-152.コンポジット亀戸ウエスト,0,9,9,35.699187,139.82429,2024-02-08 12:35:04
80,E1-13.エルアージュ小石川,0,40,40,35.71399,139.75137,2024-02-08 12:35:04
81,B4-22.リビオレゾン勝どきNEX,0,46,46,35.65554,139.77102,2024-02-08 12:35:04
82,H1-176.JMFビル東陽町02,3,3,6,35.667677,139.823552,2024-02-08 12:35:04
83,H1-102.ファミリーマート東砂七丁目店,0,17,17,35.672714,139.837914,2024-02-08 12:35:04
84,H1-101.ファミリーマート新木場一丁目店,5,1,6,35.642571,139.836766,2024-02-08 12:35:04
85,K1-67.京浜島防災広場,0,15,15,35.570508,139.764013,2024-02-08 12:35:04
86,K1-66.昭和島二丁目公園,0,11,11,35.575097,139.751446,2024-02-08 12:35:04
87,Z11.ファミリーマートＭＧ川崎昭和店,4,0,4,35.528868,139.737762,2024-02-08 12:35:04
88,I1-80.リバーサイド品川港南ビル,5,5,10,35.622714,139.74471,2024-02-08 12:35:04
89,J1-10.NTTデータ駒場研修センター,6,5,11,35.655779,139.680948,2024-02-08 12:35:04
90,A2-17.竹橋ビル,8,0,8,35.692396,139.75639,2024-02-08 12:35:04
91,H1-91.亀戸駅北口第三自転車駐車場,13,5,18,35.696913,139.823911,2024-02-08 12:35:04
92,H1-92.亀戸駅東口第二自転車駐車場,7,7,14,35.69788,139.830559,2024-02-08 12:35:04
93,K1-59.京急梅屋敷第1駐車場,6,1,7,35.565768,139.727396,2024-02-08 12:35:04
94,K1-60.京急平和島第1駐車場,2,7,9,35.576336,139.733691,2024-02-08 12:35:04
95,I1-42.京急青横駐車場,3,0,3,35.611582,139.742528,2024-02-08 12:35:04
96,I1-43.京急南大井駐車場,0,9,9,35.594722,139.737101,2024-02-08 12:35:04
97,Z01.NTTドコモ川崎ビル,8,0,8,35.528801,139.694661,2024-02-08 12:35:04
98,O7-05.ジーベック方南町,1,0,1,35.680849,139.65626,2024-02-08 12:35:04
99,H1-100.URアーバンライフ亀戸,21,8,29,35.697935,139.821855,2024-02-08 12:35:04
100,A6-10.紀尾井町ビル（西側）,9,3,12,35.682516,139.736494,2024-02-08 12:35:04
101,C3-02.赤坂地区総合支所,0,7,7,35.674788,139.731423,2024-02-08 12:35:04
102,C2-08.ファミリーマート西麻布霞町店,0,8,8,35.661673,139.721118,2024-02-08 12:35:04
103,A6-09.紀尾井町ビル（北側）,6,0,6,35.682902,139.736494,2024-02-08 12:35:04
104,H1-28.有明客船ターミナル,10,1,11,35.630063,139.792209,2024-02-08 12:35:04
105,B1-12.ファミリーマート堀留町二丁目店,0,8,8,35.687786,139.78205,2024-02-08 12:35:04
106,H1-26.青海客船ターミナル,15,0,15,35.619234,139.774485,2024-02-08 12:35:04
107,H1-27.パレットタウン乗船場,10,0,10,35.624467,139.781305,2024-02-08 12:35:04
108,K1-121.東京広域ポート（川崎LiSE）,10,0,10,35.540579,139.754506,2024-02-08 12:35:04
109,K1-122.東急新丸子駅駐輪場,8,5,13,35.581347,139.662265,2024-02-08 12:35:04
110,K1-123.東急新丸子駅（東）駐輪場,11,1,12,35.577794,139.660751,2024-02-08 12:35:04
111,O1-04.井草1-34,8,7,15,35.72758,139.62432,2024-02-08 12:35:04
112,C1-76.浜松町駅北口交通広場(ハマサイト前),15,1,16,35.656647,139.758301,2024-02-08 12:35:04
113,J1-52.駒沢一丁目公園前,7,2,9,35.629807,139.662398,2024-02-08 12:35:04
114,C1-75.虎ノ門PFビル,6,1,7,35.665466,139.748014,2024-02-08 12:35:04
115,B2-18.旭ビルディング,11,0,11,35.678291,139.78157,2024-02-08 12:35:04
116,N2-09.松山駐車場No.1,3,3,6,35.722991,139.673048,2024-02-08 12:35:04
117,I1-82.トミンハイム西五反田四丁目,3,3,6,35.627386,139.711182,2024-02-08 12:35:04
118,O4-03.ザ・ハウス,0,12,12,35.707035,139.633066,2024-02-08 12:35:04
119,O4-04.阿佐谷南3-43,15,1,16,35.704147,139.631955,2024-02-08 12:35:04
120,K1-83.北千束北児童公園,6,0,6,35.611085,139.68599,2024-02-08 12:35:04
121,I1-95.東京レールゲート EAST,5,3,8,35.584998,139.761055,2024-02-08 12:35:04
122,M5-19.グランリヴィエール代々木,1,4,5,35.68285,139.698528,2024-02-08 12:35:04
123,Z14.ファミリーマート川崎中瀬店,3,6,9,35.537163,139.729625,2024-02-08 12:35:04
124,H1-192.ウエリスアーバン水天宮前,3,1,4,35.678296,139.791949,2024-02-08 12:35:04
125,N2-08.江古田区民活動センター,3,1,4,35.728893,139.670119,2024-02-08 12:35:04
126,D7-04.セブン-イレブン 新宿下落合3丁目店,1,2,3,35.722645,139.701982,2024-02-08 12:35:04
127,Z16.ファミリーマート川崎浜町四丁目店,4,3,7,35.515344,139.722229,2024-02-08 12:35:04
128,K1-82.西蒲田公園,7,0,7,35.561499,139.71123,2024-02-08 12:35:04
129,H1-68.芝浦工業大学附属中学高等学校,0,38,38,35.649274,139.792213,2024-02-08 12:35:04
130,K1-24.東糀谷防災公園,0,16,16,35.557074,139.74575,2024-02-08 12:35:04
131,H1-03.東雲駅,13,2,15,35.640736,139.804331,2024-02-08 12:35:04
132,K1-26.大森諏訪公園,0,15,15,35.574785,139.730762,2024-02-08 12:35:04
133,K1-25.鶴渡公園,2,1,3,35.56892,139.725082,2024-02-08 12:35:04
134,N3-10.エーエスホームズⅡ駐車場,5,1,6,35.702659,139.662563,2024-02-08 12:35:04
135,J1-37.中目黒公園,12,6,18,35.640398,139.704069,2024-02-08 12:35:04
136,A1-10.ヒューリック九段ビル,6,0,6,35.696449,139.750784,2024-02-08 12:35:04
137,K1-93.六間堀仲羽公園,2,2,4,35.548864,139.74484,2024-02-08 12:35:04
138,T2-53.上練馬公園,2,2,4,35.772863,139.626969,2024-02-08 12:35:04
139,M5-01.初台駅南口,1,11,12,35.680154,139.685937,2024-02-08 12:35:04
140,C1-60.専売ビル,11,3,14,35.647659,139.745055,2024-02-08 12:35:04
141,K1-85.大田区青少年交流センター ゆいっつ,3,1,4,35.583555,139.743381,2024-02-08 12:35:04
142,I1-64.株式会社ユアス ゆうパック取扱所：ポストのうしろ,8,2,10,35.622965,139.731014,2024-02-08 12:35:04
143,C4-09.ケーヨーデイツー三田店,0,6,6,35.646375,139.740061,2024-02-08 12:35:04
144,C1-61.環三浜松町駅南,23,15,38,35.653096,139.75739,2024-02-08 12:35:04
145,K1-84.佐伯山緑地,0,13,13,35.581698,139.71491,2024-02-08 12:35:04
146,C1-59.セレスティン芝三井ビルディング,5,8,13,35.650845,139.748346,2024-02-08 12:35:04
147,G2-07.レオーネ押上cube,3,1,4,35.706167,139.815955,2024-02-08 12:35:04
148,E1-06.文京シビックセンター,10,10,20,35.708265,139.751983,2024-02-08 12:35:04
149,D2-13.THE CENTER TOKYO,0,23,23,35.695646,139.725722,2024-02-08 12:35:04
150,E5-22.千駄木2丁目,2,4,6,35.724828,139.762583,2024-02-08 12:35:04
151,C4-07.品川プリンスホテル,9,1,10,35.628266,139.734171,2024-02-08 12:35:04
152,A3-43.unito CHIYODA,0,3,3,35.69474,139.77929,2024-02-08 12:35:04
153,C4-06.白金プラチナレジデンス,0,22,22,35.644134,139.723432,2024-02-08 12:35:04
154,I1-63.セブン-イレブン西五反田店,3,0,3,35.62765,139.719212,2024-02-08 12:35:04
155,H1-53.豊洲シビックセンター,17,1,18,35.653991,139.795513,2024-02-08 12:35:04
156,T3-16.練馬区役所東庁舎(第一),10,0,10,35.735428,139.652379,2024-02-08 12:35:04
157,T2-68.さくら原っぱ緑地,2,3,5,35.731372,139.619164,2024-02-08 12:35:04
158,T2-69.久保新田さくら公園,0,4,4,35.76525,139.575978,2024-02-08 12:35:04
159,H1-187.森下文化センター,0,5,5,35.685344,139.80234,2024-02-08 12:35:04
160,E4-04.セブン-イレブン 文京本駒込１丁目店,0,5,5,35.724707,139.750469,2024-02-08 12:35:04
161,M2-13.恵比寿プライムスクエアタワー南,8,0,8,35.649257,139.713272,2024-02-08 12:35:04
162,H1-48.セブン-イレブン 江東潮見２丁目店,0,8,8,35.658249,139.815775,2024-02-08 12:35:04
163,H1-51.豊洲交通広場　東,26,0,26,35.654958,139.795718,2024-02-08 12:35:04
164,H1-52.辰巳駅,14,1,15,35.646756,139.809295,2024-02-08 12:35:04
165,D7-01.下落合図書館,5,11,16,35.715894,139.698578,2024-02-08 12:35:04
166,H1-50.豊洲交通広場　北,11,0,11,35.655457,139.795161,2024-02-08 12:35:04
167,A6-14.MG市ヶ谷ビルディング,0,2,2,35.690861,139.736393,2024-02-08 12:35:04
168,T2-21.ファミリーマート 練馬大泉町一丁目店,1,3,4,35.768448,139.601679,2024-02-08 12:35:04
169,A6-15.東急番町ビル,4,1,5,35.688929,139.7358,2024-02-08 12:35:04
170,A1-18.東京区政会館別館(特別区研修所),3,1,4,35.696202,139.752351,2024-02-08 12:35:04
171,T3-18.練馬駅北,10,9,19,35.738585,139.653396,2024-02-08 12:35:04
172,C1-43.KDX浜松町プレイス,3,3,6,35.658169,139.752509,2024-02-08 12:35:04
173,C5-27.プレミア海岸ビル,9,12,21,35.648948,139.757895,2024-02-08 12:35:04
174,I1-29.ローソン 勝島一丁目店,0,20,20,35.599987,139.745195,2024-02-08 12:35:04
175,H1-72.ネクストサイト深川ビル,20,1,21,35.674578,139.797396,2024-02-08 12:35:04
176,T1-11.むつみ台,0,3,3,35.768528,139.639807,2024-02-08 12:35:04
177,T1-10.月見大橋下,5,0,5,35.758366,139.628982,2024-02-08 12:35:04
178,H1-167.大島八丁目公園,1,9,10,35.688074,139.838932,2024-02-08 12:35:04
179,K1-36.セブン-イレブン 大田区南雪谷5丁目店,0,12,12,35.587815,139.691748,2024-02-08 12:35:04
180,L1-01.羽根木公園,5,8,13,35.66088,139.654546,2024-02-08 12:35:04
181,P1-02.雑司ヶ谷一丁目,8,0,8,35.721738,139.723103,2024-02-08 12:35:04
182,I1-66.南大井文化センター駐車場,2,4,6,35.596733,139.73804,2024-02-08 12:35:04
183,L1-05.NTT烏山ビル,0,3,3,35.669285,139.597931,2024-02-08 12:35:04
184,L1-04.下馬中央公園,0,5,5,35.63367,139.678139,2024-02-08 12:35:04
185,L1-03.世田谷城阯公園,0,6,6,35.645838,139.647799,2024-02-08 12:35:04
186,L1-02.若林公園,5,2,7,35.647075,139.654472,2024-02-08 12:35:04
187,T2-30.ファミリーマート 練馬東大泉四丁目店,4,0,4,35.750804,139.58243,2024-02-08 12:35:04
188,L1-07.NTT成城ビル,2,1,3,35.648021,139.606529,2024-02-08 12:35:04
189,L1-06.NTT瀬田ビル,0,12,12,35.618357,139.626191,2024-02-08 12:35:04
190,T3-12.春日町西公園,3,1,4,35.748092,139.636587,2024-02-08 12:35:04
191,T3-13.平和台児童公園,2,2,4,35.757298,139.664139,2024-02-08 12:35:04
192,T2-38.ファミリーマート 練馬上石神井四丁目店,7,2,9,35.727195,139.590179,2024-02-08 12:35:04
193,B1-28.アイルイムーブル日本橋,8,1,9,35.684502,139.77906,2024-02-08 12:35:04
194,A2-28.NTTコミュニケーションズ一ツ橋ビル駐車場,8,0,8,35.6915,139.75685,2024-02-08 12:35:04
195,C3-32.乃木公園,4,1,5,35.667936,139.72745,2024-02-08 12:35:04
196,T3-14.わらべ児童遊園,3,1,4,35.759774,139.654529,2024-02-08 12:35:04
197,T2-52.田柄中央児童公園,2,3,5,35.762395,139.641522,2024-02-08 12:35:04
198,M4-06.THE SHARE 原宿,9,0,9,35.671823,139.708158,2024-02-08 12:35:04
199,K1-10.セブン‐イレブン 大田区西糀谷１丁目店,1,3,4,35.559647,139.730098,2024-02-08 12:35:04
200,K1-09.セブン‐イレブン 大田区西蒲田２丁目店,0,22,22,35.570763,139.705895,2024-02-08 12:35:04
201,H1-63.東京スイソミル,0,14,14,35.65637,139.811765,2024-02-08 12:35:04
202,B1-16.小網町児童遊園,5,1,6,35.683695,139.780043,2024-02-08 12:35:04
203,H1-61.Brilliaランニングスタジアムマギーズ東京前,7,2,9,35.648281,139.786112,2024-02-08 12:35:04
204,K1-08.セブン‐イレブン 大田区東蒲田キネマ通り店,0,6,6,35.562368,139.730143,2024-02-08 12:35:04
205,C1-34.城山ガーデン,8,0,8,35.664479,139.743731,2024-02-08 12:35:04
206,H1-62.扇橋一丁目公園南,0,42,42,35.683343,139.812161,2024-02-08 12:35:04
207,J1-23.清水池公園,9,14,23,35.623756,139.692517,2024-02-08 12:35:04
208,C5-18.パークタワー品川ベイワード,8,11,19,35.634529,139.748378,2024-02-08 12:35:04
209,E4-07.ファミリーマート 本駒込二丁目店,2,2,4,35.727279,139.74627,2024-02-08 12:35:04
210,C5-45.パークアクシス芝浦キャナル,1,8,9,35.644794,139.755688,2024-02-08 12:35:04
211,A2-02.西神田公園（北側）,5,4,9,35.698591,139.755113,2024-02-08 12:35:04
212,T2-49.善福寺公園テニスクラブ,5,4,9,35.719674,139.593696,2024-02-08 12:35:04
213,H1-193.ライフ豊洲店,27,1,28,35.651833,139.79962,2024-02-08 12:35:04
214,A2-01.神田駿河台下,52,1,53,35.695762,139.761585,2024-02-08 12:35:04
215,I1-51.京急鈴ヶ森駐車場,0,15,15,35.589573,139.735585,2024-02-08 12:35:04
216,T2-36.サントピア テニスパーク,4,6,10,35.75195,139.616028,2024-02-08 12:35:04
217,G4-13. Parking in 両国駅前第2,0,3,3,35.696492,139.791591,2024-02-08 12:35:04
218,K1-120.蒲田駅消費者生活センター横自転車駐車場 屋上部,6,0,6,35.560125,139.71569,2024-02-08 12:35:04
219,N3-18.藤和シティコープ新中野3,4,2,6,35.69942,139.673964,2024-02-08 12:35:04
220,K1-145.トヨタモビリティ東京馬込テクニカル研修センター,6,7,13,35.58209,139.701362,2024-02-08 12:35:04
221,K1-100.多摩川台公園,5,0,5,35.589794,139.666955,2024-02-08 12:35:04
222,C1-54.ニッセイ虎ノ門ビル,12,0,12,35.664344,139.746662,2024-02-08 12:35:04
223,I1-52.カスタリアタワー品川シーサイド,7,3,10,35.607557,139.746866,2024-02-08 12:35:04
224,I1-53.天王洲公園,3,1,4,35.620355,139.749339,2024-02-08 12:35:04
225,C2-18.ブランシェ東麻布,0,3,3,35.656769,139.743224,2024-02-08 12:35:04
226,A3-45.鍛冶町2丁目,12,5,17,35.691578,139.77138,2024-02-08 12:35:04
227,H1-87.パークアクシス木場キャナルウエスト,0,27,27,35.662514,139.803694,2024-02-08 12:35:04
228,D6-20.淀橋けやき橋公園,5,10,15,35.693544,139.685806,2024-02-08 12:35:04
229,A3-46.神田須田町2丁目,0,1,1,35.695457,139.772972,2024-02-08 12:35:04
230,B3-13.国立がん研究センター,11,0,11,35.664871,139.767188,2024-02-08 12:35:04
231,I1-35.シーフォートスクエア,18,0,18,35.622954,139.750593,2024-02-08 12:35:04
232,K1-55.カバヤビル,5,13,18,35.576275,139.713704,2024-02-08 12:35:04
233,C3-24.SHARE GREEN 南青山 西エントランス,0,7,7,35.668419,139.724676,2024-02-08 12:35:04
234,A5-06.APA HOTEL PRIDE〈国会議事堂前〉,10,0,10,35.674468,139.741328,2024-02-08 12:35:04
235,A6-17.東京ガーデンテラス紀尾井町（プリンス通り側）,12,0,12,35.680431,139.738203,2024-02-08 12:35:04
236,B4-07.勝どき駅地下駐輪場,58,3,61,35.658135,139.776131,2024-02-08 12:35:04
237,B4-08.東京ミッドベイ勝どき（西仲通り）,1,17,18,35.656449,139.771302,2024-02-08 12:35:04
238,B3-04.築地市場駅地下駐輪場,17,0,17,35.664265,139.767426,2024-02-08 12:35:04
239,C5-10.シーバンス,11,3,14,35.649959,139.756068,2024-02-08 12:35:04
240,H1-34.門前仲町駅,48,3,51,35.67391,139.796165,2024-02-08 12:35:04
241,C3-10.ファミリーマート特許庁前店,1,5,6,35.670364,139.744684,2024-02-08 12:35:04
242,A1-01.千代田区役所,6,0,6,35.693799,139.753281,2024-02-08 12:35:04
243,A1-03.東京区政会館（メトロA5出口）,7,0,7,35.701073,139.747525,2024-02-08 12:35:04
244,B3-06.朝日新聞東京本社,4,0,4,35.664457,139.767214,2024-02-08 12:35:04
245,A1-04.東京区政会館（西側駐輪場）,7,0,7,35.701347,139.746951,2024-02-08 12:35:04
246,T1-03.四季の香公園,5,0,5,35.760585,139.626284,2024-02-08 12:35:04
247,T1-04.春の風公園,3,0,3,35.75731,139.624922,2024-02-08 12:35:04
248,T1-05.夏の雲公園,5,0,5,35.753964,139.629116,2024-02-08 12:35:04
249,H1-194.セブン-イレブン江東北砂5丁目店,0,5,5,35.68268,139.8353,2024-02-08 12:35:04
250,O5-03.新高円寺地下自転車駐輪場,5,9,14,35.697265,139.649397,2024-02-08 12:35:04
251,O3-06.アミーズ荻窪,3,1,4,35.714616,139.625116,2024-02-08 12:35:04
252,T2-03.リヴィンオズ大泉店,7,1,8,35.752383,139.594855,2024-02-08 12:35:04
253,O6-06.上高井戸1丁目,0,7,7,35.673055,139.611293,2024-02-08 12:35:04
254,T2-05.石神井図書館,3,1,4,35.736076,139.599676,2024-02-08 12:35:04
255,T2-06.総合体育館,2,1,3,35.748957,139.621385,2024-02-08 12:35:04
256,O5-02.馬橋ハイツ,4,2,6,35.705686,139.642587,2024-02-08 12:35:04
257,N1-07.プランドール上鷺宮,1,6,7,35.733292,139.630369,2024-02-08 12:35:04
258,E1-18.アーバネックス小石川春日,0,8,8,35.709261,139.746374,2024-02-08 12:35:04
259,T3-03.新桜台駅自転車駐車場,4,3,7,35.740378,139.667502,2024-02-08 12:35:04
260,O3-05.Nちゃりパーク,17,5,22,35.70389,139.6185,2024-02-08 12:35:04
261,O5-01.朝霞ハイツ,7,4,11,35.71038,139.64519,2024-02-08 12:35:04
262,L1-11.アイムタウン上祖師谷,2,1,3,35.656849,139.594422,2024-02-08 12:35:04
263,L1-12.鈴木リースホーム駐車場,12,2,14,35.646648,139.633038,2024-02-08 12:35:04
264,L1-13.わびさびホステル,2,2,4,35.647393,139.667085,2024-02-08 12:35:04
265,G2-05.リアナスカイパーク押上,5,1,6,35.715733,139.815451,2024-02-08 12:35:04
266,T3-02.早宮第二自転車駐車場,8,3,11,35.756846,139.652154,2024-02-08 12:35:04
267,I1-37.ガーデンシティ品川御殿山,6,3,9,35.623466,139.734359,2024-02-08 12:35:04
268,T2-47.上石神井駅北第二自転車駐車場,6,4,10,35.726523,139.5905,2024-02-08 12:35:04
269,C1-51.環二新橋四丁目,9,3,12,35.663843,139.757697,2024-02-08 12:35:04
270,M6-07.笹塚東,14,7,21,35.675436,139.670594,2024-02-08 12:35:04
271,M3-10.ウノサワ東急ビル,8,0,8,35.647757,139.712981,2024-02-08 12:35:04
272,C2-26.一の橋公園,6,1,7,35.655367,139.738075,2024-02-08 12:35:04
273,H1-14.ホテルリブマックス東京潮見駅前,4,2,6,35.658351,139.818229,2024-02-08 12:35:04
274,D2-12.ヴィアイン飯田橋後楽園,0,14,14,35.705774,139.743366,2024-02-08 12:35:04
275,D3-08.ホテルリブマックス高田馬場駅前,8,0,8,35.712952,139.701356,2024-02-08 12:35:04
276,H1-103.清澄庭園,4,6,10,35.680948,139.796917,2024-02-08 12:35:04
277,H1-104.木場公園,0,19,19,35.676488,139.809616,2024-02-08 12:35:04
278,H1-105.猿江恩賜公園,7,1,8,35.692277,139.817491,2024-02-08 12:35:04
279,G4-07.ディアレイシャス両国,0,4,4,35.69955,139.803204,2024-02-08 12:35:04
280,T2-46.大泉郵便局バス停自転車駐車場,0,9,9,35.766491,139.587232,2024-02-08 12:35:04
281,I1-18.東品川公園,4,3,7,35.61379,139.746617,2024-02-08 12:35:04
282,J1-03.西郷山公園,5,1,6,35.650688,139.696696,2024-02-08 12:35:04
283,J1-02.駒場野公園,10,4,14,35.657718,139.681043,2024-02-08 12:35:04
284,D2-14.ローソン 神楽坂駅北店,0,16,16,35.704201,139.735815,2024-02-08 12:35:04
285,K1-65.下丸子3丁目,7,5,12,35.571711,139.685337,2024-02-08 12:35:04
286,T2-43.学園通り自転車駐車場,8,0,8,35.7547,139.5871,2024-02-08 12:35:04
287,I1-46.セブン-イレブン 品川東中延2丁目店,0,6,6,35.608721,139.714158,2024-02-08 12:35:04
288,T2-04.石神井公園駅南口,12,0,12,35.743354,139.606592,2024-02-08 12:35:04
289,J1-06.観音橋自転車置場,34,11,45,35.642251,139.69692,2024-02-08 12:35:04
290,J1-05.東山公園　北,0,13,13,35.64853,139.686309,2024-02-08 12:35:04
291,J1-45.プラウド中目黒,0,3,3,35.63767,139.7045,2024-02-08 12:35:04
292,H1-168.大島五丁目公園,11,2,13,35.68642,139.836151,2024-02-08 12:35:04
293,J1-47.本町みなみ街かど公園,3,14,17,35.61847,139.70019,2024-02-08 12:35:04
294,J1-48.グランドエクセル祐天寺,0,19,19,35.64372,139.68777,2024-02-08 12:35:04
295,K1-101.小池公園,0,5,5,35.599541,139.697962,2024-02-08 12:35:04
296,H1-171.LOGI’Q南砂町,6,3,9,35.672877,139.842339,2024-02-08 12:35:04
297,H1-153.三井リンクラボ新木場1,9,1,10,35.63851,139.823534,2024-02-08 12:35:04
298,H1-154.やぐら橋下,20,0,20,35.631132,139.792726,2024-02-08 12:35:04
299,Z21.コーナン川崎小田栄店,0,9,9,35.514643,139.706285,2024-02-08 12:35:04
300,D5-11.NTTコミュニケーションズ新宿ビル,3,6,9,35.699312,139.696468,2024-02-08 12:35:04
301,C5-31.ヒルトン東京お台場,3,7,10,35.626267,139.771438,2024-02-08 12:35:04
302,K1-78.城南鋳物団地協同組合,0,10,10,35.567562,139.766854,2024-02-08 12:35:04
303,Z05.ローソン川崎小田二丁目店,0,8,8,35.513548,139.697176,2024-02-08 12:35:04
304,I1-68.八潮公園第二,0,9,9,35.600003,139.754288,2024-02-08 12:35:04
305,I1-67.八潮公園第一,0,11,11,35.601149,139.754284,2024-02-08 12:35:04
306,H1-123.ダイワロイネットホテル東京有明,19,2,21,35.634316,139.793199,2024-02-08 12:35:04
307,J1-24.ボヌールREIWA,4,1,5,35.612389,139.676238,2024-02-08 12:35:04
308,B2-12.東京ダイヤビルディング（東側）,16,2,18,35.674835,139.785656,2024-02-08 12:35:04
309,J1-15.二の橋自転車置場2,15,1,16,35.614391,139.678396,2024-02-08 12:35:04
310,H1-77.ライフ東砂店,0,10,10,35.684641,139.844243,2024-02-08 12:35:04
311,D1-09.NTT四谷ビル,0,3,3,35.691188,139.712079,2024-02-08 12:35:04
312,E4-11.プライマル千石,0,14,14,35.727519,139.742815,2024-02-08 12:35:04
313,I1-23.東海橋防災船着場,0,14,14,35.616114,139.74033,2024-02-08 12:35:04
314,A4-12.東京ミッドタウン日比谷,4,0,4,35.674274,139.759111,2024-02-08 12:35:04
315,K1-46.池上駅前自転車駐車場,5,7,12,35.571478,139.702779,2024-02-08 12:35:04
316,I1-24.しながわ区民公園(中央口),2,12,14,35.593611,139.738056,2024-02-08 12:35:04
317,T2-13.セブン-イレブン 練馬石神井町8丁目店,0,5,5,35.750414,139.600011,2024-02-08 12:35:04
318,O3-04.アヴァンセ阿佐ヶ谷,2,0,2,35.712,139.62816,2024-02-08 12:35:04
319,B4-01.黎明橋公園（駐輪場）,2,10,12,35.656071,139.780068,2024-02-08 12:35:04
320,T2-32.セブン-イレブン 練馬東大泉NTTビル店,4,4,8,35.750761,139.594457,2024-02-08 12:35:04
321,K1-142.コーラル洗足池,9,1,10,35.604567,139.689096,2024-02-08 12:35:04
322,K1-28.鵜の木特別出張所,4,0,4,35.574886,139.685122,2024-02-08 12:35:04
323,T1-02.ホテルカデンツァ東京,12,0,12,35.755106,139.621675,2024-02-08 12:35:04
324,C2-16.ザ・ベルグレイヴィア麻布,0,7,7,35.657264,139.743821,2024-02-08 12:35:04
325,N3-11.上高田区民活動センター,3,2,5,35.711501,139.672761,2024-02-08 12:35:04
326,T3-30.北西大松公園,2,2,4,35.765979,139.64931,2024-02-08 12:35:04
327,D6-05.新宿中央公園（水の広場）,5,1,6,35.690474,139.690219,2024-02-08 12:35:04
328,D6-07.新宿フロントタワー,3,5,8,35.696387,139.689924,2024-02-08 12:35:04
329,T2-73.早実グラウンド記念公園,2,2,4,35.734615,139.576214,2024-02-08 12:35:04
330,O7-03.永福町西幸モータープール東,2,9,11,35.67156,139.64609,2024-02-08 12:35:04
331,D1-03.新左門児童遊園,0,5,5,35.684523,139.720519,2024-02-08 12:35:04
332,D1-04.四谷見附公園,0,31,31,35.683448,139.728425,2024-02-08 12:35:04
333,I1-54.天王洲オーシャンスクエア,12,3,15,35.622356,139.749468,2024-02-08 12:35:04
334,D6-01.新宿区役所本庁舎,44,1,45,35.693602,139.703229,2024-02-08 12:35:04
335,D6-02.新宿区役所第二分庁舎,34,0,34,35.693976,139.706134,2024-02-08 12:35:04
336,D6-03.新宿中央公園（ポケットパーク）,9,0,9,35.691559,139.690029,2024-02-08 12:35:04
337,D6-04.新宿中央公園（ちびっこ広場）,8,2,10,35.686649,139.689821,2024-02-08 12:35:04
338,A6-21.日本工営ビル,2,2,4,35.684584,139.734442,2024-02-08 12:35:04
339,I1-77.セブン-イレブン品川西中延1丁目店,0,19,19,35.612217,139.708164,2024-02-08 12:35:04
340,T1-01.光が丘駅前広場,11,2,13,35.759164,139.629466,2024-02-08 12:35:04
341,T2-37.上石神井2丁目,2,6,8,35.729615,139.59532,2024-02-08 12:35:04
342,I1-75.セブン-イレブン品川二葉4丁目店,0,6,6,35.603275,139.713428,2024-02-08 12:35:04
343,M5-13.セブン-イレブン初台店,0,15,15,35.675049,139.68444,2024-02-08 12:35:04
344,D6-24.ＮＴＴ東日本 本社ビル,9,3,12,35.683102,139.688852,2024-02-08 12:35:04
345,H1-134.豊洲ぐるり公園,10,12,22,35.643141,139.777821,2024-02-08 12:35:04
346,H1-133.北砂2丁目公園,0,27,27,35.679001,139.825809,2024-02-08 12:35:04
347,E3-08.サガラマンション,0,4,4,35.722833,139.734662,2024-02-08 12:35:04
348,O4-05.阿佐ヶ谷南1-30,1,2,3,35.700703,139.639985,2024-02-08 12:35:04
349,O5-06.EXAM高円寺南,5,0,5,35.70273,139.65864,2024-02-08 12:35:04
350,G2-03.押上１丁目２６-４,5,0,5,35.710323,139.815215,2024-02-08 12:35:04
351,K1-132.多摩川駅前自転車等駐車場,15,0,15,35.587232,139.669519,2024-02-08 12:35:04
352,C5-47.oak港南品川,23,2,25,35.62413,139.744831,2024-02-08 12:35:04
353,D3-15.カースルいずみ,6,8,14,35.711324,139.711976,2024-02-08 12:35:04
354,C5-15.セブン-イレブン 港区芝浦ふ頭店,0,8,8,35.640215,139.755971,2024-02-08 12:35:04
355,C5-14.セブン-イレブン 港区汐彩橋店,0,12,12,35.640481,139.753659,2024-02-08 12:35:04
356,D5-01.新宿コズミックセンター,0,8,8,35.705244,139.70841,2024-02-08 12:35:04
357,H1-45.夢の島競技場,18,2,20,35.648596,139.824936,2024-02-08 12:35:04
358,E1-01.後楽橋横,25,0,25,35.702746,139.752009,2024-02-08 12:35:04
359,B1-15.ロイヤルパークホテル,0,11,11,35.682332,139.78722,2024-02-08 12:35:04
360,C4-05.白金台駅自転車駐車場,5,10,15,35.638927,139.727083,2024-02-08 12:35:04
361,E1-02.東京ドーム（ミーツポート）,8,1,9,35.70311,139.754951,2024-02-08 12:35:04
362,M2-06.あいおいニッセイ同和損保恵比寿ビル,6,1,7,35.647237,139.71512,2024-02-08 12:35:04
363,J1-12.工大橋下流自転車置場,3,1,4,35.605828,139.680265,2024-02-08 12:35:04
364,C5-25.NEX-TEC芝浦,38,0,38,35.639571,139.755551,2024-02-08 12:35:04
365,H1-175.ダイアパレス大島駅前,0,2,2,35.689543,139.836394,2024-02-08 12:35:04
366,C1-65.東京ポートシティ竹芝,10,3,13,35.654757,139.761516,2024-02-08 12:35:04
367,O2-03.西荻北5-8-17,4,1,5,35.709712,139.601846,2024-02-08 12:35:04
368,B2-21.八重洲二丁目北地区広場,4,0,4,35.67942,139.77004,2024-02-08 12:35:04
369,I1-101.下神明駅前,25,0,25,35.60838,139.726587,2024-02-08 12:35:04
370,N2-04.野方2丁目,6,0,6,35.713018,139.656768,2024-02-08 12:35:04
371,N2-05.野方3丁目,0,12,12,35.717877,139.654732,2024-02-08 12:35:04
372,K1-88.大田久が原西郵便局,0,6,6,35.582756,139.6925,2024-02-08 12:35:04
373,C5-51.トミンタワー台場一番街,0,11,11,35.634627,139.77663,2024-02-08 12:35:04
374,C4-10.亀塚公園,10,0,10,35.642764,139.741174,2024-02-08 12:35:04
375,H1-190.福山通運 東京支店,0,27,27,35.664845,139.796643,2024-02-08 12:35:04
376,C1-80.浜松町262ビル,11,1,12,35.654289,139.75557,2024-02-08 12:35:04
377,B2-19.リエトコートアルクスタワー,0,10,10,35.670506,139.77854,2024-02-08 12:35:04
378,C1-79.髙松コンストラクショングループ 東京本社ビル,0,6,6,35.648765,139.753363,2024-02-08 12:35:04
379,C5-43.オアーゼ芝浦MJビル,7,2,9,35.644798,139.752697,2024-02-08 12:35:04
380,J1-44.五本木2丁目,1,7,8,35.634441,139.687186,2024-02-08 12:35:04
381,B2-17.アーバネックス八丁堀,3,0,3,35.67518,139.77364,2024-02-08 12:35:04
382,M6-16.パールマンション,2,0,2,35.67464,139.67876,2024-02-08 12:35:04
383,G4-06.ドムス・スタイル両国,0,7,7,35.700453,139.798978,2024-02-08 12:35:04
384,G2-04.ラ　ステュディオ押上,3,2,5,35.712157,139.815298,2024-02-08 12:35:04
385,T3-15.セブン-イレブン練馬北町8丁目店,6,0,6,35.768105,139.646049,2024-02-08 12:35:04
386,C1-77.芝公園,13,5,18,35.65513,139.749645,2024-02-08 12:35:04
387,I1-27.小関橋公園,2,2,4,35.620699,139.730904,2024-02-08 12:35:04
388,B3-01.中央区役所,5,1,6,35.670855,139.772052,2024-02-08 12:35:04
389,A6-08.二番町ガーデン,5,0,5,35.685489,139.734562,2024-02-08 12:35:04
390,B1-01.十思公園,0,10,10,35.691058,139.777915,2024-02-08 12:35:04
391,B4-02.月島特別出張所,0,42,42,35.662197,139.782719,2024-02-08 12:35:04
392,A4-05.大手町タワー,18,0,18,35.685938,139.764886,2024-02-08 12:35:04
393,H1-22.豊洲市場（7街区）,29,41,70,35.6447,139.784512,2024-02-08 12:35:04
394,A6-07.二番町センタービル,0,2,2,35.685966,139.736328,2024-02-08 12:35:04
395,A2-12.神保町三井ビルディング,10,0,10,35.694532,139.760695,2024-02-08 12:35:04
396,E2-06.oto no ha Cafe,0,4,4,35.713991,139.725665,2024-02-08 12:35:04
397,B4-10.リバーシティ,0,15,15,35.668795,139.784784,2024-02-08 12:35:04
398,B1-03.常盤公園（北側）,7,3,10,35.688405,139.770068,2024-02-08 12:35:04
399,C5-19.グランドメゾン田町,6,1,7,35.645537,139.754899,2024-02-08 12:35:04
400,K1-11.ファミリーマート かわだ多摩川２丁目店,0,4,4,35.558289,139.697403,2024-02-08 12:35:04
401,J1-43.アルコタワー・ホテル雅叙園東京,12,0,12,35.63237,139.712681,2024-02-08 12:35:04
402,N1-03.鷺宮南駐輪場,6,3,9,35.721827,139.635949,2024-02-08 12:35:04
403,N2-06.江古田1丁目B,1,5,6,35.72515,139.672614,2024-02-08 12:35:04
404,D7-12.プラウド高田馬場,4,1,5,35.715538,139.701683,2024-02-08 12:35:04
405,K1-118.久が原3丁目,0,9,9,35.580741,139.687152,2024-02-08 12:35:04
406,K1-125.池上駅南口第1,1,1,2,35.571866,139.703214,2024-02-08 12:35:04
407,K1-117.安詳寺,5,15,20,35.581798,139.695222,2024-02-08 12:35:04
408,I1-91.アクロス目黒タワー,8,2,10,35.634019,139.719749,2024-02-08 12:35:04
409,K1-126.池上駅南口第2,2,1,3,35.571815,139.702387,2024-02-08 12:35:04
410,C5-50.お台場レインボー公園,12,0,12,35.633133,139.777315,2024-02-08 12:35:04
411,T3-26.富士見ランド公園,0,8,8,35.73701,139.627244,2024-02-08 12:35:04
412,T1-15.つのの山緑地,4,0,4,35.765144,139.636606,2024-02-08 12:35:04
413,T1-16.ゆりの木通り南公園,3,1,4,35.767582,139.636304,2024-02-08 12:35:04
414,H1-185.UR大島六丁目団地(第二),1,2,3,35.690038,139.833252,2024-02-08 12:35:04
415,H1-186.セブン-イレブン亀戸昭和橋通り店,0,8,8,35.694804,139.831357,2024-02-08 12:35:04
416,K1-96.西馬込駅前自転車駐車場,9,5,14,35.586408,139.705425,2024-02-08 12:35:04
417,H1-184.UR大島六丁目団地(第一),2,4,6,35.689913,139.833279,2024-02-08 12:35:04
418,A6-25.麹町仮住宅,4,0,4,35.679192,139.74019,2024-02-08 12:35:04
419,C1-69.塩釜公園,0,10,10,35.662908,139.755014,2024-02-08 12:35:04
420,C1-68.桜田公園,29,0,29,35.665214,139.757008,2024-02-08 12:35:04
421,A2-14.興和一橋ビル,15,0,15,35.6927,139.759311,2024-02-08 12:35:04
422,C5-41.トヨタモビリティ東京 芝浦店,4,2,6,35.639644,139.745532,2024-02-08 12:35:04
423,T2-22.ファミリーマート 石神井台7丁目店,4,1,5,35.731909,139.579685,2024-02-08 12:35:04
424,A6-20.紀尾井町PREX,6,0,6,35.68369,139.736936,2024-02-08 12:35:04
425,C5-24.GLOBAL FRONT TOWER,0,13,13,35.647713,139.755534,2024-02-08 12:35:04
426,E5-09.文京区 男女平等センター,4,11,15,35.70861,139.75768,2024-02-08 12:35:04
427,K1-37.東京サーハウス前,17,4,21,35.563874,139.685011,2024-02-08 12:35:04
428,B4-15.リバーシティ　イーストタワーズ,0,18,18,35.669188,139.785301,2024-02-08 12:35:04
429,M6-08.Be Good 幡ヶ谷,0,13,13,35.682453,139.677687,2024-02-08 12:35:04
430,D5-09.ハウジングステージ新宿,6,7,13,35.702277,139.701214,2024-02-08 12:35:04
431,D6-21.新宿5丁目,2,5,7,35.691613,139.711233,2024-02-08 12:35:04
432,K1-39.東京モノレール 流通センター駅前,29,0,29,35.581752,139.748705,2024-02-08 12:35:04
433,K1-38.ネクストサイト蒲田ビル,9,0,9,35.558916,139.717253,2024-02-08 12:35:04
434,T3-17.練馬区役所東庁舎(第二),5,0,5,35.735585,139.652544,2024-02-08 12:35:04
435,H1-107.大島小松川公園,0,27,27,35.692641,139.846346,2024-02-08 12:35:04
436,B1-11.浜町川緑道,18,29,47,35.684158,139.787649,2024-02-08 12:35:04
437,A6-19.番町麹町ビルディング,12,0,12,35.685578,139.732078,2024-02-08 12:35:04
438,B3-12.築地場外市場,17,1,18,35.665254,139.769301,2024-02-08 12:35:04
439,I1-40.御殿山トラストタワー,26,0,26,35.622371,139.737457,2024-02-08 12:35:04
440,M5-08.古賀政男音楽博物館,2,0,2,35.668091,139.680243,2024-02-08 12:35:04
441,H1-90.富士倉庫運輸(株) FACE-1前,0,11,11,35.655102,139.805205,2024-02-08 12:35:04
442,A3-38.パークホームズ千代田淡路町,4,0,4,35.695163,139.769566,2024-02-08 12:35:04
443,D2-11.神楽坂アインスタワー,2,4,6,35.702833,139.739,2024-02-08 12:35:04
444,C2-04.飯倉いきいきプラザ,0,5,5,35.656991,139.740739,2024-02-08 12:35:04
445,B1-09.スマイルホテル日本橋三越前,18,0,18,35.686101,139.776089,2024-02-08 12:35:04
446,E5-15.文京千駄木の郷,7,4,11,35.726499,139.759884,2024-02-08 12:35:04
447,C2-05.ありすいきいきプラザ,9,4,13,35.651046,139.727745,2024-02-08 12:35:04
448,C5-06.品川シーズンテラス,19,0,19,35.632303,139.742393,2024-02-08 12:35:04
449,B1-10.箱崎川第二公園,6,3,9,35.680833,139.784267,2024-02-08 12:35:04
450,L1-15.ソフィア,0,3,3,35.663222,139.587803,2024-02-08 12:35:04
451,A3-12.秋葉原UDX北側駐輪場前,15,0,15,35.70111,139.772855,2024-02-08 12:35:04
452,A2-08.KDX御茶ノ水ビル,6,3,9,35.700568,139.76013,2024-02-08 12:35:04
453,A3-07.淡路公園,5,1,6,35.696942,139.767302,2024-02-08 12:35:04
454,A1-08.飯田橋サクラテラス（早稲田通り）,11,0,11,35.699132,139.74462,2024-02-08 12:35:04
455,A3-13.富士ソフトビル（駐車場入口横）,4,14,18,35.700486,139.774254,2024-02-08 12:35:04
456,A2-09.テラススクエア,8,0,8,35.6931,139.7599,2024-02-08 12:35:04
457,A6-11.東京ガーデンテラス紀尾井町,17,5,22,35.67962,139.7364,2024-02-08 12:35:04
458,K1-124.矢口2丁目,1,5,6,35.564161,139.695187,2024-02-08 12:35:04
459,N3-15.ライオンズマンション中野東,1,2,3,35.71046,139.6855,2024-02-08 12:35:04
460,M3-11.渋谷道玄坂東急ビル,8,2,10,35.65718,139.698687,2024-02-08 12:35:04
461,H1-180.シティコート大島,8,0,8,35.691954,139.836462,2024-02-08 12:35:04
462,B1-27.日本橋本町4丁目,24,4,28,35.68973,139.77598,2024-02-08 12:35:04
463,M3-22.森谷ビル,15,0,15,35.64514,139.71686,2024-02-08 12:35:04
464,N3-17.東中野3丁目,9,1,10,35.70862,139.680679,2024-02-08 12:35:04
465,N2-10.関根ビル,1,4,5,35.733432,139.671241,2024-02-08 12:35:04
466,T1-06.秋の陽公園,5,0,5,35.762326,139.635226,2024-02-08 12:35:04
467,N1-02.鷺宮東駐輪場,0,14,14,35.721556,139.640397,2024-02-08 12:35:04
468,K1-140.西馬込駅前自転車駐車場(奥),14,0,14,35.586382,139.705116,2024-02-08 12:35:04
469,H1-182.錦糸町プライムタワー,13,1,14,35.695695,139.820507,2024-02-08 12:35:04
470,E5-05.駒込地域活動センター,0,9,9,35.728644,139.752183,2024-02-08 12:35:04
471,M3-06.渋谷第一生命ビル,5,1,6,35.657556,139.704129,2024-02-08 12:35:04
472,T2-42.石神井公園駅北第二自転車駐車場,2,3,5,35.74553,139.608939,2024-02-08 12:35:04
473,K1-144.蒲田五丁目44番自転車駐車場,10,0,10,35.559809,139.716993,2024-02-08 12:35:04
474,M3-07.渋谷ファーストプレイス,10,0,10,35.65506,139.69384,2024-02-08 12:35:04
475,H1-74.タダノ教習センター,10,0,10,35.63848,139.832305,2024-02-08 12:35:04
476,Z22.みんちゅう京急川崎駅前駐輪場内ラックスペース,3,0,3,35.532615,139.700332,2024-02-08 12:35:04
477,H1-151.コスモリード錦糸町,0,9,9,35.701347,139.819973,2024-02-08 12:35:04
478,T2-23.セブン-イレブン 練馬南大泉5丁目店,6,0,6,35.750185,139.579216,2024-02-08 12:35:04
479,M4-13.J-cube,3,0,3,35.66616,139.70458,2024-02-08 12:35:04
480,T2-65.さくらの辻公園,0,5,5,35.734805,139.599906,2024-02-08 12:35:04
481,T2-24.セブン-イレブン 練馬インター店,0,27,27,35.754586,139.606409,2024-02-08 12:35:04
482,O5-05.モンテ・ベルテ,0,2,2,35.701454,139.650518,2024-02-08 12:35:04
483,J1-42.都立大学駅北口バス停前,4,5,9,35.618622,139.67596,2024-02-08 12:35:04
484,K1-97.トミンタワー多摩川二丁目,0,14,14,35.555561,139.704345,2024-02-08 12:35:04
485,D1-14.コモレ四谷,0,7,7,35.68752,139.72818,2024-02-08 12:35:04
486,K1-106.ファミリーマート上池台夫婦坂店,0,9,9,35.599329,139.703343,2024-02-08 12:35:04
487,J1-39.松見坂公園,0,10,10,35.655483,139.687325,2024-02-08 12:35:04
488,J1-40.西小山公園,5,3,8,35.616541,139.697369,2024-02-08 12:35:04
489,J1-38.林試の森公園 北,6,6,12,35.626355,139.700153,2024-02-08 12:35:04
490,I1-84.セブン-イレブン西品川2丁目店,0,3,3,35.613819,139.728418,2024-02-08 12:35:04
491,D6-26.セブン-イレブン新宿６丁目文化センター通り店,7,2,9,35.694951,139.708219,2024-02-08 12:35:04
492,T2-25.ファミリーマート 高野台二丁目店,0,5,5,35.746045,139.620087,2024-02-08 12:35:04
493,I1-85.GOODOFFICE品川,0,4,4,35.621081,139.741178,2024-02-08 12:35:04
494,K1-74.大田スタジアム,3,4,7,35.587423,139.753871,2024-02-08 12:35:04
495,C1-64.東京虎ノ門グローバルスクエア,3,2,5,35.669941,139.749261,2024-02-08 12:35:04
496,K1-72.ファミリーマート大森西四丁目店,0,7,7,35.573358,139.723105,2024-02-08 12:35:04
497,H1-118.ファミリーマート亀戸駅前店,6,5,11,35.69839,139.825484,2024-02-08 12:35:04
498,I1-62.天王洲Rim,0,6,6,35.622277,139.745638,2024-02-08 12:35:04
499,H1-40.深川東京モダン館,4,1,5,35.674076,139.795008,2024-02-08 12:35:04
500,H1-117.東京パークサイドビル,8,3,11,35.671225,139.808561,2024-02-08 12:35:04
501,J1-01.目黒区総合庁舎,8,1,9,35.640675,139.698088,2024-02-08 12:35:04
502,C5-16.品川インターシティ,23,0,23,35.626704,139.742174,2024-02-08 12:35:04
503,A1-12.北の丸スクエア,7,0,7,35.695515,139.750213,2024-02-08 12:35:04
504,H1-46.セブン-イレブン 江東枝川2丁目店,0,28,28,35.659287,139.807358,2024-02-08 12:35:04
505,A2-25.プラウド神田駿河台,10,3,13,35.698991,139.76091,2024-02-08 12:35:04
506,C5-49.プラウドタワー芝浦,0,15,15,35.638912,139.747422,2024-02-08 12:35:04
507,T3-25.北町みのり公園,0,4,4,35.767627,139.65243,2024-02-08 12:35:04
508,H1-75.ジオ深川住吉,0,10,10,35.684247,139.815638,2024-02-08 12:35:04
509,T1-09.ローソン練馬旭町一丁目店,3,2,5,35.765704,139.625178,2024-02-08 12:35:04
510,T2-26.ファミリーマート 大泉学園町四丁目店,0,8,8,35.767388,139.587625,2024-02-08 12:35:04
511,T2-27.ファミリーマート 大泉長久保通り店,2,3,5,35.773841,139.591456,2024-02-08 12:35:04
512,C3-19.明治記念館西,3,1,4,35.678179,139.720809,2024-02-08 12:35:04
513,I1-11.鮫洲入江広場,11,3,14,35.603984,139.744504,2024-02-08 12:35:04
514,I1-10.品川シーサイド公園第1,15,3,18,35.607717,139.749478,2024-02-08 12:35:04
515,I1-09.東品川海上公園第1,0,15,15,35.616633,139.748945,2024-02-08 12:35:04
516,D3-06.セブン-イレブン高田馬場3丁目中央店,0,7,7,35.713872,139.698301,2024-02-08 12:35:04
517,K1-40.大田文化の森,0,17,17,35.579649,139.720263,2024-02-08 12:35:04
518,C1-41.港区立エコプラザ,6,3,9,35.658709,139.757036,2024-02-08 12:35:04
519,I1-13.八潮北公園,0,12,12,35.613421,139.75375,2024-02-08 12:35:04
520,I1-12.しながわ区民公園（北側）,2,2,4,35.596091,139.740884,2024-02-08 12:35:04
521,T2-09.こぐれの森緑地,3,7,10,35.763741,139.588847,2024-02-08 12:35:04
522,T3-31.パークサイド関口,3,5,8,35.74097,139.63836,2024-02-08 12:35:04
523,H1-183.MFLP新木場1,4,0,4,35.643958,139.838358,2024-02-08 12:35:04
524,T2-33.ウインドヒルズ189,2,4,6,35.74642,139.581204,2024-02-08 12:35:04
525,T2-67.陽和病院,0,7,7,35.761211,139.603316,2024-02-08 12:35:04
526,H1-82.セブンｰイレブン 北砂3丁目明治通り店,0,21,21,35.683514,139.827081,2024-02-08 12:35:04
527,T2-60.武蔵関公園（第一）,9,0,9,35.724747,139.565817,2024-02-08 12:35:04
528,I1-48.NTT 東日本 関東病院(北側),5,4,9,35.632191,139.725002,2024-02-08 12:35:04
529,T2-58.立野公園,3,2,5,35.716776,139.577975,2024-02-08 12:35:04
530,I1-100.東急荏原中延駅駐輪場,3,4,7,35.610444,139.712333,2024-02-08 12:35:04
531,T2-56.大泉公園（第一）,2,2,4,35.77228,139.58325,2024-02-08 12:35:04
532,T2-55.大泉町もみじやま公園,0,3,3,35.767296,139.602321,2024-02-08 12:35:04
533,T2-54.土支田農業公園,0,9,9,35.760939,139.609264,2024-02-08 12:35:04
534,I1-44.大井三ツ又商店街入口,6,1,7,35.604606,139.734483,2024-02-08 12:35:04
535,T2-62.大泉井頭公園,6,4,10,35.746681,139.57754,2024-02-08 12:35:04
536,T2-61.武蔵関公園（第二）,4,0,4,35.727826,139.570056,2024-02-08 12:35:04
537,T3-09.学田公園,4,1,5,35.730428,139.648704,2024-02-08 12:35:04
538,K1-105.東糀谷二丁目児童公園,0,8,8,35.555702,139.740802,2024-02-08 12:35:04
539,Z02.NTT渡田ビル,2,4,6,35.513644,139.712594,2024-02-08 12:35:04
540,T3-04.サンパレス平和台,8,4,12,35.759827,139.659121,2024-02-08 12:35:04
541,K1-104.六郷BASE,1,5,6,35.543573,139.714393,2024-02-08 12:35:04
542,M4-16.神宮前6丁目,2,1,3,35.668673,139.702816,2024-02-08 12:35:04
543,K1-69.京急平和島第2Bバイク駐輪場,0,7,7,35.585747,139.735242,2024-02-08 12:35:04
544,H1-155.メブクス豊洲,12,8,20,35.645726,139.784496,2024-02-08 12:35:04
545,C2-11.一の橋,8,45,53,35.654726,139.737491,2024-02-08 12:35:04
546,C4-11.ザ・パークハウス 三田ガーデン,0,14,14,35.64816,139.737991,2024-02-08 12:35:04
547,H1-161.昭文社制作本部ビル,4,2,6,35.684003,139.794983,2024-02-08 12:35:04
548,N2-07.新井区民活動センター,1,4,5,35.714292,139.663327,2024-02-08 12:35:04
549,K1-87.羽田イノベーションシティ,2,8,10,35.547061,139.756277,2024-02-08 12:35:04
550,N3-16.COURT 5,5,0,5,35.699743,139.664608,2024-02-08 12:35:04
551,C4-01.高輪地区総合支所(5F),1,10,11,35.641833,139.734519,2024-02-08 12:35:04
552,C5-48.セブンイレブン港区海岸三丁目店,0,8,8,35.636808,139.752517,2024-02-08 12:35:04
553,H1-42.江東区スポーツ会館,0,29,29,35.683961,139.821559,2024-02-08 12:35:04
554,B2-10.東京ダイヤビルディング（北側）,0,12,12,35.675702,139.785229,2024-02-08 12:35:04
555,H1-43.東京イースト21,0,18,18,35.675639,139.815255,2024-02-08 12:35:04
556,B3-20.歌舞伎座タワー駐輪場2F,6,0,6,35.670106,139.768041,2024-02-08 12:35:04
557,B3-21.歌舞伎座タワー駐輪場3F,11,0,11,35.6701,139.76801,2024-02-08 12:35:04
558,Z06.ローソン川崎殿町店,5,8,13,35.537434,139.744509,2024-02-08 12:35:04
559,K1-139.プラットホステル京急 羽田ホーム,8,2,10,35.548104,139.748889,2024-02-08 12:35:04
560,J1-58.目黒女子会館前,3,2,5,35.629011,139.69716,2024-02-08 12:35:04
561,T2-18.ファミリーマート練馬西税務署前店,2,2,4,35.745505,139.580878,2024-02-08 12:35:04
562,C3-23.LIFORK 南青山 北エントランス,14,15,29,35.669916,139.725701,2024-02-08 12:35:04
563,C1-46.新虎通りCORE,15,2,17,35.665124,139.754054,2024-02-08 12:35:04
564,C1-45.浜松町クレアタワー,16,3,19,35.656324,139.755927,2024-02-08 12:35:04
565,K1-53.セブン-イレブン 田園調布郵便局前店,16,4,20,35.589309,139.678587,2024-02-08 12:35:04
566,K1-52.大田区総合体育館,7,0,7,35.564152,139.727422,2024-02-08 12:35:04
567,T1-12.ファミリーマート 高松六丁目店,3,1,4,35.756873,139.616612,2024-02-08 12:35:04
568,D7-07.ローソン 新宿西落合三丁目店,0,5,5,35.725171,139.675897,2024-02-08 12:35:04
569,A6-16.一番町第二TGビル,3,2,5,35.688351,139.744321,2024-02-08 12:35:04
570,C3-33.PASONA SQUARE,13,0,13,35.667462,139.716058,2024-02-08 12:35:04
571,A3-24.岩本町ほほえみプラザ,0,11,11,35.69441,139.777715,2024-02-08 12:35:04
572,H1-35.ヒューリック豊洲プライムスクエア,7,0,7,35.652376,139.797724,2024-02-08 12:35:04
573,C5-11.フェイバリッチタワー品川,0,57,57,35.631729,139.749767,2024-02-08 12:35:04
574,E2-13.デルックス文京神楽坂,1,3,4,35.70781,139.732227,2024-02-08 12:35:04
575,C5-01.こうなん星の公園,46,0,46,35.629697,139.742167,2024-02-08 12:35:04
576,C5-02.港南緑水公園,0,80,80,35.628955,139.750731,2024-02-08 12:35:04
577,A3-22.龍閑児童公園,1,7,8,35.693234,139.779702,2024-02-08 12:35:04
578,A3-21.神田ふれあい通り第３,7,5,12,35.695176,139.772832,2024-02-08 12:35:04
579,H1-30.江東区役所（北側）,9,3,12,35.67338,139.8164,2024-02-08 12:35:04
580,C1-17.港区役所,4,0,4,35.657866,139.751068,2024-02-08 12:35:04
581,H1-31.江東区役所（南側）,17,0,17,35.67214,139.8166,2024-02-08 12:35:04
582,C1-09.愛宕グリーンヒルズ,9,0,9,35.662051,139.748132,2024-02-08 12:35:04
583,D1-02.四谷特別出張所（新宿御苑大木戸門前）,16,1,17,35.687435,139.714169,2024-02-08 12:35:04
584,D1-01.花園西公園,4,1,5,35.690612,139.711631,2024-02-08 12:35:04
585,C1-04.虎ノ門ヒルズ,12,2,14,35.666527,139.748804,2024-02-08 12:35:04
586,C1-05.西新橋2丁目（新虎通り）,14,0,14,35.665593,139.752617,2024-02-08 12:35:04
587,C1-73.日比谷フォートタワー,14,0,14,35.669871,139.753147,2024-02-08 12:35:04
588,K1-102.上池台四丁目公園,0,7,7,35.595119,139.6996,2024-02-08 12:35:04
589,M2-01.恵比寿保健相談所（恵比寿社会教育館）,0,14,14,35.64524,139.71946,2024-02-08 12:35:04
590,I1-98.コーポ荏原,0,6,6,35.60411,139.709784,2024-02-08 12:35:04
591,C3-17.セブン-イレブン 港区溜池山王店,1,17,18,35.670308,139.743242,2024-02-08 12:35:04
592,T2-11.石神井松の風文化公園,2,1,3,35.739471,139.595578,2024-02-08 12:35:04
593,M2-03.サイカパーク恵比寿,15,0,15,35.646581,139.710613,2024-02-08 12:35:04
594,M2-02.アメリカ橋公園,7,1,8,35.643606,139.713099,2024-02-08 12:35:04
595,T2-50.North Ridge 吉祥寺,8,1,9,35.72305,139.579555,2024-02-08 12:35:04
596,J1-35.目黒川田道街かど公園,5,1,6,35.634574,139.710332,2024-02-08 12:35:04
597,H1-174.ジュネス(エントランス側),0,2,2,35.682712,139.823961,2024-02-08 12:35:04
598,M6-17.笹塚一丁目駐輪場,1,6,7,35.672922,139.668729,2024-02-08 12:35:04
599,C4-14.神応ほっとプラザ,3,7,10,35.643711,139.724753,2024-02-08 12:35:04
600,K1-107.馬込駅A2出口,5,5,10,35.596854,139.712139,2024-02-08 12:35:04
601,T3-11.ガラクタ公園,1,2,3,35.740321,139.631256,2024-02-08 12:35:04
602,T2-80.みその緑地,2,3,5,35.756825,139.590528,2024-02-08 12:35:04
603,T3-24.AZEST新桜台,5,2,7,35.743962,139.670315,2024-02-08 12:35:04
604,D4-07.新宿余丁町ビル,0,9,9,35.698512,139.716482,2024-02-08 12:35:04
605,Z23.NA川崎南町,4,0,4,35.524976,139.697495,2024-02-08 12:35:04
606,T3-01.練馬春日町駅自転車駐車場,7,0,7,35.751438,139.641265,2024-02-08 12:35:04
607,H1-89.BUDDY スポーツアリーナ,7,7,14,35.637041,139.781088,2024-02-08 12:35:04
608,E5-14.上野広小路駅（湯島側）,0,13,13,35.707313,139.771857,2024-02-08 12:35:04
609,H1-109.Brillia ist 東雲キャナルコート東側,0,47,47,35.648008,139.803487,2024-02-08 12:35:04
610,H1-108.Brillia ist 東雲キャナルコート北側,0,21,21,35.648431,139.803125,2024-02-08 12:35:04
611,C1-53.ホテルリブマックス新橋,4,0,4,35.661149,139.754612,2024-02-08 12:35:04
612,D7-10.染の里 おちあい,1,5,6,35.715211,139.689788,2024-02-08 12:35:04
613,A1-15.富士見みらい館,0,6,6,35.697167,139.745629,2024-02-08 12:35:04
614,E4-15.千石4丁目,2,3,5,35.729153,139.741368,2024-02-08 12:35:04
615,H1-111.ファミリーマート木場六丁目店,0,9,9,35.66688,139.80779,2024-02-08 12:35:04
616,C5-36.お台場海浜公園駅,3,0,3,35.62974,139.778178,2024-02-08 12:35:04
617,H1-10.出会い橋,15,0,15,35.625029,139.777344,2024-02-08 12:35:04
618,H1-11.テレコムセンター駅,7,14,21,35.61813,139.778698,2024-02-08 12:35:04
619,H1-47.トピレックプラザ,0,37,37,35.672481,139.835877,2024-02-08 12:35:04
620,H1-13.アーバンドック ららぽーと豊洲,19,0,19,35.654067,139.792376,2024-02-08 12:35:04
621,T2-66.大泉学園町希望ヶ丘公園,0,4,4,35.778605,139.588883,2024-02-08 12:35:04
622,C5-37.台場駅,0,24,24,35.626388,139.772453,2024-02-08 12:35:04
623,H1-16.豊洲三丁目公園,19,0,19,35.657477,139.796629,2024-02-08 12:35:04
624,H1-17.東雲水辺公園,0,69,69,35.64704,139.80469,2024-02-08 12:35:04
625,C1-72.新田町ビル,10,1,11,35.646307,139.746428,2024-02-08 12:35:04
626,K1-98.鵜の木松山公園,2,5,7,35.577433,139.680752,2024-02-08 12:35:04
627,C1-71.芝商業高校前交差点,0,5,5,35.65583,139.759896,2024-02-08 12:35:04
628,H1-122.東砂スポーツセンター,0,11,11,35.679167,139.839746,2024-02-08 12:35:04
629,O6-05.コージーコート久我山,0,5,5,35.687531,139.60439,2024-02-08 12:35:04
630,T2-39.ローソン 練馬大泉町五丁目店,7,1,8,35.758929,139.597548,2024-02-08 12:35:04
631,J1-50.大岡山公園,2,2,4,35.609958,139.684087,2024-02-08 12:35:04
632,J1-51.池尻大橋駅東口駐輪場,0,5,5,35.650627,139.687228,2024-02-08 12:35:04
633,K1-99.東原くすのき公園,7,1,8,35.584086,139.67898,2024-02-08 12:35:04
634,N3-12.桃園区民活動センター,2,1,3,35.702414,139.667327,2024-02-08 12:35:04
635,H1-191.三井リンクラボ新木場2,14,0,14,35.644863,139.831107,2024-02-08 12:35:04
636,M5-09.代々木上原駅前,5,0,5,35.66865,139.679251,2024-02-08 12:35:04
637,O3-09.NTT井草ビル第3ポート,4,3,7,35.714151,139.61693,2024-02-08 12:35:04
638,T1-07.土支田一丁目（笹目通り）,2,8,10,35.765913,139.619285,2024-02-08 12:35:04
639,K1-22.矢口特別出張所,2,3,5,35.562324,139.690486,2024-02-08 12:35:04
640,T3-08.中新井川児童遊園,2,5,7,35.728268,139.649188,2024-02-08 12:35:04
641,H1-78.ローソン新木場一丁目店,14,0,14,35.645604,139.834941,2024-02-08 12:35:04
642,A6-13.番町会館,5,1,6,35.689131,139.733071,2024-02-08 12:35:04
643,H1-71.セブン-イレブン 江東東陽4丁目,0,4,4,35.670906,139.819386,2024-02-08 12:35:04
644,D2-09.セブン-イレブン 新宿岩戸町店,3,0,3,35.700993,139.736355,2024-02-08 12:35:04
645,I1-08.天王洲アイル第一水辺広場,26,5,31,35.622294,139.751644,2024-02-08 12:35:04
646,I1-07.しながわ水族館,1,15,16,35.590641,139.736354,2024-02-08 12:35:04
647,D3-09.西早稲田3丁目,2,2,4,35.712545,139.713319,2024-02-08 12:35:04
648,E1-16.小石川3丁目緑地,0,21,21,35.714338,139.746346,2024-02-08 12:35:04
649,C5-28.芝浦ルネサイトタワー,7,0,7,35.643683,139.7506,2024-02-08 12:35:04
650,I1-59.文庫の森第一,13,9,22,35.612357,139.721484,2024-02-08 12:35:04
651,I1-60.文庫の森第二,0,5,5,35.611368,139.720424,2024-02-08 12:35:04
652,C1-38.KDX西新橋ビル（西側）,2,3,5,35.66495,139.750459,2024-02-08 12:35:04
653,C1-37.KDX西新橋ビル（北側）,5,0,5,35.665218,139.750827,2024-02-08 12:35:04
654,T2-14.NPC24H東大泉第6パーキング,0,6,6,35.747807,139.593599,2024-02-08 12:35:04
655,C3-12.赤坂センタービルディング前（青山通り）,4,4,8,35.676732,139.733905,2024-02-08 12:35:04
656,H1-36.フジゴルフセンター,0,22,22,35.66605,139.806699,2024-02-08 12:35:04
657,C1-27.虎ノ門2丁目タワー,14,0,14,35.668547,139.747175,2024-02-08 12:35:04
658,C5-12.第2東運ビル,5,3,8,35.633742,139.748281,2024-02-08 12:35:04
659,D6-08.新宿イーストサイドスクエア,6,1,7,35.697158,139.707887,2024-02-08 12:35:04
660,A4-08.永代通り（大手町駅B2c出口前）,24,0,24,35.684349,139.766958,2024-02-08 12:35:04
661,H1-37.東雲駅（東京湾岸道路）,32,3,35,35.640618,139.802455,2024-02-08 12:35:04
662,C3-11.赤坂見附南,1,0,1,35.676566,139.737083,2024-02-08 12:35:04
663,M6-04.本町東べんてん橋公園,0,20,20,35.687126,139.680702,2024-02-08 12:35:04
664,I1-79.品川浦第二,11,4,15,35.621904,139.741429,2024-02-08 12:35:04
665,K1-81.コーナン本羽田萩中店,10,3,13,35.549568,139.731093,2024-02-08 12:35:04
666,D6-25.新宿駅東南口自転車駐輪場,29,3,32,35.689755,139.701323,2024-02-08 12:35:04
667,I1-78.セブン-イレブン西大井店,3,8,11,35.601431,139.718659,2024-02-08 12:35:04
668,H1-136.東砂一丁目公園,0,17,17,35.683542,139.839763,2024-02-08 12:35:04
669,A6-23.セブン-イレブン 千代田三番町店,0,14,14,35.689466,139.745316,2024-02-08 12:35:04
670,C5-34.五色橋ビル,0,13,13,35.636644,139.751798,2024-02-08 12:35:04
671,K1-41.郷土博物館,0,12,12,35.588644,139.710413,2024-02-08 12:35:04
672,G2-06.ディアレイシャス押上スカイヴィレッジ,0,5,5,35.71408,139.810588,2024-02-08 12:35:04
673,O3-11.ハイリビング関根,6,2,8,35.707877,139.618926,2024-02-08 12:35:04
674,O7-02.永福中央公園,6,0,6,35.67121,139.64145,2024-02-08 12:35:04
675,K1-29.萩中文化センター,3,6,9,35.55017,139.728146,2024-02-08 12:35:04
676,K1-30.テクノFRONT森ケ崎,2,2,4,35.567922,139.746181,2024-02-08 12:35:04
677,K1-130.COCOONひろば平和島,15,3,18,35.578728,139.735238,2024-02-08 12:35:04
678,H1-81.豊洲IHIビル（北側）,21,0,21,35.659829,139.793243,2024-02-08 12:35:04
679,E4-03.昭和小学校北側（不忍通り）,25,8,33,35.73166,139.748625,2024-02-08 12:35:04
680,C2-12.六本木ファーストビル,15,0,15,35.66249,139.741397,2024-02-08 12:35:04
681,D3-16.セジョリ江戸川橋,5,10,15,35.708734,139.730509,2024-02-08 12:35:04
682,A5-04.日比谷パークフロント前　日比谷公園南面向い歩道上,6,2,8,35.671514,139.753952,2024-02-08 12:35:04
683,C3-22.OMO3東京赤坂 by 星野リゾート,8,0,8,35.674929,139.736053,2024-02-08 12:35:04
684,B1-20.竜閑さくら橋際街角広場,0,18,18,35.688301,139.768958,2024-02-08 12:35:04
685,H1-83.ローソン江東東雲店,0,14,14,35.642165,139.800439,2024-02-08 12:35:04
686,H1-84.NTT東日本辰巳ビル,0,20,20,35.647091,139.817333,2024-02-08 12:35:04
687,C5-26.ピアシティ芝浦ビル,9,5,14,35.644155,139.756216,2024-02-08 12:35:04
688,T3-28.ほしぞら緑地,0,3,3,35.755137,139.661208,2024-02-08 12:35:04
689,I1-88.セブン-イレブン品川南大井3丁目店,1,1,2,35.58768,139.734515,2024-02-08 12:35:04
690,I1-87.セブン-イレブン西大井滝王子通り店,0,8,8,35.599774,139.723467,2024-02-08 12:35:04
691,Z20.川崎キングスカイフロント 東急 REI ホテル,0,10,10,35.540589,139.752918,2024-02-08 12:35:04
692,G4-11.ホテルマイステイズ浅草,19,3,22,35.703972,139.797327,2024-02-08 12:35:04
693,C5-30.フェイム芝浦インターウェーブ,0,11,11,35.647872,139.75391,2024-02-08 12:35:04
694,M6-13.JICA東京,9,3,12,35.673409,139.675203,2024-02-08 12:35:04
695,A4-13.アーバンネット大手町ビル,5,0,5,35.68557,139.766929,2024-02-08 12:35:04
696,B4-27.リバーシティ西ブロック,11,7,18,35.670491,139.784447,2024-02-08 12:35:04
697,K1-143.大森北1丁目,59,0,59,35.584914,139.730504,2024-02-08 12:35:04
698,E5-24.本郷6丁目,3,2,5,35.712445,139.758157,2024-02-08 12:35:04
699,D2-17.genten市ヶ谷店,10,0,10,35.690657,139.73255,2024-02-08 12:35:04
700,A4-14.東京国際フォーラム（有楽町駅ガード側）,8,0,8,35.675739,139.763712,2024-02-08 12:35:04
701,A2-27.丸紅ビル,6,0,6,35.690958,139.759876,2024-02-08 12:35:04
702,K1-135.北千束2丁目,4,2,6,35.608633,139.693653,2024-02-08 12:35:04
703,A1-19.九段会館テラス,4,0,4,35.694065,139.751801,2024-02-08 12:35:04
704,K1-136.BIG FUN 平和島,0,9,9,35.585489,139.740194,2024-02-08 12:35:04
705,K1-137.京浜島つばさ公園,0,14,14,35.571578,139.770532,2024-02-08 12:35:04
706,D1-16.ルネ新宿御苑タワー,7,3,10,35.690155,139.713377,2024-02-08 12:35:04
707,G6-01.オーキッドレジデンス森下,3,4,7,35.692547,139.799231,2024-02-08 12:35:04
708,T2-63.三原台公園,1,6,7,35.751471,139.599835,2024-02-08 12:35:04
709,O4-01.阿佐ヶ谷南公園,1,1,2,35.70328,139.62981,2024-02-08 12:35:04
710,B4-11.ダンスキューブ勝どき,0,16,16,35.656565,139.775073,2024-02-08 12:35:04
711,D1-06.四谷第六小学校北,10,0,10,35.681754,139.715256,2024-02-08 12:35:04
712,T2-64.高野台中央公園,1,2,3,35.746768,139.613885,2024-02-08 12:35:04
713,H1-169.セブンイレブン江東亀戸7丁目東店,0,10,10,35.697157,139.839835,2024-02-08 12:35:04
714,H1-170.セブンイレブン江東亀戸7丁目南店,0,31,31,35.695937,139.838017,2024-02-08 12:35:04
715,B2-16.ホテルサードニクス東京,5,0,5,35.67684,139.77876,2024-02-08 12:35:04
716,I1-93.中央海浜公園前交差点（南側）,4,1,5,35.595498,139.750654,2024-02-08 12:35:04
717,I1-92.中央海浜公園前交差点（北側）,10,0,10,35.595873,139.75134,2024-02-08 12:35:04
718,B1-26.Dash Living Nihonbashi,3,3,6,35.68802,139.78112,2024-02-08 12:35:04
719,H1-158.東京国際交流館,11,1,12,35.621845,139.776833,2024-02-08 12:35:04
720,J1-32.緑が丘駅前高架下,7,0,7,35.606793,139.678372,2024-02-08 12:35:04
721,K1-90.ファミリーマート大田仲池上一丁目店,1,5,6,35.5873,139.701644,2024-02-08 12:35:04
722,K1-91.穴守稲荷神社,4,6,10,35.550027,139.74973,2024-02-08 12:35:04
723,C1-67.京阪神 虎ノ門ビル,16,5,21,35.669228,139.751668,2024-02-08 12:35:04
724,K1-89.ファミリーマート大田千鳥三丁目店,3,2,5,35.572086,139.68708,2024-02-08 12:35:04
725,I1-97.トミンハイム東品川三丁目第二,15,4,19,35.613387,139.749307,2024-02-08 12:35:04
726,T2-51.練馬区役所石神井庁舎,10,0,10,35.743772,139.603317,2024-02-08 12:35:04
727,T2-75.石神井台二丁目緑地,3,0,3,35.734684,139.593628,2024-02-08 12:35:04
728,E5-19.千駄木公園,0,7,7,35.728333,139.757629,2024-02-08 12:35:04
729,E5-18.団子坂上広場,0,11,11,35.724921,139.75903,2024-02-08 12:35:04
730,A5-07.富国生命ビル,3,3,6,35.670452,139.75557,2024-02-08 12:35:04
731,H1-156.つどい橋下,0,9,9,35.630791,139.787396,2024-02-08 12:35:04
732,H1-159.夢の大橋西,16,0,16,35.627599,139.782953,2024-02-08 12:35:04
733,H1-143.ダイバーシティ東京 プラザ,8,2,10,35.624619,139.776006,2024-02-08 12:35:04
734,I1-57.大井水神公園,71,3,74,35.589972,139.729368,2024-02-08 12:35:04
735,B2-15.KABUTO ONE,6,0,6,35.68168,139.77825,2024-02-08 12:35:04
736,K1-64.多摩川グリーンスクエア,0,17,17,35.545459,139.719489,2024-02-08 12:35:04
737,Z07.ローソン川崎渡田三丁目店,0,4,4,35.519137,139.705791,2024-02-08 12:35:04
738,T2-57.大泉公園（第二）,5,1,6,35.771708,139.583551,2024-02-08 12:35:04
739,A4-06.大手町ファーストスクエア,10,0,10,35.686037,139.764472,2024-02-08 12:35:04
740,C1-50.NTT虎ノ門ビル,11,3,14,35.666075,139.748008,2024-02-08 12:35:04
741,C1-23.三田いきいきプラザ,9,1,10,35.648637,139.749834,2024-02-08 12:35:04
742,H1-29.スカイズタワー＆ガーデン,0,75,75,35.647618,139.792152,2024-02-08 12:35:04
743,C1-21.汐留ビルディング,5,5,10,35.657363,139.75918,2024-02-08 12:35:04
744,A3-16.地蔵橋東児童遊園,2,4,6,35.691069,139.775376,2024-02-08 12:35:04
745,Z08.ファミリーマート観音二丁目店,0,10,10,35.526238,139.72907,2024-02-08 12:35:04
746,A3-18.美倉橋北児童遊園,0,11,11,35.69703,139.779928,2024-02-08 12:35:04
747,A4-01.丸ビル（南側駐輪場）,11,0,11,35.680514,139.764002,2024-02-08 12:35:04
748,A3-11.練成公園,0,8,8,35.703735,139.770629,2024-02-08 12:35:04
749,A3-10.芳林公園（北側）,0,9,9,35.701978,139.7698,2024-02-08 12:35:04
750,A6-02.いきいきプラザ一番町（西側駐輪場）,4,4,8,35.687031,139.739327,2024-02-08 12:35:04
751,A6-01.東郷元帥記念公園（南側）,3,2,5,35.689879,139.740178,2024-02-08 12:35:04
752,A5-03.参議院第二別館（永田町駅2番出口）,10,6,16,35.677763,139.74271,2024-02-08 12:35:04
753,A4-03.東京国際フォーラム（メトロD5出口）,8,0,8,35.675843,139.763329,2024-02-08 12:35:04
754,K1-15.セブン‐イレブン 大田区西蒲田店,3,0,3,35.56694,139.716331,2024-02-08 12:35:04
755,K1-49.ローソン仲池上一丁目店,1,9,10,35.586585,139.698552,2024-02-08 12:35:04
756,A2-06.東光電気工事 別館（屋内駐輪場）,7,0,7,35.69919,139.75701,2024-02-08 12:35:04
757,M4-01.新宿タカシマヤ,5,1,6,35.68714,139.702775,2024-02-08 12:35:04
758,M4-03.NTTドコモ代々木ビル,6,4,10,35.684451,139.702884,2024-02-08 12:35:04
759,M3-03.代官山 T-SITE,6,2,8,35.649823,139.700139,2024-02-08 12:35:04
760,K1-14.大森地域庁舎,7,2,9,35.578239,139.723262,2024-02-08 12:35:04
761,C5-46.ウエリスアーバン品川タワー,0,22,22,35.630961,139.746875,2024-02-08 12:35:04
762,C4-13.コシダコネクトビル,0,15,15,35.637765,139.739128,2024-02-08 12:35:04
763,K1-127.第二石井ビル,5,0,5,35.559286,139.722611,2024-02-08 12:35:04
764,C1-74.札の辻スクエア,6,2,8,35.645155,139.744543,2024-02-08 12:35:04
765,H1-164.森下三丁目第三児童遊園,0,19,19,35.68546,139.80244,2024-02-08 12:35:04
766,C1-78.CIRCLES新橋,7,2,9,35.66646,139.752138,2024-02-08 12:35:04
767,C3-34.3rd MINAMI AOYAMA,6,0,6,35.668622,139.715957,2024-02-08 12:35:04
768,O4-06.杉並区役所本庁舎,3,2,5,35.699328,139.636343,2024-02-08 12:35:04
769,D3-14.コーシャハイム高田馬場,5,1,6,35.712413,139.70168,2024-02-08 12:35:04
770,D7-11.新宿清掃事務所,2,4,6,35.716359,139.704377,2024-02-08 12:35:04
771,D5-08.ウエリス新宿早稲田の森,0,10,10,35.704597,139.708397,2024-02-08 12:35:04
772,E2-12.水道2丁目,0,29,29,35.709147,139.739183,2024-02-08 12:35:04
773,M6-10.京王コインパーク幡ヶ谷,0,11,11,35.6772,139.678117,2024-02-08 12:35:04
774,E3-05.文京スポーツセンター,49,11,60,35.721045,139.735687,2024-02-08 12:35:04
775,J1-36.WJ Haus,0,7,7,35.629067,139.711779,2024-02-08 12:35:04
776,K1-51.テクノポートカマタ 第2,11,0,11,35.555808,139.722791,2024-02-08 12:35:04
777,D1-13.新宿御苑新宿門【西側】,0,22,22,35.688945,139.706536,2024-02-08 12:35:04
778,I1-31.セブン-イレブン 品川戸越5丁目店,3,3,6,35.608193,139.719139,2024-02-08 12:35:04
779,T3-27.貫井川緑地,1,3,4,35.738427,139.632251,2024-02-08 12:35:04
780,H1-147.大島四丁目団地,9,8,17,35.68744,139.827075,2024-02-08 12:35:04
781,O4-02.成宗さくら公園,2,0,2,35.69638,139.63482,2024-02-08 12:35:04
782,O1-01.上瀬戸公園,3,1,4,35.72077,139.6045,2024-02-08 12:35:04
783,T2-15.NPC24H大泉学園南口パーキング,10,0,10,35.748611,139.584251,2024-02-08 12:35:04
784,O3-03.桃井1丁目5番地,6,1,7,35.71013,139.61194,2024-02-08 12:35:04
785,H1-08.東京テレポート駅,16,28,44,35.627087,139.779779,2024-02-08 12:35:04
786,H1-05.相鉄グランドフレッサ 東京ベイ有明,14,0,14,35.632148,139.79017,2024-02-08 12:35:04
787,H1-06.武蔵野大学,2,13,15,35.630185,139.786618,2024-02-08 12:35:04
788,A4-15.TOKIWAブリッジ,9,0,9,35.686389,139.769237,2024-02-08 12:35:04
789,H1-160.花の広場,8,9,17,35.633908,139.793322,2024-02-08 12:35:04
790,H1-01.豊洲ＩＨＩビル前（晴海通り）,10,0,10,35.658911,139.792531,2024-02-08 12:35:04
791,H1-02.豊洲駅,16,0,16,35.654196,139.79626,2024-02-08 12:35:04
792,J1-19.NTT東日本自由が丘ビル,3,1,4,35.615098,139.675954,2024-02-08 12:35:04
793,C2-19.広尾駅,5,0,5,35.650732,139.72256,2024-02-08 12:35:04
794,H1-114.東京夢の島マリーナ,5,10,15,35.651987,139.830691,2024-02-08 12:35:04
795,K1-71.ファミリーマート大田大森南店,0,18,18,35.562769,139.74327,2024-02-08 12:35:04
796,J1-20.すずめのお宿緑地公園,2,7,9,35.617773,139.685351,2024-02-08 12:35:04
797,H1-115.東京夢の島マリーナ 第4駐車場,2,12,14,35.650235,139.835993,2024-02-08 12:35:04
798,M5-10.富ヶ谷2丁目,14,2,16,35.665961,139.686491,2024-02-08 12:35:04
799,J1-21.中央緑地公園,0,9,9,35.630694,139.690482,2024-02-08 12:35:04
800,H1-116.出会い橋高架下,27,22,49,35.625037,139.777646,2024-02-08 12:35:04
801,M3-12.渋谷南東急ビル,6,0,6,35.656228,139.706284,2024-02-08 12:35:04
802,T2-01.大泉学園駅北口,2,3,5,35.749918,139.58618,2024-02-08 12:35:04
803,K1-06.大森駅入新井自転車駐車場,5,1,6,35.585269,139.726279,2024-02-08 12:35:04
804,D6-06.新宿中央公園（エコギャラリー下）,0,14,14,35.691199,139.687966,2024-02-08 12:35:04
805,D6-14.新宿ファーストウエスト,13,1,14,35.689529,139.695995,2024-02-08 12:35:04
806,D6-15.住友不動産西新宿ビル,10,1,11,35.69465,139.695911,2024-02-08 12:35:04
807,H1-56.南砂三丁目緑地公園西,0,30,30,35.672361,139.829825,2024-02-08 12:35:04
808,T2-74.扇橋公園,2,3,5,35.731791,139.588844,2024-02-08 12:35:04
809,B2-20.SHビル,3,1,4,35.675398,139.779962,2024-02-08 12:35:04
810,I1-17.東品川海上公園第2,0,17,17,35.616364,139.749171,2024-02-08 12:35:04
811,I1-16.品川浦,13,1,14,35.6214,139.741958,2024-02-08 12:35:04
812,A4-11.二重橋前駅(メトロ4番出口),5,0,5,35.680753,139.762069,2024-02-08 12:35:04
813,H1-76.有明物流センター,0,19,19,35.638571,139.78829,2024-02-08 12:35:04
814,K1-43.北馬込わくわく公園,0,14,14,35.600707,139.703216,2024-02-08 12:35:04
815,K1-42.馬込西公園,11,3,14,35.58849,139.70376,2024-02-08 12:35:04
816,T1-08.セブン-イレブン 練馬高松6丁目店,4,0,4,35.756506,139.620347,2024-02-08 12:35:04
817,T2-17.ファミリーマート 練馬石神井町八丁目店,0,6,6,35.74755,139.597968,2024-02-08 12:35:04
818,K1-31.テクノWING,0,12,12,35.546252,139.731708,2024-02-08 12:35:04
819,K1-32.石川町文化センター,5,0,5,35.601958,139.682876,2024-02-08 12:35:04
820,I1-20.しおじ公園,9,11,20,35.59632,139.751279,2024-02-08 12:35:04
821,I1-19.品川シーサイド公園第2,7,0,7,35.607571,139.749108,2024-02-08 12:35:04
822,J1-29.カスタリア目黒鷹番,2,3,5,35.626121,139.688576,2024-02-08 12:35:04
823,H1-127.古石場川親水公園,0,38,38,35.669291,139.795364,2024-02-08 12:35:04
824,D4-05.カスタリア新宿7丁目,0,14,14,35.700732,139.711472,2024-02-08 12:35:04
825,I1-71.セブン-イレブン南大井浜川店,0,4,4,35.596483,139.7355,2024-02-08 12:35:04
826,I1-72.セブン-イレブン大井店,0,22,22,35.600081,139.728193,2024-02-08 12:35:04
827,T3-21.くまのやま緑地,4,1,5,35.747038,139.667965,2024-02-08 12:35:04
828,K1-110.萩中集会所裏,9,5,14,35.550479,139.739538,2024-02-08 12:35:04
829,O2-02.シエール荻窪,30,0,30,35.708265,139.612703,2024-02-08 12:35:04
830,H1-128.豊洲市場（5街区）,31,3,34,35.645162,139.785386,2024-02-08 12:35:04
831,N1-09.若宮レジデンス,1,4,5,35.716184,139.643905,2024-02-08 12:35:04
832,M6-12.LIVART SEASON 幡ヶ谷,0,14,14,35.683156,139.67338,2024-02-08 12:35:04
833,H1-142.東京ベイ潮見プリンスホテル,0,19,19,35.660632,139.817294,2024-02-08 12:35:04
834,G1-01.鐘ヶ淵駅南自転車駐車場,1,8,9,35.732291,139.82012,2024-02-08 12:35:04
835,M1-01.渋谷区役所,8,0,8,35.66362,139.69801,2024-02-08 12:35:04
836,I1-83.かもめ歩道橋,0,26,26,35.600161,139.749902,2024-02-08 12:35:04
837,N4-05.セブン-イレブン中野鍋横店,3,2,5,35.693815,139.668571,2024-02-08 12:35:04
838,D4-02.JICA市ヶ谷ビル（地球ひろば／研究所）,7,0,7,35.694927,139.731328,2024-02-08 12:35:04
839,T3-19.なかみや児童遊園,1,4,5,35.749388,139.651824,2024-02-08 12:35:04
840,N1-08.上鷺自転車保管場所,2,5,7,35.729056,139.627864,2024-02-08 12:35:04
841,O7-06.松木1丁目,2,11,13,35.686015,139.642784,2024-02-08 12:35:04
842,E4-16.ビレッジワン,1,6,7,35.723723,139.740143,2024-02-08 12:35:04
843,D1-15.フロンティア四谷,1,8,9,35.68768,139.71937,2024-02-08 12:35:04
844,K1-128.大森西3丁目,1,14,15,35.571975,139.732137,2024-02-08 12:35:04
845,N1-06.大和区民活動センター,0,5,5,35.713562,139.649075,2024-02-08 12:35:04
846,G4-01.両国ビューホテル1,0,7,7,35.69566,139.79214,2024-02-08 12:35:04
847,G4-02.両国ビューホテル2,0,8,8,35.69562,139.79206,2024-02-08 12:35:04
848,G4-05.両国駅西口臨時自転車駐車場,18,2,20,35.698588,139.792946,2024-02-08 12:35:04
849,G4-03.本所1-6-5,10,4,14,35.702525,139.796632,2024-02-08 12:35:04
850,G5-01.牡丹橋自転車駐車場,15,2,17,35.693059,139.813417,2024-02-08 12:35:04
851,G5-02.横川3-7-10,16,21,37,35.70378,139.814298,2024-02-08 12:35:04
852,G4-04.NTTドコモ墨田ビル,14,7,21,35.697898,139.795345,2024-02-08 12:35:04
853,G2-02.押上1-23-8,1,6,7,35.710111,139.81488,2024-02-08 12:35:04
854,C5-13.区立芝浦西運河沿緑地,9,30,39,35.638245,139.749754,2024-02-08 12:35:04
855,D6-12.東京ビジネスホテル,0,3,3,35.69342,139.710568,2024-02-08 12:35:04
856,D6-11.ホテルリステル新宿,0,5,5,35.693029,139.711327,2024-02-08 12:35:04
857,D6-10.ホテルサンライト新宿,3,0,3,35.694201,139.707047,2024-02-08 12:35:04
858,H1-39.辰巳駅東口自転車駐車場,22,3,25,35.645823,139.812178,2024-02-08 12:35:04
859,H1-38.辰巳駅西口自転車駐車場,89,0,89,35.646857,139.808912,2024-02-08 12:35:04
860,C2-10.元麻布三丁目,0,7,7,35.655865,139.730566,2024-02-08 12:35:04
861,C2-09.麻布地区総合支所,2,0,2,35.660614,139.734771,2024-02-08 12:35:04
862,M3-20.東急ステイ渋谷新南口,8,0,8,35.65494,139.70534,2024-02-08 12:35:04
863,I1-86.ファミリーマート二葉三丁目店,3,0,3,35.601694,139.719778,2024-02-08 12:35:04
864,A2-23.axle御茶ノ水,7,0,7,35.696126,139.763297,2024-02-08 12:35:04
865,C4-02.白金台いきいきプラザ,4,1,5,35.63756,139.724981,2024-02-08 12:35:04
866,N3-04.東中野駅地下駐輪場,0,22,22,35.707883,139.683284,2024-02-08 12:35:04
867,N3-05.中野坂上駅地下駐輪場,0,5,5,35.698068,139.682781,2024-02-08 12:35:04
868,N3-03.青桐公園,0,15,15,35.697024,139.677846,2024-02-08 12:35:04
869,N3-01.中野四季の森公園,5,5,10,35.708487,139.662135,2024-02-08 12:35:04
870,N4-01.本四公園,1,9,10,35.69693,139.672721,2024-02-08 12:35:04
871,N4-02.栄町公園,0,11,11,35.686474,139.671383,2024-02-08 12:35:04
872,K1-57.池上本門寺,5,1,6,35.579585,139.705377,2024-02-08 12:35:04
873,C1-49.汐留シティセンター,15,0,15,35.666213,139.760907,2024-02-08 12:35:04
874,C4-15.クロスレジデンス白金高輪,0,13,13,35.642771,139.733046,2024-02-08 12:35:04
875,K1-56.NTT馬込ビル,0,9,9,35.588106,139.718852,2024-02-08 12:35:04
876,J1-41.CASSIA目黒,0,9,9,35.631319,139.70237,2024-02-08 12:35:04
877,A2-22.専修大学,6,0,6,35.696147,139.753709,2024-02-08 12:35:04
878,T3-20.はやいち公園,2,2,4,35.75312,139.65661,2024-02-08 12:35:04
879,B3-19.本の森ちゅうおう,9,0,9,35.67363,139.77623,2024-02-08 12:35:04
880,K1-86.IMPREST STAY TOKYO 蒲田,22,0,22,35.556267,139.727246,2024-02-08 12:35:04
881,T3-23.氷川台二丁目緑地,3,1,4,35.756575,139.669689,2024-02-08 12:35:04
882,T3-22.氷川台三丁目ちびっこ公園,1,2,3,35.750547,139.66707,2024-02-08 12:35:04
883,B1-23.NANAEI日本橋,3,3,6,35.679616,139.784341,2024-02-08 12:35:04
884,B2-11.京橋エドグラン,12,0,12,35.677576,139.769822,2024-02-08 12:35:04
885,N1-05.大野ハイツ,1,4,5,35.7266,139.62948,2024-02-08 12:35:04
886,B2-09.茅場町一丁目平和ビル,10,0,10,35.680203,139.778679,2024-02-08 12:35:04
887,B2-08.共同ビル（茅場町交差点前）,9,0,9,35.681012,139.778569,2024-02-08 12:35:04
888,B2-07.東京証券会館（北側）,1,0,1,35.680864,139.779331,2024-02-08 12:35:04
889,O3-12.大宮前体育館,0,3,3,35.696567,139.610517,2024-02-08 12:35:04
890,B1-08.明治座,0,19,19,35.688038,139.786561,2024-02-08 12:35:04
891,B4-05.ドコモ・バイクシェア晴海ポート,0,28,28,35.654165,139.781568,2024-02-08 12:35:04
892,B4-04.ＫＤＸ晴海ビル,0,0,0,35.65443,139.77843,2024-02-08 12:35:04
893,B4-03.桜の散歩道（晴海トリトンスクエア前）,3,13,16,35.658665,139.782553,2024-02-08 12:35:04
894,E5-08.セブン-イレブン 文京動坂上店,1,4,5,35.727778,139.756296,2024-02-08 12:35:04
895,H1-65.ローソン南砂日曹橋店,7,8,15,35.669507,139.825553,2024-02-08 12:35:04
896,H1-66.中川船番所資料館,0,8,8,35.687732,139.846383,2024-02-08 12:35:04
897,K1-113.ファミリーマート大田上池台四丁目店,1,6,7,35.594658,139.700133,2024-02-08 12:35:04
898,H1-64.ローソン東雲駅前店,9,1,10,35.640228,139.804267,2024-02-08 12:35:04
899,E1-11.小石川運動場前,12,3,15,35.703914,139.747061,2024-02-08 12:35:04
900,T2-70.三ツ塚けやき緑地,2,2,4,35.720318,139.570762,2024-02-08 12:35:04
901,H1-137.住友不動産ショッピングシティ有明ガーデン,21,0,21,35.638985,139.793653,2024-02-08 12:35:04
902,C5-40.芝浦ふ頭駅前暫定自転車駐車場,3,1,4,35.64096,139.75754,2024-02-08 12:35:04
903,M3-21.渋谷ソラスタ,12,0,12,35.65618,139.69612,2024-02-08 12:35:04
904,D7-03.中井駅北,19,12,31,35.715645,139.687486,2024-02-08 12:35:04
905,K1-119.シーンズ大森パークサイド,4,0,4,35.58223,139.72763,2024-02-08 12:35:04
906,M6-15.cova Hatagaya,0,2,2,35.67741,139.67383,2024-02-08 12:35:04
907,C2-25.アパホテル＆リゾート＜六本木駅東＞,32,9,41,35.661783,139.737242,2024-02-08 12:35:04
908,D4-10.東新宿ポート(余丁町6番),1,5,6,35.696585,139.713081,2024-02-08 12:35:04
909,O1-02.井荻南地下自転車駐車場,7,7,14,35.72424,139.61431,2024-02-08 12:35:04
910,O1-03.LUCKY HOUSE,1,3,4,35.72489,139.62383,2024-02-08 12:35:04
911,D6-30.京王プラザホテル,7,0,7,35.6897,139.694823,2024-02-08 12:35:04
912,D6-29.都庁第二本庁舎前,13,0,13,35.688735,139.692249,2024-02-08 12:35:04
913,O3-02.アートメゾン荻窪,6,2,8,35.71355,139.6199,2024-02-08 12:35:04
914,J1-57.トレインチ自由が丘,4,1,5,35.606667,139.667324,2024-02-08 12:35:04
915,O2-01.サカエフラット荻窪,10,1,11,35.70535,139.61497,2024-02-08 12:35:04
916,O3-01.西田公園,1,6,7,35.69575,139.62065,2024-02-08 12:35:04
917,K1-47.NTT雪ヶ谷ビル,7,4,11,35.598601,139.684747,2024-02-08 12:35:04
918,Z17.NTT川崎ビル,9,0,9,35.529519,139.704845,2024-02-08 12:35:04
919,O7-04.永福町西幸モータープール西,7,1,8,35.67161,139.64527,2024-02-08 12:35:04
920,K1-48.ファミリーマート大田上池台三丁目店,0,23,23,35.590934,139.696915,2024-02-08 12:35:04
921,K1-111.本羽田公園,4,3,7,35.546499,139.736761,2024-02-08 12:35:04
922,C1-58.ウォーターズ竹芝,3,7,10,35.655937,139.763251,2024-02-08 12:35:04
923,K1-109.萩中公園プール駐輪場,8,0,8,35.549323,139.737091,2024-02-08 12:35:04
924,K1-108.仲江名公園,2,2,4,35.557999,139.732564,2024-02-08 12:35:04
925,E1-17.小石川パークスクエア,0,10,10,35.713913,139.745416,2024-02-08 12:35:04
926,D6-23.アパホテル 東新宿 歌舞伎町西,1,1,2,35.697535,139.703633,2024-02-08 12:35:04
927,H1-98.洲崎川緑道公園,0,36,36,35.668705,139.810549,2024-02-08 12:35:04
928,H1-99.南砂三丁目公園,18,6,24,35.669695,139.831874,2024-02-08 12:35:04
929,H1-96.越中島公園,0,18,18,35.668757,139.790156,2024-02-08 12:35:04
930,H1-97.浜園公園,0,18,18,35.661852,139.802224,2024-02-08 12:35:04
931,H1-94.新木場一丁目緑地公園,8,1,9,35.64423,139.835823,2024-02-08 12:35:04
932,H1-95.若洲公園,7,17,24,35.619451,139.834429,2024-02-08 12:35:04
933,J1-09.ファミリーマート佐野久下目黒店,2,3,5,35.629252,139.712716,2024-02-08 12:35:04
934,H1-93.新木場一丁目公園,7,0,7,35.64143,139.835455,2024-02-08 12:35:04
935,I1-55.鈴ヶ森公園,0,22,22,35.593559,139.734704,2024-02-08 12:35:04
936,O6-04.柏の宮公園,0,5,5,35.67834,139.62711,2024-02-08 12:35:04
937,B4-14.Brillia ist Tower 勝どき,0,22,22,35.660526,139.776816,2024-02-08 12:35:04
938,D7-08.上落合3丁目,3,10,13,35.71115,139.68232,2024-02-08 12:35:04
939,H1-21.UR東雲キャナルコート,0,91,91,35.646041,139.804495,2024-02-08 12:35:04
940,H1-20.日本科学未来館,23,7,30,35.619377,139.777582,2024-02-08 12:35:04
941,H1-19.UR豊洲四丁目団地,12,9,21,35.653603,139.80144,2024-02-08 12:35:04
942,T2-45.風致地区バス停第三自転車駐車場,0,7,7,35.771068,139.586798,2024-02-08 12:35:04
943,H1-33.深川ギャザリア（ウエストスクエア）,0,28,28,35.66789,139.803,2024-02-08 12:35:04
944,H1-32.区営塩浜住宅前,0,24,24,35.664591,139.813954,2024-02-08 12:35:04
945,H1-23.KDX豊洲グランスクエア,11,3,14,35.648085,139.798986,2024-02-08 12:35:04
946,C2-22.飯倉公園,9,1,10,35.655649,139.74427,2024-02-08 12:35:04
947,I1-89.下神明駅自転車駐車場,4,1,5,35.608402,139.726118,2024-02-08 12:35:04
948,C5-39.お台場海浜公園東,11,2,13,35.631021,139.778109,2024-02-08 12:35:04
949,C5-38.お台場海浜公園乗船場,0,15,15,35.628743,139.773915,2024-02-08 12:35:04
950,O4-08.ローソン阿佐ヶ谷青梅街道店,0,5,5,35.703203,139.62804,2024-02-08 12:35:04
951,T2-72.高塚南緑地,4,2,6,35.733132,139.570311,2024-02-08 12:35:04
952,O6-03.みなみ荘,6,4,10,35.68073,139.62803,2024-02-08 12:35:04
953,K1-129.ローソン東糀谷一丁目店,0,8,8,35.557427,139.739126,2024-02-08 12:35:04
954,E1-03.東京ドーム（黄色いビル横）,8,0,8,35.70319,139.751888,2024-02-08 12:35:04
955,K1-23.大田区役所本庁舎前,6,1,7,35.561183,139.716339,2024-02-08 12:35:04
956,T2-78.北大泉くれはし公園,1,2,3,35.761474,139.592735,2024-02-08 12:35:04
957,J1-53.ボヌールAllamanda,3,2,5,35.612833,139.675047,2024-02-08 12:35:04
958,A3-39.トーシン東神田ビル,0,4,4,35.694834,139.780333,2024-02-08 12:35:04
959,O6-01.高井戸みどり公園,4,5,9,35.67912,139.61074,2024-02-08 12:35:04
960,T2-79.大泉学園町八丁目緑地,4,2,6,35.774457,139.596182,2024-02-08 12:35:04
961,O5-04.リヴィエール,17,3,20,35.70104,139.65839,2024-02-08 12:35:04
962,N3-08.中野区役所(西側),6,0,6,35.707968,139.663519,2024-02-08 12:35:04
963,I1-99.北品川２丁目,4,2,6,35.61663,139.74192,2024-02-08 12:35:04
964,P1-01.サンシャインシティ,5,2,7,35.728846,139.718577,2024-02-08 12:35:04
965,N3-14.ヴィラソンサ落合,0,7,7,35.713227,139.680966,2024-02-08 12:35:04
966,H1-49.セブン-イレブン 江東新砂３丁目店,0,21,21,35.667892,139.8311,2024-02-08 12:35:04
967,I1-06.大森貝塚遺跡庭園,9,0,9,35.593489,139.72967,2024-02-08 12:35:04
968,M2-12.恵比寿プライムスクエアタワー北,8,1,9,35.650541,139.713361,2024-02-08 12:35:04
969,H1-69.ファミリーマート 江東石島店,0,32,32,35.680474,139.812316,2024-02-08 12:35:04
970,B3-09.築地永谷コーポラス,0,16,16,35.66523,139.776313,2024-02-08 12:35:04
971,E4-10.白山四丁目第二児童遊園横,3,8,11,35.720349,139.746924,2024-02-08 12:35:04
972,I1-03.大井町駅中央口（西側）,7,0,7,35.605617,139.73472,2024-02-08 12:35:04
973,I1-04.大井町歩道橋,5,0,5,35.605146,139.734694,2024-02-08 12:35:04
974,I1-01.品川区役所 本庁舎前,10,0,10,35.609052,139.729825,2024-02-08 12:35:04
975,I1-02.品川区役所 第三庁舎前,9,0,9,35.608161,139.730048,2024-02-08 12:35:04
976,G4-08.ブオンサンヴァレンティーノ,0,6,6,35.691677,139.793857,2024-02-08 12:35:04
977,J1-13.洗足二丁目駐輪場,13,4,17,35.61061,139.693443,2024-02-08 12:35:04
978,J1-16.八雲橋自転車置場,3,3,6,35.617353,139.672256,2024-02-08 12:35:04
979,H1-189.MFLP新木場2,0,35,35,35.634453,139.824,2024-02-08 12:35:04
980,M6-09.ファミリーマート渋谷本町店,0,11,11,35.683756,139.684965,2024-02-08 12:35:04
981,H1-113.123+N東雲店,0,36,36,35.646366,139.801492,2024-02-08 12:35:04
982,J1-17.ファミリーマート原町二丁目店,0,6,6,35.613902,139.691476,2024-02-08 12:35:04
983,E5-21.動坂公園,0,11,11,35.73176,139.756669,2024-02-08 12:35:04
984,E5-20.本郷2丁目,0,8,8,35.704391,139.758575,2024-02-08 12:35:04
985,T2-48.武蔵関駅南第二自転車駐車場,1,3,4,35.726064,139.578015,2024-02-08 12:35:04
986,A6-26.相互半蔵門ビル,6,3,9,35.683378,139.743189,2024-02-08 12:35:04
987,J1-31.守屋図書館,13,7,20,35.634194,139.688833,2024-02-08 12:35:04
988,M3-19.渋谷キャスト,20,0,20,35.662146,139.702793,2024-02-08 12:35:04
989,N1-04.都立家政南駐輪場,0,10,10,35.721679,139.645265,2024-02-08 12:35:04
990,Z09.ファミリーマート川崎川中島二丁目店,0,11,11,35.529781,139.727511,2024-02-08 12:35:04
991,N2-02.江古田1丁目A,0,3,3,35.724988,139.672511,2024-02-08 12:35:04
992,C1-56.鈴与竹芝ビル,3,2,5,35.654873,139.762103,2024-02-08 12:35:04
993,D3-07.戸塚特別出張所,6,1,7,35.71429,139.70507,2024-02-08 12:35:04
994,G4-12.プレミアムキューブ両国,0,7,7,35.70103,139.803341,2024-02-08 12:35:04
995,A2-21.神田神保町3丁目,7,0,7,35.694578,139.754434,2024-02-08 12:35:04
996,B4-19.コーシャタワー佃,0,26,26,35.668044,139.785801,2024-02-08 12:35:04
997,I1-81.戸越6丁目,16,4,20,35.608127,139.717865,2024-02-08 12:35:04
998,A6-24.国立劇場,0,15,15,35.682218,139.743292,2024-02-08 12:35:04
999,E5-23.ビレッジ千駄木,0,7,7,35.722353,139.760966,2024-02-08 12:35:04
1000,H1-119.榎戸材木店,0,6,6,35.638319,139.834741,2024-02-08 12:35:04
1001,C5-29.Hi-NODE(ハイノード),7,1,8,35.651672,139.760549,2024-02-08 12:35:04
1002,J1-22.NTTコミュニケーションズ唐ヶ崎ビル,0,4,4,35.627373,139.692044,2024-02-08 12:35:04
1003,A2-18.猿楽町SSビル東,4,1,5,35.698654,139.759762,2024-02-08 12:35:04
1004,A2-19.猿楽町SSビル西,3,0,3,35.698641,139.759306,2024-02-08 12:35:04
1005,C1-55.アーバンネット内幸町ビル,19,1,20,35.669267,139.756018,2024-02-08 12:35:04
1006,D4-06.グリーンフォート河田,0,13,13,35.697143,139.718739,2024-02-08 12:35:04
1007,K1-134.東調布公園,3,7,10,35.588363,139.69042,2024-02-08 12:35:04
1008,Z12.京急川崎西口駐輪場B,21,0,21,35.533627,139.700527,2024-02-08 12:35:04
1009,M5-18.Luxe初台,0,5,5,35.679182,139.68596,2024-02-08 12:35:04
1010,D7-06.エムアイセミナーハウス,3,2,5,35.721064,139.677128,2024-02-08 12:35:04
1011,A3-37.ポータル秋葉原,0,25,25,35.695737,139.78162,2024-02-08 12:35:04
1012,M5-11.あおい通り,9,0,9,35.688154,139.698975,2024-02-08 12:35:04
1013,E5-04.保健サービスセンター本郷支所,0,5,5,35.727046,139.760439,2024-02-08 12:35:04
1014,E5-03.汐見地域活動センター（本郷図書館）,0,5,5,35.725538,139.76116,2024-02-08 12:35:04
1015,E5-01.文京総合体育館,31,0,31,35.708121,139.763583,2024-02-08 12:35:04
1016,E4-01.千石南自転車駐車場,6,19,25,35.72707,139.746112,2024-02-08 12:35:04
1017,E3-03.大塚公園,6,15,21,35.724286,139.730954,2024-02-08 12:35:04
1018,E3-02.教育の森公園,6,11,17,35.719345,139.736198,2024-02-08 12:35:04
1019,I1-25.セブン-イレブン 品川旗の台2丁目店,0,3,3,35.607084,139.705007,2024-02-08 12:35:04
1020,B1-21.日本橋二丁目街角広場,10,1,11,35.680861,139.774493,2024-02-08 12:35:04
1021,C3-30.東京赤坂NKビル (ヴィアインプライム赤坂),9,0,9,35.672652,139.738908,2024-02-08 12:35:04
1022,A3-36.クロックカフェ東神田,0,5,5,35.694943,139.782718,2024-02-08 12:35:04
1023,E1-14.いきいき礫川,0,9,9,35.711147,139.747386,2024-02-08 12:35:04
1024,D4-09.トミンハイム仲之町,0,13,13,35.69617,139.722021,2024-02-08 12:35:04
1025,L1-08.NTT砧ビル,0,6,6,35.63534,139.601602,2024-02-08 12:35:04
1026,L1-09.コージーK・駒沢,2,2,4,35.632689,139.654804,2024-02-08 12:35:04
1027,L1-10.宮坂2-4-10,0,6,6,35.652913,139.644825,2024-02-08 12:35:04
1028,I1-22.ウィラ大井 (ショッピングモール),2,3,5,35.596579,139.745009,2024-02-08 12:35:04
1029,K1-76.グリーンベルト,9,0,9,35.585178,139.726339,2024-02-08 12:35:04
1030,H1-121.南砂5丁目,0,42,42,35.676603,139.829736,2024-02-08 12:35:04
1031,M3-02.文化総合センター大和田,5,0,5,35.65558,139.69966,2024-02-08 12:35:04
1032,D4-04.ジェノヴィア新宿早稲田グリーンヴェール,1,5,6,35.700033,139.71983,2024-02-08 12:35:04
1033,A3-20.神田ふれあい通り第２,0,2,2,35.695005,139.772747,2024-02-08 12:35:04
1034,H1-120.豊洲5丁目,17,1,18,35.650948,139.799711,2024-02-08 12:35:04
1035,C5-42.DHC芝浦2丁目ビル,1,7,8,35.644241,139.753834,2024-02-08 12:35:04
1036,I1-65.セブン-イレブン品川東大井1丁目店,7,0,7,35.605996,139.743037,2024-02-08 12:35:04
1037,M2-04.広尾東公園,5,1,6,35.653382,139.721059,2024-02-08 12:35:04
1038,M3-13.渋谷駅東口地下駐輪場,18,1,19,35.657682,139.703307,2024-02-08 12:35:04
1039,A3-19.神田ふれあい通り第１,0,5,5,35.694904,139.772712,2024-02-08 12:35:04
1040,O6-07.ローソン杉並宮前一丁目店,1,4,5,35.689639,139.613516,2024-02-08 12:35:04
1041,T3-10.貫井一丁目緑地,0,3,3,35.736378,139.632485,2024-02-08 12:35:04
1042,M2-05.日本赤十字医療センター,1,9,10,35.65519,139.718559,2024-02-08 12:35:04
1043,T2-20.パークサイド石神井,0,13,13,35.741769,139.591103,2024-02-08 12:35:04
1044,N4-06.ローソン中野本町新橋通り店,0,6,6,35.695819,139.674326,2024-02-08 12:35:04
1045,T3-07.徳殿公園,3,1,4,35.726728,139.65874,2024-02-08 12:35:04
1046,K1-35.セブン-イレブン 大田区西六郷2丁目店,0,13,13,35.549778,139.707362,2024-02-08 12:35:04
1047,A3-27.秋葉原駅中央口（ヨドバシカメラ前）,6,4,10,35.698986,139.774099,2024-02-08 12:35:04
1048,A3-28.秋葉原駅電気街口(西側交通広場),5,0,5,35.699173,139.772629,2024-02-08 12:35:04
1049,H1-57.新木場駅,10,55,65,35.64508,139.826456,2024-02-08 12:35:04
1050,H1-58.潮見駅,0,26,26,35.658703,139.817251,2024-02-08 12:35:04
1051,D7-02.セブン-イレブン 新宿中落合3丁目店,0,16,16,35.722202,139.691712,2024-02-08 12:35:04
1052,D2-06.飯田濠,13,1,14,35.70057,139.74301,2024-02-08 12:35:04
1053,C5-17.鈴与浜松町ビル,5,4,9,35.651103,139.759092,2024-02-08 12:35:04
1054,H1-59.LYURO 東京清澄,0,24,24,35.681316,139.792176,2024-02-08 12:35:04
1055,H1-60.荒川・砂町庭球場西,0,30,30,35.679678,139.844892,2024-02-08 12:35:04
1056,K1-44.中馬込貝塚公園,0,7,7,35.594795,139.704951,2024-02-08 12:35:04
1057,M6-11.京王サイクルパーク笹塚,0,5,5,35.674337,139.668801,2024-02-08 12:35:04
1058,J1-49.伊勢脇公園,1,3,4,35.638864,139.696568,2024-02-08 12:35:04
1059,K1-45.たぬき山公園,1,7,8,35.592801,139.715472,2024-02-08 12:35:04
1060,D2-01.あずさセンタービル,12,6,18,35.702286,139.741093,2024-02-08 12:35:04
1061,C1-02.西新橋1丁目（外堀通り）,5,1,6,35.668791,139.753582,2024-02-08 12:35:04
1062,O3-07.NTT井草ビル第1ポート,2,1,3,35.714044,139.61688,2024-02-08 12:35:04
1063,T2-41.ローソン 練馬東大泉五丁目店,0,4,4,35.74248,139.58715,2024-02-08 12:35:04
1064,H1-144.南砂住宅,0,17,17,35.674199,139.822018,2024-02-08 12:35:04
1065,C3-28.ヒューリックＪＰ赤坂ビル,11,0,11,35.672477,139.739743,2024-02-08 12:35:04
1066,H1-145.東雲都橋住宅,0,15,15,35.643131,139.797784,2024-02-08 12:35:04
1067,I1-58.品川区役所　第二庁舎前,18,0,18,35.609664,139.730006,2024-02-08 12:35:04
1068,K1-92.蒲田駅西口自転車駐車場,25,0,25,35.561101,139.715173,2024-02-08 12:35:04
1069,A2-24.水道橋駅西口前,6,0,6,35.702271,139.752619,2024-02-08 12:35:04
1070,K1-94.昭和島駅前,0,25,25,35.572188,139.749613,2024-02-08 12:35:04
1071,M5-15.新宿マインズタワー,18,2,20,35.686567,139.699355,2024-02-08 12:35:04
1072,D7-13.日本光電本社南側,11,4,15,35.71936,139.679083,2024-02-08 12:35:04
1073,N3-09.中野区役所(北側),5,0,5,35.708259,139.663829,2024-02-08 12:35:04
1074,H1-163.森下公園,2,3,5,35.68663,139.799529,2024-02-08 12:35:04
1075,B4-23.交通広場（豊海町）,0,14,14,35.653771,139.769295,2024-02-08 12:35:04
1076,D6-18.ヨドバシカメラ 新宿西口本店前,5,1,6,35.689689,139.698231,2024-02-08 12:35:04
1077,I1-47.NTT 東日本 関東病院(南側),7,0,7,35.630151,139.725215,2024-02-08 12:35:04
1078,H1-112.ファミリーマート江東塩浜二丁目店,3,0,3,35.66305,139.8087,2024-02-08 12:35:04
1079,K1-103.雪谷特別出張所,0,7,7,35.594515,139.691219,2024-02-08 12:35:04
1080,E5-17.Village藍染,0,5,5,35.720896,139.76422,2024-02-08 12:35:04
1081,Z04.ローソン川崎四谷上町店,7,1,8,35.527562,139.737102,2024-02-08 12:35:04
1082,Z03.ローソン川崎塩浜三丁目店,0,3,3,35.523754,139.746356,2024-02-08 12:35:04
1083,I1-49.京急鮫洲バイク駐輪場,6,0,6,35.603815,139.741362,2024-02-08 12:35:04
1084,I1-50.京急立会川第2バイク駐輪場,0,12,12,35.599196,139.739158,2024-02-08 12:35:04
1085,E4-14.NTT東日本大塚ビル,0,17,17,35.726188,139.741375,2024-02-08 12:35:04
1086,M2-07.ファミリーマート恵比寿駅東店,7,0,7,35.6471,139.712818,2024-02-08 12:35:04
1087,M4-07.千駄ヶ谷駅前,1,3,4,35.68082,139.71188,2024-02-08 12:35:04
1088,O5-07.バーンホーフ キクチ,12,8,20,35.698169,139.655665,2024-02-08 12:35:04
1089,J1-11.コンフォリア目黒青葉台,0,6,6,35.649023,139.696086,2024-02-08 12:35:04
1090,L1-14.給田3丁目,1,12,13,35.664335,139.590114,2024-02-08 12:35:04
1091,B4-06.月島駅地下駐輪場,1,16,17,35.66291,139.782564,2024-02-08 12:35:04
1092,C5-09.グランパーク,20,1,21,35.643202,139.746244,2024-02-08 12:35:04
1093,C5-08.AQUACITY芝浦,5,6,11,35.637366,139.74844,2024-02-08 12:35:04
1094,C3-08.赤坂パークビルヂング,5,0,5,35.671792,139.733668,2024-02-08 12:35:04
1095,C3-07.新青山ビル,17,1,18,35.672659,139.725644,2024-02-08 12:35:04
1096,C3-06.ホテルアジア会館,0,11,11,35.67064,139.728166,2024-02-08 12:35:04
1097,C1-24.三田国際ビル,2,8,10,35.653159,139.744673,2024-02-08 12:35:04
1098,C5-07.港区立港南図書館,0,35,35,35.632842,139.7495,2024-02-08 12:35:04
1099,A3-04.秋葉原公園,0,18,18,35.697642,139.774867,2024-02-08 12:35:04
1100,A3-05.和泉公園（西側入口）,4,2,6,35.698817,139.778898,2024-02-08 12:35:04
1101,A3-02.絶滅メディア博物館（楓ビル）,8,0,8,35.689575,139.767848,2024-02-08 12:35:04
1102,O3-10.メゾンパークス,3,5,8,35.716265,139.618954,2024-02-08 12:35:04
1103,A2-05.神田橋公園,1,0,1,35.689665,139.764091,2024-02-08 12:35:04
1104,A3-01.神田児童公園（西側交番横）,4,2,6,35.692983,139.76773,2024-02-08 12:35:04
1105,A2-03.西神田公園（西側）,5,0,5,35.698338,139.754876,2024-02-08 12:35:04
1106,M6-03.十三号通り公園,0,8,8,35.675198,139.663587,2024-02-08 12:35:04
1107,M6-02.サイカパーク笹塚,0,11,11,35.673444,139.666553,2024-02-08 12:35:04
1108,H1-165.亀戸梅屋敷,0,10,10,35.701318,139.825916,2024-02-08 12:35:04
1109,H1-166.亀戸クロック,18,1,19,35.696574,139.82972,2024-02-08 12:35:04
1110,M5-02.あいおいニッセイ同和損保新宿ビル,1,3,4,35.684423,139.692262,2024-02-08 12:35:04
1111,M6-01.幡ヶ谷駅高架下第一,23,12,35,35.677175,139.676769,2024-02-08 12:35:04
1112,A5-02.山王パークタワー,4,1,5,35.673555,139.741293,2024-02-08 12:35:04
1113,K1-116.旧呑川緑地（大森東五丁目）,5,7,12,35.567176,139.742345,2024-02-08 12:35:04
1114,K1-115.旧呑川緑地（大森中三丁目）,0,7,7,35.565685,139.736195,2024-02-08 12:35:04
1115,K1-114.下丸子公園,6,2,8,35.568722,139.680736,2024-02-08 12:35:04
1116,T3-05.東武練馬駅南,0,10,10,35.767129,139.664365,2024-02-08 12:35:04
1117,T1-14.ファミリーマート 練馬高松五丁目北店,4,0,4,35.761038,139.623148,2024-02-08 12:35:04
1118,C3-29.高橋是清翁記念公園,5,2,7,35.674094,139.728895,2024-02-08 12:35:04
1119,K1-141.蒲田駅西口歩道,5,0,5,35.561291,139.715076,2024-02-08 12:35:04
1120,C3-35.ワールド北青山ビル,17,0,17,35.667069,139.713423,2024-02-08 12:35:04
1121,M5-03.代々木大山公園,9,7,16,35.671282,139.675307,2024-02-08 12:35:04
1122,E5-13.弥生二丁目,4,2,6,35.715592,139.76192,2024-02-08 12:35:04
1123,E5-12.NK本郷ビル,0,6,6,35.704475,139.763041,2024-02-08 12:35:04
1124,B3-18.銀座松竹スクエア,10,0,10,35.668395,139.769849,2024-02-08 12:35:04
1125,C1-44.三田Avanti,5,1,6,35.64115,139.741471,2024-02-08 12:35:04
1126,T2-31.ファミリーマート 石神井台二丁目店,0,9,9,35.739488,139.590273,2024-02-08 12:35:04
1127,H1-150.ホテルヴィラフォンテーヌ南側,8,1,9,35.636978,139.791858,2024-02-08 12:35:04
1128,H1-149.有明ガーデン 公園口,8,0,8,35.639132,139.793047,2024-02-08 12:35:04
1129,H1-148.大島七丁目団地,0,17,17,35.694104,139.840278,2024-02-08 12:35:04
1130,B4-26.東武ストア晴海三丁目店,0,14,14,35.654371,139.779545,2024-02-08 12:35:04
1131,J1-26.田向公園,3,4,7,35.623459,139.687128,2024-02-08 12:35:04
1132,J1-25.碑文谷公園,3,5,8,35.625081,139.682632,2024-02-08 12:35:04
1133,H1-195.東京アクアティクスセンター,6,13,19,35.65238,139.815613,2024-02-08 12:35:04
1134,T1-13.ファミリーマート 練馬土支田二丁目店,0,14,14,35.761613,139.61349,2024-02-08 12:35:04
1135,T2-34.ファミリーマート 練馬富士見台店,0,5,5,35.73969,139.62125,2024-02-08 12:35:04
1136,T2-35.ファミリーマート 石神井台六丁目店,0,6,6,35.738607,139.585331,2024-02-08 12:35:04
1137,C1-81.田町タワー,20,0,20,35.646534,139.748913,2024-02-08 12:35:04
1138,J1-07.目黒川船入場,14,1,15,35.641992,139.701588,2024-02-08 12:35:04
1139,J1-08.目黒区民センター公園,14,4,18,35.634533,139.708868,2024-02-08 12:35:04
1140,D4-01.市谷仲之町,2,4,6,35.695102,139.723345,2024-02-08 12:35:04
1141,M2-11.鉢山町,15,1,16,35.652151,139.698426,2024-02-08 12:35:04
1142,E4-08.ドコモ・バイクシェア向丘ポート,1,8,9,35.720546,139.756685,2024-02-08 12:35:04
1143,D4-03.市谷加賀町2丁目,0,10,10,35.695636,139.727882,2024-02-08 12:35:04
1144,Z10.ローソン川崎浅田三丁目店,4,6,10,35.506142,139.701005,2024-02-08 12:35:04
1145,N1-01.BeGood野方,0,11,11,35.719717,139.64785,2024-02-08 12:35:04
1146,C2-03.アークヒルズサウスタワー,9,2,11,35.666357,139.73923,2024-02-08 12:35:04
1147,C2-01.アークヒルズ（アーク森ビル）,7,4,11,35.667107,139.739565,2024-02-08 12:35:04
1148,C2-02.六本木ヒルズ,26,0,26,35.661158,139.728533,2024-02-08 12:35:04
1149,C5-03.港南公園C,7,19,26,35.624966,139.746657,2024-02-08 12:35:04
1150,C5-04.みなとパーク芝浦,10,1,11,35.646801,139.751208,2024-02-08 12:35:04
1151,C1-16.機械振興会館,6,0,6,35.659442,139.745549,2024-02-08 12:35:04
1152,C1-14.新橋プラザビル,0,4,4,35.664461,139.756082,2024-02-08 12:35:04
1153,H1-73.イシマビル,0,9,9,35.67386,139.79976,2024-02-08 12:35:04
1154,O7-01.西永福公園,4,1,5,35.67753,139.63667,2024-02-08 12:35:04
1155,O6-02.富士見ヶ丘南自転車駐車場,6,2,8,35.68296,139.60861,2024-02-08 12:35:04
1156,K1-50.テクノポートカマタ 第1,6,0,6,35.556199,139.721476,2024-02-08 12:35:04
1157,J1-14.二の橋自転車置場1,38,1,39,35.614856,139.678208,2024-02-08 12:35:04
1158,O3-08.NTT井草ビル第２ポート,0,3,3,35.714077,139.61694,2024-02-08 12:35:04
1159,H1-124.セブン-イレブン 江東海辺店,1,12,13,35.680636,139.817977,2024-02-08 12:35:04
1160,D1-11.三井ガーデンホテル神宮外苑の杜プレミア,5,0,5,35.679807,139.715931,2024-02-08 12:35:04
1161,O7-07.ハレ永福,1,7,8,35.678913,139.639944,2024-02-08 12:35:04
1162,C5-32.トレードピアお台場,4,1,5,35.627891,139.776896,2024-02-08 12:35:04
1163,B4-18.豊海センタービル,0,5,5,35.653531,139.769431,2024-02-08 12:35:04
1164,D5-04.西戸山公園野球場,2,5,7,35.707388,139.700204,2024-02-08 12:35:04
1165,D5-03.北新宿公園,0,14,14,35.702288,139.68862,2024-02-08 12:35:04
1166,D3-04.鶴巻南公園,0,23,23,35.706182,139.723394,2024-02-08 12:35:04
1167,D3-03.甘泉園公園,0,15,15,35.712431,139.715418,2024-02-08 12:35:04
1168,K1-03.池上会館,0,7,7,35.576593,139.706597,2024-02-08 12:35:04
1169,K1-02.平和の森公園,11,4,15,35.579049,139.739878,2024-02-08 12:35:04
1170,K1-01.大森海苔のふるさと館,0,12,12,35.57685,139.742496,2024-02-08 12:35:04
1171,D6-13.新宿中央公園（ジャブジャブ池下）,8,1,9,35.687652,139.689254,2024-02-08 12:35:04
1172,T2-28.ファミリーマート 南大泉六丁目店,3,2,5,35.752217,139.571095,2024-02-08 12:35:04
1173,K1-05.平和島公園プール,13,4,17,35.581832,139.741581,2024-02-08 12:35:04
1174,K1-04.京急蒲田駅東口,21,0,21,35.559483,139.724273,2024-02-08 12:35:04
1175,E2-10.音羽パークロード（北入口）,13,2,15,35.716586,139.727705,2024-02-08 12:35:04
1176,E2-11.音羽パークロード（キャッチボール場横）,13,7,20,35.715382,139.728533,2024-02-08 12:35:04
1177,I1-21.大井競馬場(正門前),10,0,10,35.593887,139.741204,2024-02-08 12:35:04
1178,J1-27.衾町公園,1,0,1,35.623215,139.668472,2024-02-08 12:35:04
1179,T2-44.中島橋自転車駐車場,5,2,7,35.75372,139.584332,2024-02-08 12:35:04
1180,B3-15.ACホテル・バイ・マリオット東京銀座,8,0,8,35.668845,139.765144,2024-02-08 12:35:04
1181,D5-07.百人町1丁目,2,4,6,35.699252,139.697606,2024-02-08 12:35:04
1182,C4-04.ショパン高輪,0,11,11,35.632128,139.732097,2024-02-08 12:35:04
1183,B1-18.セブン-イレブン 日本橋小網町店,2,1,3,35.681352,139.781436,2024-02-08 12:35:04
1184,T2-71.わかば児童公園,4,3,7,35.7211,139.574669,2024-02-08 12:35:04
1185,M3-15.co-ba ebisu,6,0,6,35.647076,139.703964,2024-02-08 12:35:04
1186,C2-20.三井ガーデンホテル六本木プレミア,4,0,4,35.66206,139.735501,2024-02-08 12:35:04
1187,I1-70.五反田リバーステーション,4,4,8,35.624566,139.72448,2024-02-08 12:35:04
1188,E5-25.ジェノヴィア東大前グリーンヴェール,7,4,11,35.711875,139.759306,2024-02-08 12:35:04
1189,D1-12.ジェノヴィア新宿御苑グリーンヴェール,1,6,7,35.689017,139.714755,2024-02-08 12:35:04
1190,C5-33.msb Tamachi,37,1,38,35.645682,139.748768,2024-02-08 12:35:04
1191,G4-09.SYFORME MORISHITA Ⅱ 1,1,0,1,35.690348,139.796133,2024-02-08 12:35:04
1192,G4-10.SYFORME MORISHITA Ⅱ 2,0,5,5,35.690307,139.796128,2024-02-08 12:35:04
1193,N3-19.上高田パーキング,0,17,17,35.715878,139.673669,2024-02-08 12:35:04
1194,Z13.京急川崎日進町駐輪場,10,0,10,35.528361,139.696499,2024-02-08 12:35:04
1195,F6-01.松坂屋上野店,0,4,4,35.707305,139.773657,2024-02-08 12:35:04
1196,F4-01.SYFORME ASAKUSA,0,4,4,35.718832,139.791133,2024-02-08 12:35:04
1197,F2-02.アップルパーク浅草6丁目第3,0,3,3,35.716062,139.799552,2024-02-08 12:35:04
1198,F2-01.松が谷2丁目2,0,20,20,35.71283,139.787754,2024-02-08 12:35:04
1199,F1-02.台東デザイナーズビレッジ,1,6,7,35.706023,139.783751,2024-02-08 12:35:04
1200,F2-03.台東区生涯学習センター,0,6,6,35.717497,139.790055,2024-02-08 12:35:04
1201,K1-146.南馬込6丁目25-11,0,3,3,35.582743,139.710561,2024-02-08 12:35:04
1202,F3-01.清川1丁目18-11,0,17,17,35.724944,139.801684,2024-02-08 12:35:04
1203,F1-03.新御徒町駅自転車駐車場,4,12,16,35.706793,139.782985,2024-02-08 12:35:04
1204,F3-02.台東区リバーサイドスポーツセンター,0,7,7,35.717571,139.804216,2024-02-08 12:35:04
1205,I1-45.セブン-イレブン品川西五反田3丁目店,5,0,5,35.62541,139.718135,2024-02-08 12:35:04
1206,H1-135.北砂5丁目団地,0,35,35,35.684218,139.832843,2024-02-08 12:35:04
1207,C3-16.赤坂ガーデンシティ,0,11,11,35.6738,139.731525,2024-02-08 12:35:04
1208,J1-34.田道広場公園,7,3,10,35.636269,139.709073,2024-02-08 12:35:04
1209,O5-08.セシオン杉並,1,2,3,35.69714,139.65432,2024-02-08 12:35:04
1210,A2-04.ちよだプラットフォームスクウェア,10,0,10,35.691456,139.762228,2024-02-08 12:35:04
1211,I1-102.J.GRAN Court 品川西大井 EAST,2,5,7,35.598244,139.722447,2024-02-08 12:35:04
1212,H1-196.フットサルクラブ東京東陽町,6,0,6,35.665288,139.824294,2024-02-08 12:35:04
1213,F2-04.コンフォラス浅草マンション,0,3,3,35.717241,139.801674,2024-02-08 12:35:04
1214,G5-03.京成リッチモンドホテル東京錦糸町,3,2,5,35.693492,139.81506,2024-02-08 12:35:04
1215,K1-27.六郷文化センター,1,3,4,35.544715,139.707623,2024-02-08 12:35:04
1216,K1-147.トヨタモビリティ東京GRGarage東京蒲田店,2,0,2,35.552741,139.718404,2024-02-08 12:35:04
1217,K1-148.トヨタモビリティ東京 蒲田仲六郷店,6,0,6,35.552068,139.71747,2024-02-08 12:35:04
1218,K1-150.トヨタモビリティ東京 池上第二京浜店,1,4,5,35.568019,139.696379,2024-02-08 12:35:04
1219,K1-149.トヨタモビリティ東京 大田店,1,5,6,35.59336,139.715879,2024-02-08 12:35:04
1220,C1-82.トヨタモビリティ東京 港三田店,0,5,5,35.647831,139.739048,2024-02-08 12:35:04
1221,D4-11.トヨタモビリティ東京 新宿明治通り南店,2,0,2,35.699835,139.70808,2024-02-08 12:35:04
1222,C3-31.赤坂一丁目,12,5,17,35.670239,139.744285,2024-02-08 12:35:04
1223,E1-04.礫川公園,34,7,41,35.707853,139.751518,2024-02-08 12:35:04
1224,M3-23.円山町7-1,1,8,9,35.658229,139.694885,2024-02-08 12:35:04
1225,M3-24.渋谷道玄坂２丁目駐輪場,3,16,19,35.66026,139.69684,2024-02-08 12:35:04
1226,T3-32.練馬北町1丁目,1,4,5,35.764452,139.666299,2024-02-08 12:35:04
1227,H1-197.セブン-イレブン江東南砂葛西橋通り店,0,4,4,35.675361,139.825034,2024-02-08 12:35:04
1228,T2-84.石神井町二丁目緑地,0,3,3,35.748395,139.605958,2024-02-08 12:35:04
1229,T2-82.梅の木児童遊園,0,5,5,35.737899,139.576584,2024-02-08 12:35:04
1230,T2-83.西大泉さくら緑地,4,4,8,35.760442,139.573145,2024-02-08 12:35:04
1231,D7-05.西落合図書館,7,1,8,35.725818,139.678976,2024-02-08 12:35:04
1232,D6-28.東急ステイ新宿,3,0,3,35.690899,139.706348,2024-02-08 12:35:04
1233,T2-85.泉新公園,3,1,4,35.7547,139.601497,2024-02-08 12:35:04
1234,T2-86.石神井町八丁目緑地,2,1,3,35.746956,139.600798,2024-02-08 12:35:04
1235,T2-87.南大泉四丁目児童遊園,0,4,4,35.745607,139.573947,2024-02-08 12:35:04
1236,T2-88.南大泉かたまち緑地,0,4,4,35.739633,139.570457,2024-02-08 12:35:04
1237,T2-89.南大泉三丁目児童遊園,0,3,3,35.742755,139.568335,2024-02-08 12:35:04
1238,E2-05.護国寺駅西自転車駐車場,21,1,22,35.719421,139.725584,2024-02-08 12:35:04
1239,J1-59.第44興和ビル,3,1,4,35.647704,139.693671,2024-02-08 12:35:04
1240,C1-15.東京タワー,11,5,16,35.65928,139.744767,2024-02-08 12:35:04
1241,C5-20.ローソン芝浦二丁目店,3,1,4,35.645254,139.754765,2024-02-08 12:35:04
1242,C2-27.有栖川宮記念公園第一,17,0,17,35.651382,139.724392,2024-02-08 12:35:04
1243,C2-28.有栖川宮記念公園第二,4,4,8,35.651129,139.726003,2024-02-08 12:35:04
1244,C2-29.狸穴公園,4,1,5,35.658204,139.738935,2024-02-08 12:35:04
1245,T2-90.南田中四丁目緑地,2,2,4,35.733195,139.612327,2024-02-08 12:35:04
1246,T2-91.石神井町四丁目緑地,5,0,5,35.745272,139.604579,2024-02-08 12:35:04
1247,A3-41.秋葉原ダイビル,4,1,5,35.698917,139.771856,2024-02-08 12:35:04
1248,J1-54.田道住区センター三田分室,5,0,5,35.638904,139.712518,2024-02-08 12:35:04
1249,H1-140.キャナルパレス住吉,12,4,16,35.689896,139.815116,2024-02-08 12:35:04
1250,C1-57.虎ノ門ツインビルディング,7,0,7,35.667259,139.745643,2024-02-08 12:35:04
1251,K1-54.ファミリーマート大田久が原五丁目店,0,16,16,35.579435,139.698552,2024-02-08 12:35:04
1252,B1-29.ASTILE日本橋浜町,1,7,8,35.685504,139.790817,2024-02-08 12:35:04
1253,N3-20.SYFORME NAKANO-SAKAUE,2,3,5,35.701157,139.679617,2024-02-08 12:35:04
1254,D6-31.東急歌舞伎町タワー駐輪場,2,8,10,35.696207,139.700521,2024-02-08 12:35:04
1255,I1-30.ローソン 大井三丁目店,7,0,7,35.603327,139.729006,2024-02-08 12:35:04
1256,K1-151.PATH仲六郷,10,0,10,35.549465,139.711157,2024-02-08 12:35:04
1257,H1-198.Br Tower 有明 MID CROSS,2,5,7,35.63464,139.783445,2024-02-08 12:35:04
1258,H1-04.石と光の広場（国際展示場駅）,41,20,61,35.63363,139.79082,2024-02-08 12:35:04
1259,B4-24.ミュプレ月島,5,2,7,35.66288,139.78329,2024-02-08 12:35:04
1260,H1-199.ラ・ヴェール東陽町,1,9,10,35.664244,139.814506,2024-02-08 12:35:04
1261,H1-200.ヴェッセル木場南,0,14,14,35.662414,139.813333,2024-02-08 12:35:04
1262,F1-04.台東2丁目21,0,5,5,35.703465,139.780325,2024-02-08 12:35:04
1263,F3-03.ヴェルステージ南千住,0,5,5,35.728704,139.801867,2024-02-08 12:35:04
1264,J1-46.五本木西みどり街かど公園,0,6,6,35.632735,139.683899,2024-02-08 12:35:04
1265,Z24.総合川崎臨港病院,0,10,10,35.525854,139.717848,2024-02-08 12:35:04
1266,K1-131.東急武蔵新田駅駐輪場,11,4,15,35.567146,139.693344,2024-02-08 12:35:04
1267,K1-152.アットホームスクエア前,0,8,8,35.543327,139.703223,2024-02-08 12:35:04
1268,B2-04.清水建設本社（都営地下鉄宝町駅 Ａ８出口）,12,1,13,35.676119,139.772895,2024-02-08 12:35:04
1269,H1-202.辰巳の森海浜公園,7,5,12,35.648107,139.813572,2024-02-08 12:35:04
1270,H1-201.ウエリスアーバン水天宮前2,1,5,6,35.678099,139.791831,2024-02-08 12:35:04
1271,I1-103.五反田ＪＰビルディング,3,0,3,35.622389,139.721552,2024-02-08 12:35:04
1272,L1-16.上祖師谷7丁目,13,1,14,35.65838,139.59231,2024-02-08 12:35:04
1273,O5-09.AppCruise中野,1,1,2,35.700772,139.66063,2024-02-08 12:35:04
1274,H1-203.セブン-イレブン江東木場３丁目店,0,11,11,35.67517,139.804087,2024-02-08 12:35:04
1275,H1-44.テプコ豊洲ビル,25,0,25,35.648726,139.790877,2024-02-08 12:35:04
1276,L1-17.赤堤3丁目,3,4,7,35.659787,139.636696,2024-02-08 12:35:04
1277,L1-18.上北沢1丁目,20,10,30,35.662796,139.626795,2024-02-08 12:35:04
1278,B3-16.明石町区民館,0,11,11,35.666001,139.778102,2024-02-08 12:35:04
1279,I1-104.源氏前ビル,5,0,5,35.603521,139.712345,2024-02-08 12:35:04
1280,J1-28.宮前公園,0,8,8,35.617699,139.664826,2024-02-08 12:35:04
1281,M6-18.セブン-イレブン渋谷本町3丁目店,0,3,3,35.686521,139.685017,2024-02-08 12:35:04
1282,O7-08.杉並区和泉2-3-17,0,4,4,35.67187,139.65474,2024-02-08 12:35:04
1283,T1-17.セブン-イレブン練馬田柄通店,6,1,7,35.75987,139.640474,2024-02-08 12:35:04
1284,H1-18.東京ビッグサイト,7,9,16,35.631192,139.79401,2024-02-08 12:35:04
1285,M3-01.渋谷マークシティ,11,2,13,35.657726,139.697802,2024-02-08 12:35:04
1286,H1-70.有明スポーツセンター,13,4,17,35.63403,139.784319,2024-02-08 12:35:04
1287,H1-41.深川北スポーツセンター,2,11,13,35.676475,139.804741,2024-02-08 12:35:04
1288,H1-55.深川江戸資料館,3,5,8,35.681089,139.800777,2024-02-08 12:35:04
1289,I1-61.五反田文化センター,3,4,7,35.622588,139.716159,2024-02-08 12:35:04
1290,N3-13.中部すこやか福祉センター,3,2,5,35.700052,139.673715,2024-02-08 12:35:04
1291,A4-02.東京サンケイビル,10,0,10,35.686847,139.765151,2024-02-08 12:35:04
1292,M3-09.ティップ.クロス TOKYO 渋谷,10,9,19,35.661475,139.699296,2024-02-08 12:35:04
1293,B3-02.サンクンガーデン,2,4,6,35.670336,139.771911,2024-02-08 12:35:04
1294,T2-10.勤労福祉会館,5,0,5,35.748153,139.58765,2024-02-08 12:35:04
1295,K1-133.東京港野鳥公園,13,0,13,35.584217,139.759232,2024-02-08 12:35:04
1296,K1-21.六郷特別出張所,0,8,8,35.55079,139.716517,2024-02-08 12:35:04
1297,H1-54.砂町文化センター,3,17,20,35.680052,139.831874,2024-02-08 12:35:04
1298,D1-08.新宿歴史博物館,3,1,4,35.689984,139.725261,2024-02-08 12:35:04
1299,E1-05.春日地下自転車駐車場,23,2,25,35.708291,139.753335,2024-02-08 12:35:04
1300,E1-15.播磨坂事業所,0,6,6,35.71724,139.74289,2024-02-08 12:35:04
1301,E5-02.不忍通りふれあい館,0,12,12,35.719356,139.764308,2024-02-08 12:35:04
1302,E4-02.向丘地域活動センター,8,5,13,35.717357,139.757817,2024-02-08 12:35:04
1303,C3-18.明治記念館,4,1,5,35.678509,139.721207,2024-02-08 12:35:04
1304,D5-05.中央図書館,13,2,15,35.705018,139.706841,2024-02-08 12:35:04
1305,E2-07.肥後細川庭園,10,3,13,35.713223,139.721699,2024-02-08 12:35:04
1306,A1-05.富士見出張所,0,3,3,35.699187,139.746348,2024-02-08 12:35:04
1307,E5-07.湯島三丁目児童遊園,4,4,8,35.707296,139.769393,2024-02-08 12:35:04
1308,D5-10.桜美林大学 新宿キャンパス,1,6,7,35.705154,139.697562,2024-02-08 12:35:04
1309,A3-08.神田明神（神田神社）,11,2,13,35.702029,139.768245,2024-02-08 12:35:04
1310,E2-14.永青文庫 ミュージアム,5,0,5,35.713145,139.723342,2024-02-08 12:35:04
1311,M5-17.小田急サザンタワー,8,1,9,35.6866,139.70014,2024-02-08 12:35:04
1312,K1-16.ファミリーマート 矢口二丁目店,3,3,6,35.563092,139.693548,2024-02-08 12:35:04
1313,H1-206.北砂5丁目団地2,0,9,9,35.683866,139.831809,2024-02-08 12:35:04
1314,G1-02.八広駅高架下,4,10,14,35.727495,139.828499,2024-02-08 12:35:04
1315,F4-02.Risingplace浅草四番館,0,4,4,35.717963,139.791025,2024-02-08 12:35:04
1316,H1-204.大島四丁目団地2,3,5,8,35.68832,139.828829,2024-02-08 12:35:04
1317,H1-205.大島四丁目団地3,5,5,10,35.688236,139.827711,2024-02-08 12:35:04
1318,H1-106.亀戸中央公園,12,7,19,35.699874,139.834263,2024-02-08 12:35:04
1319,E5-30.湯島3丁目15,0,12,12,35.705148,139.769314,2024-02-08 12:35:04
1320,B4-38.HARUMI FLAG SUN VILLAGE,0,24,24,35.650347,139.771785,2024-02-08 12:35:04
1321,B4-32.HARUMI FLAG SEA VILLAGE,0,10,10,35.648731,139.774995,2024-02-08 12:35:04
1322,B4-31.HARUMI FLAG PORT VILLAGE,0,19,19,35.650604,139.77724,2024-02-08 12:35:04
1323,B4-33.HARUMI FLAG SEA VILLAGE,0,15,15,35.649552,139.776369,2024-02-08 12:35:04
1324,B4-36.HARUMI FLAG SEA VILLAGE,2,10,12,35.650742,139.778097,2024-02-08 12:35:04
1325,B4-35.HARUMI FLAG SEA VILLAGE,1,11,12,35.650573,139.777908,2024-02-08 12:35:04
1326,B4-37.HARUMI FLAG SUN VILLAGE,0,17,17,35.649419,139.771447,2024-02-08 12:35:04
1327,B4-34.HARUMI FLAG SEA VILLAGE,2,10,12,35.649932,139.776958,2024-02-08 12:35:04
1328,B4-39.HARUMI FLAG SUN VILLAGE,0,18,18,35.650863,139.772549,2024-02-08 12:35:04
1329,B4-40.HARUMI FLAG SUN VILLAGE,0,15,15,35.651305,139.773379,2024-02-08 12:35:04
1330,B4-41.HARUMI FLAG SUN VILLAGE,0,16,16,35.649854,139.77334,2024-02-08 12:35:04
1331,B4-42.HARUMI FLAG SUN VILLAGE,0,12,12,35.649329,139.772656,2024-02-08 12:35:04
1332,B4-28.HARUMI FLAG PORT VILLAGE,4,7,11,35.651183,139.776119,2024-02-08 12:35:04
1333,B4-50.HARUMI FLAG PARK VILLAGE,1,8,9,35.648295,139.773973,2024-02-08 12:35:04
1334,B4-49.HARUMI FLAG PARK VILLAGE,4,12,16,35.648636,139.774251,2024-02-08 12:35:04
1335,B4-48.HARUMI FLAG PARK VILLAGE,0,5,5,35.649513,139.775287,2024-02-08 12:35:04
1336,B4-47.HARUMI FLAG PARK VILLAGE,2,4,6,35.649119,139.775138,2024-02-08 12:35:04
1337,B4-46.HARUMI FLAG PARK VILLAGE,0,25,25,35.649642,139.773859,2024-02-08 12:35:04
1338,B4-45.HARUMI FLAG PARK VILLAGE,0,24,24,35.649002,139.772764,2024-02-08 12:35:04
1339,B4-44.HARUMI FLAG PARK VILLAGE,3,10,13,35.648221,139.772666,2024-02-08 12:35:04
1340,B4-30.HARUMI FLAG PORT VILLAGE,1,10,11,35.651136,139.778218,2024-02-08 12:35:04
1341,B4-29.HARUMI FLAG PORT VILLAGE,0,17,17,35.651907,139.777391,2024-02-08 12:35:04
1342,L1-19.三軒茶屋1丁目駐輪場,1,3,4,35.639302,139.674744,2024-02-08 12:35:04
1343,O7-09.方南月極パーキング,8,9,17,35.678921,139.658289,2024-02-08 12:35:04
1344,O5-10.ローソン ツルハドラッグ杉並和田店,0,4,4,35.68942,139.662118,2024-02-08 12:35:04
1345,O2-04.西荻北1丁目,2,3,5,35.708082,139.607543,2024-02-08 12:35:04
1346,K1-75.三井不動産インダストリアルパーク羽田,6,4,10,35.556231,139.751408,2024-02-08 12:35:04
1347,F1-05.ホウエイコート秋葉原,0,2,2,35.703024,139.78052,2024-02-08 12:35:04
1348,C3-36.第35興和ビル,2,2,4,35.666349,139.741781,2024-02-08 12:35:04
1349,B4-53.晴海五丁目ターミナル,24,82,106,35.651627,139.773103,2024-02-08 12:35:04
1350,C5-44.ブランズタワー芝浦,9,0,9,35.643105,139.753039,2024-02-08 12:35:04
1351,A3-47.ホテルヴィラフォンテーヌ東京大手町,13,0,13,35.690602,139.766916,2024-02-08 12:35:04
1352,A1-20.菱和パレス九段,4,1,5,35.693021,139.740317,2024-02-08 12:35:04
